"dota"
{
"DOTA_Accept"	"Godta"
"DOTA_Cancel"	"Avbryt"
"DOTA_Console"	"Konsoll"
"DOTA_Create"	"Opprett"
"DOTA_Decline"	"Avslå"
"DOTA_Error"	"Feil"
"DOTA_Join"	"Bli med"
"DOTA_Leave"	"Forlat"
"DOTA_New"	"Nytt"
"DOTA_Ok"	"OK"
"DOTA_Sale"	"Salg"
"DOTA_Close"	"Lukk"
"DOTA_Continue"	"Fortsett"
"DOTA_Add"	"Legg til"
"DOTA_Edit"	"Rediger"
"DOTA_Enable"	"Aktiver"
"DOTA_Disable"	"Deaktiver"
"DOTA_Refresh"	"Oppdater"
"DOTA_Loading"	"Laster"
"DOTA_None"	"Ingen"
"DOTA_Customize"	"Tilpass"
"DOTA_AcceptChanges"	"Godta endringer"
"Unknown"	"Ukjent"
"UI_Yes"	"Ja"
"UI_No"	"Nei"
"UI_File_Filter_Any"	"Alle filer (*.*)"
"DOTA_MainMenu_Heroes"	"Helter"
"DOTA_MainMenu_Watch"	"Se på"
"DOTA_MainMenu_Learn"	"Lær"
"DOTA_MainMenu_Mods"	"Arkade"
"DOTA_TabName_GlobalItems"	"Globale gjenstander"
"DOTA_TabName_Armory"	"Arsenal"
"DOTA_ConfirmQuit"	"Avslutt spill"
"DOTA_ConfirmQuitDesc"	"Vil du virkelig avslutte Dota 2?"
"DOTA_ConfirmQuitDescUnsafe"	"Å forlate en kamp før den er ferdig kan ødelegge spillopplevelsen for andre spillere. Vil du virkelig avslutte Dota 2?"
"DOTA_InvalidPersonaName"	"[ukjent]"
"DOTA_Friends_WindowTitle"	"VENNER"
"DOTA_FriendsCategory_ReadyToPlay"	"I åpne spill <font color='#63C290'><b></b>({d:friend_count})</font>"
"DOTA_FriendsCategory_PlayingDota"	"I Dota <font color='#ACEBA9'>({d:friend_count})</font>"
"DOTA_FriendsCategory_Online"	"Tilkoblet <font color='#6a9dcc'>({d:friend_count})</font>"
"DOTA_FriendsCategory_Pending"	"Venter <font color='#eeee82'>({d:friend_count})</font>"
"DOTA_FriendsCategory_Offline"	"Frakoblet <font color='#676666'>({d:friend_count})</font>"
"DOTA_Friends_Empty"	"Din venneliste er for øyeblikket tom"
"DOTA_FriendsMenu_Tooltip_NoneReady"	"Venner"
"DOTA_UserName"	"{g:dota_persona:user_account_id}"
"DOTA_UserNamePro"	"{g:dota_persona_pro:user_account_id}"
"DOTA_UserNickname"	"{g:dota_persona_nickname:user_account_id}"
"DOTA_UserRichPresence"	"{s:user_rich_presence}"
"DOTA_ProfileCard_StatTitle_Wins"	"Seire"
"DOTA_ProfileCard_StatTitle_Commends"	"Anbefalinger"
"DOTA_ProfileCard_StatTitle_GamesPlayed"	"Kamper"
"DOTA_ProfileCard_StatTitle_FirstMatchDate"	"Første kamp"
"DOTA_ProfileCard_StatValue_Int"	"{d:stat_value}"
"DOTA_ProfileCard_StatValue_Date"	"{t:s:stat_value}"
"DOTA_ProfileCard_StatValue_String"	"{s:stat_value}"
"DOTA_ProfileCard_SlotTab_Trophies"	"Trofeer"
"DOTA_ProfileCard_SlotTab_Items"	"Arsenal"
"DOTA_ProfileCard_SlotTab_Heroes"	"Helter"
"DOTA_ProfileCard_SlotTab_Emoticons"	"Uttrykksikon"
"DOTA_ProfileCard_NoTrophies"	"Ingen trofeer er tilgjengelige."
"DOTA_ProfileCard_NoItems"	"Ingen gjenstander er tilgjengelige."
"DOTA_ProfileCard_HeroShowWins"	"Vis seire"
"DOTA_ProfileCard_HeroShowWinsAndLosses"	"Vis seire/tap"
"DOTA_ProfileCard_ItemSearchPrefix"	"Søk etter:"
"DOTA_ProfileCard_ItemSearchPlaceholder"	"Gjenstander etter navn"
"DOTA_HeroTooltip_HeroName"	"{s:hero_name}"
"DOTA_HeroTooltip_HeroRecord"	"{s:hero_wins_string}, {s:hero_losses_string}"
"DOTA_Wins_Singular"	"1 seier"
"DOTA_Wins_Plural"	"{d:hero_wins} seire"
"DOTA_Losses_Singular"	"1 tap"
"DOTA_Losses_Plural"	"{d:hero_losses} tap"
"DOTA_Profile_TotalGames"	"Spill totalt"
"DOTA_Profile_VictoryCount"	"Seire"
"DOTA_Profile_ProfilePage"	"Profil"
"DOTA_Profile_TrophyPage"	"Trofeer"
"DOTA_Profile_RecentGamesPage"	"Nylige kamper"
"DOTA_Profile_HeroPage"	"Helter"
"DOTA_Profile_PlayStyle"	"Spillestil"
"DOTA_Profile_RecentActivity"	"Nylig aktivitet"
"DOTA_Profile_Fighting"	"Slåssing"
"DOTA_Profile_Fighting_TooltipTitle"	"Slåssing"
"DOTA_Profile_Fighting_Tooltip"	"Spillere som slåss i mange kamper mot fiendtlige helter."
"DOTA_Profile_Tooltip_Value"	"{s:CurrentStatValue}"
"DOTA_Profile_Tooltip_Comparison"	"{s:CurrentComparisonValue}"
"DOTA_Profile_StatsCompare"	"Sammenlign"
"DOTA_Profile_Self"	"Meg"
"DOTA_Profile_GPMValue"	"{s:GPM}"
"DOTA_Profile_XPMValue"	"{s:XPM}"
"DOTA_Profile_LHValue"	"{s:LH}"
"DOTA_Profile_RampagesValue"	"{d:Rampages}"
"DOTA_Profile_TripleKillsValue"	"{d:TripleKills}"
"DOTA_Profile_FirstBloodValue"	"{d:FirstBlood}"
"DOTA_Profile_FirstBledValue"	"{d:FirstBled}"
"DOTA_Profile_CourierKillsValue"	"{d:CourierKills}"
"DOTA_Profile_AegisesValue"	"{d:Aegises}"
"DOTA_Profile_CheeseEatenValue"	"{d:CheeseEaten}"
"DOTA_Profile_CreepStackValue"	"{d:CreepStack}"
"DOTA_Profile_GPMLocalValue"	"{s:GPMLocal}"
"DOTA_Profile_XPMLocalValue"	"{s:XPMLocal}"
"DOTA_Profile_LHLocalValue"	"{s:LHLocal}"
"DOTA_Profile_RampagesLocalValue"	"{d:RampagesLocal}"
"DOTA_Profile_TripleKillsLocalValue"	"{d:TripleKillsLocal}"
"DOTA_Profile_FirstBloodLocalValue"	"{d:FirstBloodLocal}"
"DOTA_Profile_FirstBledLocalValue"	"{d:FirstBledLocal}"
"DOTA_Profile_CourierKillsLocalValue"	"{d:CourierKillsLocal}"
"DOTA_Profile_AegisesLocalValue"	"{d:AegisesLocal}"
"DOTA_Profile_CheeseEatenLocalValue"	"{d:CheeseEatenLocal}"
"DOTA_Profile_CreepStackLocalValue"	"{d:CreepStackLocal}"
"DOTA_RecentGames_TimeStamp"	"Dato/tid"
"DOTA_RecentGames_HeroSelection"	"Helt spilt"
"DOTA_RecentGames_GameResult"	"Resultat"
"DOTA_RecentGames_GameLength"	"Varighet"
"DOTA_RecentGames_Team"	"Lag"
"DOTA_RecentGames_GameType"	"Type"
"DOTA_RecentGames_Items"	"Gjenstander"
"DOTA_RecentGame_Timestamp_Entry"	"{t:s:timestamp} {t:t:timestamp}"
"DOTA_RecentGame_Duration"	"{t:d:duration}"
"DOTA_RecentGame_Downloading"	"{s:DownloadPercent} laster ned"
"DOTA_RecentGame_Watch"	"Se reprise"
"DOTA_RecentGame_NoReplay"	"Ingen reprise"
"DOTA_RecentGame_Expired"	"Reprise utløpt"
"DOTA_RecentGame_Finding"	"Finner..."
"DOTA_RecentGame_Download"	"Last ned kamp"
"DOTA_No_Team_Name"	"--"
"DOTA_TrophyCount"	"{d:trophy_count} trofé"
"DOTA_TrophiesCount"	"{d:trophy_count} trofeer"
"DOTA_TrophyCount_Number"	"{d:trophy_count}"
"DOTA_TrophyCount_NoNum"	"Trofé"
"DOTA_TrophiesCount_NoNum"	"Trofeer"
"DOTA_Trophies_ViewAll"	"Alle"
"DOTA_TrophyName"	"{s:trophy_name}"
"DOTA_TrophyCategory"	"{s:trophy_category}"
"DOTA_TrophyDescription"	"{s:trophy_description}"
"DOTA_TrophyXP"	"{d:trophy_xp}<span class=\"TrophyPointTextSmall\">TP</span>"
"DOTA_NextTrophy"	"Neste belønning"
"DOTA_NewPlayerQuestion_Title"	"VELKOMMEN TIL DOTA 2"
"DOTA_PlayerOriginQuestion_BeginnerButton"	"Jeg er nybegynner."
"DOTA_PlayerOriginQuestion_Dota2Button"	"Jeg har spilt Dota 2."
"DOTA_PlayerOriginQuestion_MOBAExplanation"	"Velg det spillet du er mest komfortabel med:"
"DOTA_OtherGames_Other"	"Et annet spill"
"DOTA_Tutorial_QuestDetailsLearn"	"Du vil lære:"
"DOTA_ChallengeGroup_0_Title"	"Mekanikk"
"DOTA_ChallengeGroup_1_Desc"	"Start Her!"
"DOTA_LearnMechanics_Title"	"Mekanikk"
"DOTA_BotMatches_1_Desc"	"Bli komfortabel."
"DOTA_BotMatches_3_Desc"	"Skad deg selv."
"FileOpenDialog_Open"	"Åpne"
"FileOpenDialog_Save"	"Lagre"
"FileOpenDialog_Select"	"Velg"
"FileOpenDialog_FileType_Folder"	"Mappe"
"DOTA_FindMatch"	"Finn kamp"
"DOTA_FindingMatch"	"Finner kamp ( {s:find_match_time} )"
"DOTA_FindMatchTime"	"{s:find_match_time}"
"DOTA_Searching"	"Søker"
"DOTA_Create_Lobby"	"OPPRETT LOBBY"
"DOTA_Join_Lobby"	"Bli med i lobby"
"DOTA_LobbyStartGame"	"Start spill"
"DOTA_ReturnToLobby"	"Tilbake til lobby"
"DOTA_FindMatchStatus"	"{s:searching_matchtype} / {s:searching_gamemodes} / {s:searching_region}"
"DOTA_FindRegionsMany"	"Regioner: "
"DOTA_GameMode_LeastPlayed"	"Minst spilt"
"DOTA_GameMode_AllRandom"	"All Random"
"DOTA_ImmediatePurchase_Success_Title"	"Suksess"
"DOTA_ImmediatePurchase_Cancelled_Title"	"Avbrutt"
"DOTA_ConfirmPurchaseTitle"	"Bekreft kjøp"
"DOTA_ConfirmPurchaseText"	"Vil du kjøpe denne gjenstanden?"
"DOTA_PartnerPurchase_Purchase"	"{g:dota_item_price:item_def}"
"StoreCheckout_Error_Title"	"Feil"
"StoreCheckout_NoItems"	"Handlevognen din er tom!"
"StoreCheckout_TooManyItems"	"Du har for mange gjenstander i handlevognen!"
"StoreCheckout_Loading"	"Går til kassen..."
"StoreCheckout_Unavailable"	"Kassen er for øyeblikket ikke tilgjengelig."
"StoreCheckout_Cancelling"	"Avbryter..."
"StoreCheckout_Fail"	"Butikken i spillet er for øyeblikket stengt."
"StoreCheckout_InvalidParam"	"En programmerer har rotet det til! En ugyldig parameter ble sendt til spillkoordinatoren. Prøv å gjennomføre kjøpet på nytt."
"StoreCheckout_InternalError"	"Det ser ut til å ha oppstått en feil under forberedelsen eller oppdateringen av transaksjonen din. Vennligst vent et minutt og prøv igjen, eller kontakt kundestøtte for å få hjelp."
"StoreCheckout_ContactSupport"	"Det oppsto en feil med transaksjonen din. Vennligst kontakt kundestøtte for hjelp."
"StoreCheckout_NotApproved"	"Spillkoordinatoren kunne ikke godkjenne transaksjonen med Steam. Prøv å gjennomføre kjøpet på nytt senere."
"StoreCheckout_NotLoggedin"	"Du må være logget på Steam for å gjennomføre et kjøp."
"StoreCheckout_WrongCurrency"	"Valutaen i denne transaksjonen samsvarer ikke med valutaen i lommeboken din."
"StoreCheckout_NoAccount"	"Steam-kontoen din er for øyeblikket ikke tilgjengelig. Prøv å gjennomføre kjøpet på nytt senere."
"StoreCheckout_InsufficientFunds"	"Du har ikke nok midler til å gjennomføre dette kjøpet."
"StoreCheckout_TimedOut"	"Transaksjonen ble tidsavbrutt. Prøv å gjennomføre kjøpet på nytt."
"StoreCheckout_SteamAccountDisabled"	"Steam-kontoen din er deaktivert og kan ikke gjennomføre kjøp."
"StoreCheckout_SteamAccountNoPurchase"	"Lommeboktransaksjoner er deaktivert på denne Steam-kontoen."
"StoreCheckout_OldPriceSheet"	"Din lokale produktliste er utdatert. Ber om en ny."
"StoreCheckout_TransactionNotFound"	"Spillkoordinatoren fant ikke transaksjons-IDen. Prøv å gjennomføre kjøpet på nytt."
"StoreCheckout_TransactionCompleted"	"Transaksjonen er fullført!\\\nKos deg med byttet!"
"StoreCheckout_CompleteButUnfinalized"	"Kan ikke bekrefte resultatet. Hvis transaksjonen var vellykket, blir gjenstandene levert senere."
"StoreCheckout_NotEnoughRoom"	"Du har ikke nok plass i rygsekken til å kjøpe så mange gjenstander."
"StoreCheckout_ContactSupport_Dialog_Title"	"Advarsel"
"StoreCheckout_ContactSupport_Dialog_Btn"	"Kontakt"
"DOTA_AbilityTooltip_Name"	"{s:name}"
"DOTA_AbilityTooltip_Level"	"Nivå {s:level}"
"DOTA_AbilityTooltip_TargetType"	"PÅVIRKER: {s:targettype}"
"DOTA_AbilityTooltip_CastType"	"EVNE: {s:casttype}"
"DOTA_AbilityTooltip_DamageType"	"SKADETYPE: {s:damagetype}"
"DOTA_AbilityTooltip_SpellImmunityType"	"GÅR GJENNOM FORMELIMMUNITET: {s:spellimmunity}"
"DOTA_AbilityTooltip_Description"	"{s:description}"
"DOTA_AbilityTooltip_ScepterDescription"	"{s:scepterdescription}"
"DOTA_AbilityTooltip_ExtraDescription"	"{s:extradescription}"
"DOTA_AbilityTooltip_Attributes"	"{s:attributes}"
"DOTA_AbilityTooltip_Cooldown"	"{s:cooldown}"
"DOTA_AbilityTooltip_ManaCost"	"{s:manacost}"
"DOTA_AbilityTooltip_Lore"	"{s:lore}"
"DOTA_AbilityTooltip_UpgradeLevel"	"Neste oppgradering på heltenivå {d:upgradelevel}"
"DOTA_AbilityTooltip_BuildComment"	"{g:dota_filtered_string:buildcomment}"
"DOTA_PersonaTooltip_Title"	"{g:dota_persona:account_id}"
"DOTA_PersonaTooltip_TitlePro"	"{g:dota_persona_pro:account_id}"
"DOTA_PendingInvites"	"Gruppeinvitasjoner"
"DOTA_PendingInvitesTooltip_None"	"Ingen ventende invitasjoner."
"DOTA_PendingInvitesTooltip_1"	"1 ventende invitasjon"
"DOTA_PendingInvitesTooltip_N"	"{d:pending_invite_count} ventende invitasjoner"
"DOTA_PendingInvitesTooltip_Leader"	"Trykk for å behandle invitasjoner."
"DOTA_PendingInvitesTooltip_NonLeader"	"Trykk for å se invitasjoner."
"DOTA_PendingInvitesCancelAll"	"Avbryt alle invitasjoner"
"DOTA_PendingInvitesNotPartyLeader"	"Kun gruppelederen kan behandle invitasjoner"
"DOTA_ChatTab_NotInChannelMessage"	"Ingen hører deg."
"DOTA_ChatTab_Leave"	"Forlat denne kanalen."
"DOTA_Chat_ChannelName"	"{g:dota_filtered_string:channel_name}"
"DOTA_Chat_ChannelMemberCount_Singular"	"1 medlem"
"DOTA_Chat_ChannelMemberCount_Plural"	"{d:channel_member_count} medlemmer"
"DOTA_EditChatTab_AddNewChannel"	"Legg til en ny kanal..."
"DOTA_EditChatTab_ChannelToggleDisabled"	"{s:target} må alltid være i minst én fane."
"DOTA_EditChatTab_Target"	"{s:target}"
"DOTA_Chat_TimestampFormat"	"{t:t:timestamp}"
"DOTA_Chat_Autocomplete_Title"	"{s:autocomplete_title}"
"DOTA_Chat_Autocomplete_NoMatches"	"Ingen kamper"
"DOTA_Chat_Autocomplete_InviteFriends"	"Inviter en venn"
"DOTA_Chat_Autocomplete_Channels"	"Kanaler"
"DOTA_Chat_Autocomplete_Commands"	"Kommandoer"
"DOTA_Chat_Autocomplete_CommandName"	"/{s:command_name}"
"DOTA_Chat_Autocomplete_CommandDescription"	"{s:command_description}"
"dota_suggest_invite_format"	"Vennligst inviter {s:invite_persona} til gruppen."
"DOTA_ChatTarget_Format_Default"	"{g:dota_filtered_string:target}"
"DOTA_ChatTarget_Prompt_Default"	"Til ({g:dota_filtered_string:target}):"
"DOTA_ChatTarget_Format_Whisper"	"{s:persona}"
"DOTA_ChatTarget_Prompt_Whisper"	"Til [{s:persona}]:"
"DOTA_ChatTarget_Team"	"Lag"
"DOTA_ChatTarget_Fantasy"	"Fantasi"
"DOTA_ChatTarget_Console"	"Konsoll"
"DOTA_ChatTarget_Invalid"	"Ingen kanal"
"DOTA_ChatTarget_GameAll"	"Alle"
"DOTA_ChatTarget_GameAllies"	"Allierte"
"DOTA_ChatTarget_GameCoaching"	"Veiledning"
"DOTA_ChatTarget_GameSpectator"	"Tilskuer"
"DOTA_ChatTargetMenu_Title"	"{s:target}"
"DOTA_ChatTargetMenu_ToggleEnabled"	"{s:toggle_enabled}"
"DOTA_ChatTargetMenu_NotActive"	"(Ikke aktiv)"
"DOTA_Chat_MissedMessages"	"{s:missed_message_count}"
"DOTA_ChatCommand_Party"	"p"
"DOTA_ChatCommand_Lobby"	"l"
"DOTA_ChatCommand_Lobby_Name"	"Lobby"
"DOTA_ChatCommand_Channel"	"c"
"DOTA_ChatCommand_Channel_Name"	"Kanal"
"DOTA_ChatCommand_Whisper"	"w"
"DOTA_ChatCommand_Reply"	"r"
"DOTA_ChatCommand_Reply_Name"	"Svar"
"DOTA_ChatCommand_Help"	"?"
"DOTA_ChatCommand_Help_Name"	"Hjelp"
"DOTA_ChatCommand_InviteToParty_Name"	"Inviter til gruppe"
"DOTA_ChatCommand_LeaveParty"	"leaveparty"
"DOTA_ChatCommand_LeaveParty_Name"	"Forlat gruppe"
"DOTA_ChatCommand_LeaveChannel"	"leavechannel"
"DOTA_ChatCommand_LeaveChannel_Name"	"Forlat kanal"
"DOTA_ChatCommand_GameAll"	"alle"
"DOTA_ChatCommand_GameAll_Name"	"Alle"
"DOTA_ChatCommand_GameAllies"	"allierte"
"DOTA_ChatCommand_GameAllies_Name"	"Allierte"
"DOTA_ChatCommand_GameAllies_Description"	"Snakk med dine allierte."
"DOTA_ChatCommand_GameCoaching"	"coach"
"DOTA_ChatCommand_GameCoaching_Name"	"Veiledning"
"DOTA_ChatCommand_GameSpectator"	"tilskuer"
"DOTA_ChatCommand_GameSpectator_Name"	"Tilskuer"
"DOTA_ChatCommand_GameSpectator_Description"	"Snakk med andre tilskuere."
"DOTA_ChatCommand_Clear"	"clear"
"DOTA_ChatCommand_Clear_Name"	"Fjern"
"DOTA_ChatHelp_Targets"	"Mål"
"DOTA_ChatHelp_NameFormat"	"{s:command_name}:"
"DOTA_ChatHelp_CommandFormat"	"/{s:command}"
"DOTA_Chat_LeftParty"	"Gruppe oppløst."
"DOTA_Chat_MemberLeftParty"	"Spiller forlot gruppen: {s:party_members}"
"DOTA_Chat_InvitedToJoinParty"	"Invitert: {s:party_members}"
"DOTA_Chat_PartyMemberSeparator"	", "
"DOTA_Feature_Under_Construction_Title"	"Under konstruksjon"
"DOTA_PartyJoinRequest_Description"	"{g:dota_persona:b:inviter} ønsker å bli med i gruppen din."
"DOTA_PartyMergeRequest_Description"	"{g:dota_persona:b:inviter} ønsker at deres gruppe skal bli med i gruppen din."
"DOTA_Invite_IOfN"	"{d:received_invite_index} av {d:received_invite_count}"
"DOTA_PartyInvite_Description"	"{g:dota_persona:b:inviter} har invitert deg til en gruppe."
"DOTA_PartyInvite_LowPriority_Description"	"{g:dota_persona:b:inviter} har invitert deg til en lavprioritetsgruppe."
"DOTA_PartyVisTooltip_TitleOpen"	"Ser etter gruppemedlemmer"
"DOTA_PartyVisTooltip_TitleNotOpen"	"Ser ikke etter gruppemedlemmer"
"DOTA_PartySettings"	"Gruppeinnstillinger"
"DOTA_LobbyInvite_Title"	"Lobby-invitasjon"
"DOTA_LobbyInvite_Description"	"{g:dota_persona:inviter} har invitert deg til en lobby."
"DOTA_PartyJoinedLobby_Title"	"Ble med i lobby"
"DOTA_PartyJoinedLobby_Generic"	"{g:dota_filtered_string:party_leader} har flyttet deg til en lobby."
"DOTA_PartyJoinedLobby_Custom"	"{g:dota_filtered_string:party_leader} har flyttet deg til en {s:custom_game}-lobby."
"DOTA_PartyLeader"	"Gruppeleder"
"DOTA_LobbyKicked_Header"	"Kastet ut fra lobby"
"DOTA_LobbyKicked_Message"	"Du ble kastet ut fra spill-lobbyen av lobbylederen."
"DOTA_PlayerContextMenu_ViewProfile"	"Vis profil"
"DOTA_PlayerContextMenu_ChatWithPlayer"	"Send melding"
"DOTA_PlayerContextMenu_InviteToParty"	"Inviter til gruppe"
"DOTA_PlayerContextMenu_LeaveParty"	"Forlat gruppe"
"DOTA_PlayerContextMenu_AddFriend"	"Legg til venn"
"DOTA_PlayerContextMenu_AcceptFriendRequest"	"Godta venneforespørsel"
"DOTA_PlayerContextMenu_IgnoreFriendRequest"	"Ignorer venneforespørsel"
"DOTA_FeaturedHero_ViewGrid"	"Vis rutenett"
"DOTA_FeaturedHero_HeroName"	"{s:hero_name}"
"DOTA_FeaturedHero_ItemName"	"{g:dota_item_name:item_def}"
"DOTA_FeaturedHeroReason_NewItem"	"Ny {s:item_rarity}"
"DOTA_FeaturedHeroReason_FrequentlyPlayedHero"	"Fordi du spilte"
"DOTA_FeaturedHeroReason_FeaturedItem"	"Fremhevet gjenstand"
"DOTA_FeaturedHeroReason_PopularItem"	"Bestselger"
"DOTA_FeaturedHeroReason_SaleItem"	"Nå på tilbud"
"DOTA_HeroSelectorCategory_Default"	"Alle helter"
"DOTA_HeroSelectorCategory_NewItems"	"Nye gjenstander"
"DOTA_HeroSelectorCategory_Favorites"	"Favoritter"
"DOTA_HeroSelectorCategory_MostPlayed"	"Min mest spilte"
"DOTA_HeroSelectorCategory_LeastPlayed"	"Min minst spilte"
"DOTA_HeroSelectorCategory_HaveItems"	"Jeg har gjenstander for"
"DOTA_HeroSelectorCategory_PrimaryAttribute_Strength"	"Styrke"
"DOTA_HeroSelectorCategory_PrimaryAttribute_Agility"	"Smidighet"
"DOTA_HeroSelectorCategory_PrimaryAttribute_Intelligence"	"Intelligens"
"DOTA_HeroSelectorCategory_AttackRange_Melee"	"Nærkamp"
"DOTA_HeroSelectorCategory_AttackRange_Ranged"	"Avstandskamp"
"DOTA_HeroSelector_SelectHero_Label"	"Velg"
"DOTA_HeroSelector_ClearFilters"	"Fjern filtre"
"DOTA_OwnedItemSet_Selector_Title"	"Eid"
"DOTA_EquippedItemSet_Selector_Title"	"Utstyrt"
"DOTA_OwnedItemSet_Available_Title"	"Tilgjengelig"
"DOTA_FeaturedItemSet_Selector_Title"	"Utvalgt"
"DOTA_AllItemSet_Selector_Title"	"Alle"
"DOTA_ConfirmLANLobby_title"	"LOKAL LOBBY"
"DOTA_ConfirmLANLobbyDisconnect_ok"	"Ja, koble fra"
"DOTA_Lobby_Settings_Required"	"PÅKREVD"
"DOTA_Lobby_Settings_Confirm"	"{s:lobby_confirm_label}"
"DOTA_Lobby_Settings_Password"	"LOBBY-PASSORD"
"DOTA_Lobby_Settings_Starting_Team"	"STARTENDE LAG"
"DOTA_Lobby_Settings_Starting_Team_Random"	"TILFELDIG"
"DOTA_Lobby_Settings_Penalty_Level_0"	"Ingen straff"
"DOTA_Lobby_Settings_Series_Best_of_3"	"BEST AV 3"
"DOTA_Lobby_Settings_Series_Best_of_5"	"BEST AV 5"
"DOTA_Lobby_Settings_Bot_Difficulty_Passive"	"PASSIV"
"DOTA_Lobby_Settings_Bot_Difficulty_Easy"	"LETT"
"DOTA_Lobby_Settings_Bot_Difficulty_Medium"	"MIDDELS"
"DOTA_Lobby_Settings_Bot_Difficulty_Hard"	"VANSKELIG"
"DOTA_Lobby_Settings_Version"	"VERSJON"
"DOTA_Lobby_Settings_Version_Latest"	"SISTE"
"DOTA_Lobby_Settings_Version_Tournament"	"TURNERING"
"DOTA_Lobby_Settings_Spectator_Section"	"TILSKUER"
"DOTA_Lobby_Settings_Dota_TV_Delay_2_Minutes"	"2 minutter"
"DOTA_Lobby_Settings_Dota_TV_Delay_5_Minutes"	"5 minutter"
"DOTA_Lobby_Settings_Dota_TV_Delay_10_Seconds"	"10 sekunder"
"DOTA_Lobby_Settings_Spectators"	"TILSKUERE"
"DOTA_Lobby_Settings_Spectators_Enabled"	"AKTIVERT"
"DOTA_Lobby_Settings_Spectators_Disabled"	"DEAKTIVERT"
"dota_lobby_settings_hide_password"	"Skjul passord"
"DOTA_Lobby_Settings_Visibility"	"Lobbysynlighet"
"DOTA_Lobby_Settings_Visibility_Public"	"Offentlig"
"DOTA_Lobby_Settings_Visibility_Friends"	"Venner"
"DOTA_TeamUnsetHeader"	"LAG IKKE ANGITT"
"DOTA_TeamUnsetMessage"	"Minst ett lag har ikke angitt navn eller logo. Er du sikker på at du vil starte spillet?"
"dota_lobby_team_name_radiant"	"{s:team_name_good_guys}"
"dota_lobby_team_name_dire"	"{s:team_name_bad_guys}"
"dota_lobby_broadcast_default_channel_name"	"Kanalnavn"
"dota_lobby_broadcast_join"	"Bli med"
"dota_lobby_broadcast_leave"	"Forlat"
"dota_lobby_broadcast_create"	"Opprett ny kanal"
"dota_lobby_broadcast_default_channel_name_custom"	"{s:custom_title}"
"dota_popup_broadcast_channel_edit_country"	"Land"
"dota_popup_broadcast_channel_edit_language"	"Språk"
"DOTA_Lobby_Broadcaster_Channel_Other_Language"	"Annet språk"
"lobby_slot_error_header"	"Kan ikke bytte plass"
"generic_gc_timeout"	"Melding ble tidsavbrutt."
"lobby_slot_success_header"	"Suksess"
"lobby_slot_denied"	"Du mangler adgang til å bli med i denne plassen."
"lobby_slot_cameramanoff"	"Du er ikke lenger kameramann"
"LobbySetting_GameMode"	"Spillmodus"
"LobbySetting_GameMode_Value"	"{s:lobbysetting_gamemode}"
"LobbySetting_Bots_Value"	"{s:lobbysetting_bots_radiant} / {s:lobbysetting_bots_dire}"
"LobbySetting_Password"	"Passord"
"LobbySetting_Password_Value"	"{s:lobbysetting_password}"
"LobbySetting_Server"	"Tjener"
"LobbySetting_Server_Value"	"{s:lobbysetting_server}"
"LobbySetting_Cheats"	"Juks"
"LobbySetting_Cheats_Value"	"{s:lobbysetting_cheats}"
"LobbySetting_Spectators"	"Tilskuere"
"LobbySetting_Spectators_Value"	"{s:lobbysetting_spectators}"
"LobbySetting_Visibility"	"Synlighet"
"LobbySetting_Visibility_Value"	"{s:lobbysetting_visibility}"
"dota_lobby_lan_title"	"Lokal tjener"
"DOTA_Custom_Game_Info"	"Info"
"DOTA_Custom_Game_View_Details"	"Se spilldetaljer"
"DOTA_Custom_Game_Author"	"av {g:dota_persona:author}"
"DOTA_Custom_Game_Lobby_Count"	"{d:lobby_count} lobby"
"DOTA_Custom_Game_Lobby_Count_Plural"	"{d:lobby_count} lobbyer"
"DOTA_Custom_Game_Friend_Lobbies_Alert"	"Du har {d:friend_count} venner med en åpen spill-lobby."
"DOTA_Custom_Game_Find_Lobby"	"Finn lobby"
"DOTA_Custom_Game_Create_Lobby"	"Opprett lobby"
"DOTA_Custom_Game_Game_Page"	"Spillside"
"DOTA_Custom_Game_Downloading"	"Laster ned..."
"DOTA_Custom_Game_Play"	"Spill {g:dota_filtered_string:game_mode_name}"
"DOTA_Custom_Game_Uninstall"	"Avinstaller"
"DOTA_Custom_Game_Install"	"Installer"
"DOTA_Custom_Game_Installed"	"Innstallert"
"DOTA_Custom_Game_Not_Installed"	"Ikke installert"
"DOTA_Custom_Game_Connect"	"Bli med i lobby"
"DOTA_Custom_Game_FileSize"	"{d:file_size} MB"
"DOTA_Custom_Game_Name"	"{g:dota_filtered_string:game_mode_name}"
"DOTA_Custom_Game_Subscription"	"{s:subscriptions_count} abonnement"
"DOTA_Custom_Game_Subscriptions"	"{s:subscriptions_count} abonnementer"
"DOTA_Custom_Game_Rating"	"Rangering"
"DOTA_Custom_Game_Release_Date"	"Utgitt"
"DOTA_Custom_Game_Playing_Now"	"{s:player_count} spiller nå"
"DOTA_Custom_Game_Ratings_Count"	"({d:ratings_count})"
"DOTA_Custom_Game_Description"	"{g:dota_filtered_string:game_description}"
"DOTA_Custom_Game_Update_Note_Title"	"{s:timestamp}"
"DOTA_Custom_Game_Screenshots"	"Skjermbilder"
"DOTA_Custom_Game_Map_Label"	"Kart"
"DOTA_Custom_Game_Map_Any"	"Alle"
"DOTA_Custom_Game_Update"	"Oppdater"
"DOTA_Custom_Game_Spectate"	"Se på"
"DOTA_Custom_Game_Friends_Playing"	"Venner som spiller tilpassede spill"
"DOTA_Custom_Game_Friends_In_Lobbies"	"{d:friends_in_open_lobbies} i åpne lobbyer"
"DOTA_Custom_Game_Friends_In_Game"	"{d:friends_in_game} venner i tilpassede spill"
"DOTA_Custom_Games_Friends_Play"	"Tilpassede spill dine venner spiller"
"DOTA_Custom_Game_Invite_Friend"	"Inviter en venn"
"DOTA_Custom_Game_Tooltip_Subscribers"	"{d:subscriber_count} abonnementer"
"DOTA_Custom_Game_Tooltip_Subscriber"	"{d:subscriber_count} abonnement"
"DOTA_Custom_Game_Most_Popular"	"Mest populært"
"DOTA_Custom_Game_Installed_Games"	"Installerte spill"
"DOTA_Custom_Game_Favorite_Games"	"Vis bare favoritter"
"DOTA_Custom_Game_Add_Favorite"	"Merk som favoritt"
"DOTA_Custom_Game_Vote_Start"	"Start avstemning"
"DOTA_Custom_Game_Vote_PrevLabel"	"Forrige spill"
"DOTA_Custom_Game_Vote_NextLabel"	"Neste spill"
"DOTA_Custom_Game_Leave_Lobby"	"Forlat denne lobbyen"
"DOTA_Custom_Game_Suggested_Title"	"Anbefalte spill"
"DOTA_Custom_Lobby_Settings_Title"	"Opprett lobby"
"DOTA_Custom_Lobby_Settings_Mode"	"Spillmodus"
"DOTA_Custom_Lobby_Settings_Map"	"Kart"
"DOTA_Custom_Lobby_LobbyName"	"Valgfri beskrivelse"
"DOTA_Custom_Lobby_Public"	"Offentlig"
"DOTA_Custom_Lobby_Join_Failed_Reason"	"{s:join_error}"
"DOTA_Custom_Lobby_Create_Private_Button"	"Opprett privat lobby"
"DOTA_Custom_Lobby_Find_Private_Title"	"Finn privat lobby"
"DOTA_Custom_Lobby_List_Game_Header"	"Spill"
"DOTA_Custom_Lobby_List_Name_Header"	"Beskrivelse"
"DOTA_Custom_Lobby_List_Players_Header"	"Spillere"
"DOTA_Custom_Lobby_List_Map_Header"	"Kart"
"DOTA_Custom_Lobby_List_Region_Header"	"Region"
"DOTA_Custom_Lobby_List_Connection_Header"	"Forbindelse"
"DOTA_Custom_Lobby_List_Status_Header"	"Lokal status"
"DOTA_Custom_Lobby_List_Game"	"{g:dota_filtered_string:lobby_game}"
"DOTA_Custom_Lobby_List_Lobby_Name"	"{g:dota_filtered_string:lobby_name}"
"DOTA_Custom_Lobby_List_Players"	"{s:lobby_players} / {s:lobby_max_players}"
"DOTA_Custom_Lobby_List_Map"	"{g:dota_filtered_string:lobby_map}"
"DOTA_Custom_Lobby_List_Region"	"{s:lobby_region}"
"DOTA_Custom_Lobby_List_Connection"	"..."
"DOTA_Custom_Lobby_List_Status"	"{s:lobby_status}"
"DOTA_Custom_Lobby_List_Connect"	"{s:connect_button_text}"
"DOTA_Custom_Lobby_Game_Name"	"{g:dota_filtered_string:game_name}"
"DOTA_Custom_Lobby_Map_Name"	"Kart: {g:dota_filtered_string:map_name}"
"DOTA_Custom_Lobby_Player_Count"	"Spillere: {d:player_count} / {d:max_player_count}"
"DOTA_Custom_Lobby_Player_Count_Short"	"{d:player_count} / {d:max_player_count}"
"DOTA_Custom_Join_Chat_Member_Count"	"({d:ChatMemberCount})"
"DOTA_TabName_ModsOverview"	"Oversikt"
"DOTA_TabName_ModsSubscribed"	"Bibliotek"
"DOTA_TabName_ModsBrowse"	"Bla gjennom"
"DOTA_WatchTabName_Live"	"Direkte"
"DOTA_WatchTabName_Replays"	"Repriser"
"DOTA_WatchTabName_Tournaments"	"Turneringer"
"DOTA_WatchTabName_Downloads"	"Nedlastinger"
"DOTA_WatchLive_CountSpec"	"{i:num_spectating} ser på"
"DOTA_WatchLive_CountSpecFriend"	"{i:num_friends_spectating} venn og {i:num_spectating} ser på"
"DOTA_WatchLive_CountSpecFriends"	"{i:num_friends_spectating} venner og {i:num_spectating} ser på"
"DOTA_WatchLive_CountFriends"	"{i:num_friends_playing} venner spiller"
"DOTA_WatchLive_Participants1"	"{s:friend_1}"
"DOTA_WatchLive_Participants2"	"{s:friend_1} og {s:friend_2}"
"DOTA_WatchLive_Participants3"	"{s:friend_1}, {s:friend_2} og {s:friend_3}"
"DOTA_WatchLive_Participants4Plus"	"{s:friend_1}, {s:friend_2}, {s:friend_3} og {i:friend_count_over_3} andre..."
"DOTA_WatchLive_MatchType_MM_Kills"	"{s:game_mode}"
"DOTA_WatchLive_MatchType_MM"	"{s:game_mode}"
"DOTA_WatchLiveSpectatorFriends1"	"{g:dota_persona:spectator_friend_1} ser på"
"DOTA_WatchLiveSpectatorFriends2"	"{g:dota_persona:spectator_friend_1} og {g:dota_persona:spectator_friend_2} ser på"
"DOTA_WatchLiveSpectatorFriends3"	"{g:dota_persona:spectator_friend_1}, {g:dota_persona:spectator_friend_2} og {g:dota_persona:spectator_friend_3} ser på"
"DOTA_WatchLiveSpectatorFriends4Plus"	"{g:dota_persona:spectator_friend_1}, {g:dota_persona:spectator_friend_2}, {g:dota_persona:spectator_friend_3} og {i:spectator_friend_count_over_3} andre venner ser på"
"DOTA_WatchLiveSpectatorCount"	"{i:spectator_count} ser på"
"DOTA_WatchReplays_ParticipantsVs"	"{s:team_1} vs. {s:team_2}"
"DOTA_WatchReplays_MatchType_League"	"{s:league_name}"
"DOTA_WatchReplays_Recommendations"	"{i:recommendations}"
"DOTA_WatchReplays_Recommendations1"	"{g:dota_persona:friend_1} + {i:recommendations}"
"DOTA_WatchReplays_Recommendations2"	"{g:dota_persona:friend_1}, {g:dota_persona:friend_2} + {i:recommendations}"
"DOTA_WatchReplays_Recommendations3Plus"	"{g:dota_persona:friend_1} + {i:friend_count_over_1} andre venner + {i:recommendations}"
"DOTA_WatchReplays_Friends1"	"{g:dota_persona:b:friend_1} spilte"
"DOTA_WatchReplays_Friends2"	"{g:dota_persona:b:friend_1} og {g:dota_persona:friend_2} spilte"
"DOTA_WatchReplays_Friends3Plus"	"{g:dota_persona:b:friend_1}, {g:dota_persona:b:friend_2} og {i:friend_count_over_2} andre venner"
"DOTA_WatchReplays_Views"	"{i:views} visninger"
"DOTA_WatchReplays_Price"	"{g:dota_item_price:ticket_itemdef}"
"DOTA_WatchReplays_SharedMatch"	"{g:dota_persona:shared_by} delte – «{s:shared_text}»"
"DOTA_WatchReplays_SharedHighlight"	"{g:dota_persona:shared_by} delte et høydepunkt"
"DOTA_WatchReplays_Duration"	"{s:minutes}:{s:seconds}"
"DOTA_WatchTournaments_FeaturedTitle"	"{s:tournament_featured_title}"
"DOTA_WatchTournaments_FeaturedDates"	"{s:tournament_featured_start} – {s:tournament_featured_end}"
"DOTA_WatchTournaments_FeaturedDescription"	"{s:tournament_featured_description}"
"DOTA_WatchTournaments_FeaturedTeams"	"Lag"
"DOTA_WatchTournaments_PrizePoolAmt"	"{s:tournament_featured_prize_pool}"
"DOTA_WatchTournament_TournamentName"	"{s:tournament_name}"
"DOTA_WatchTournament_Price"	"{s:price}"
"DOTA_Watch_GameStatus"	"Se kampstatus"
"DOTA_Watch_LobbyNotFound"	"Lobby ikke funnet."
"dota_matchmaking_language_primary"	"{s:environment_language}"
"dota_matchmaking_language_english"	"Engelsk"
"dota_matchmaking_language_russian"	"Russisk"
"dota_matchmaking_language_chinese"	"Kiniesisk"
"dota_matchmaking_language_schinese"	"Kinesisk"
"dota_matchmaking_language_korean"	"Koreansk"
"dota_matchmaking_language_koreana"	"Koreansk"
"dota_matchmaking_language_spanish"	"Spansk"
"dota_matchmaking_language_portuguese"	"Portugisisk"
"GameUI_Language_English"	"Engelsk"
"GameUI_Language_German"	"Tysk"
"GameUI_Language_French"	"Fransk"
"GameUI_Language_Italian"	"Italiensk"
"GameUI_Language_Korean"	"Koreansk"
"GameUI_Language_Spanish"	"Spansk"
"GameUI_Language_Simplified_Chinese"	"Forenklet kinesisk"
"GameUI_Language_Traditional_Chinese"	"Tradisjonell kinesisk"
"GameUI_Language_Russian"	"Russisk"
"GameUI_Language_Thai"	"Thai"
"GameUI_Language_Japanese"	"Japansk"
"GameUI_Language_Portuguese"	"Portugisisk"
"GameUI_Language_Polish"	"Polsk"
"GameUI_Language_Danish"	"Dansk"
"GameUI_Language_Dutch"	"Nederlandsk"
"GameUI_Language_Finnish"	"Finsk"
"GameUI_Language_Norwegian"	"Norsk"
"GameUI_Language_Swedish"	"Svensk"
"GameUI_Language_Hungarian"	"Ungarsk"
"GameUI_Language_Czech"	"Tsjekkisk"
"GameUI_Language_Romanian"	"Rumensk"
"GameUI_Language_Turkish"	"Tyrkisk"
"GameUI_Language_Brazilian"	"Brasiliansk-portugisisk"
"GameUI_Language_Bulgarian"	"Bulgarsk"
"GameUI_Language_Greek"	"Gresk"
"GameUI_Language_Ukrainian"	"Ukrainsk"
"client_version_out_of_date_title"	"Oppdatering påkrevd"
"dota_abandon_dialog_title"	"Forlat spill"
"dota_abandon_dialog_confirm"	"Er du sikker på at du vil forlate dette spillet?"
"dota_abandon_dialog_yes"	"Ja, forlat kamp."
"dota_leave_dialog_title"	"Forlat kamp"
"dota_leave_dialog_confirm"	"Er du sikker på at du vil forlate denne kampen?"
"dota_leave_dialog_yes"	"Ja, forlat kamp."
"dota_accept_match_title"	"Kampen din er klar"
"dota_accept_match_readyup_title"	"Venter på spillere"
"dota_accept_match_accept"	"Godta"
"dota_accept_match_accept_button"	"{s:accept}"
"dota_accept_match_decline"	"Avslå kamp"
"dota_accept_match_subtitle"	"{s:subtitle}"
"dota_finding_match_generic"	"Normal kamp"
"dota_match_connected"	"Koblet til spillet"
"dota_match_connecting"	"Kobler til spill..."
"dota_match_in_progress"	"Spill pågår"
"dota_match_finished"	"Spill ferdig"
"matchmaking_waiting_for_players"	"Venter på andre spillere"
"matchmaking_player_declined"	"En spiller avslo kampen"
"dota_match_find_server"	"Finner tjener"
"ranked_mmr_solo_value"	"{i:solo_mmr}"
"ranked_mmr_party_label"	"Gruppe"
"ranked_mmr_party_value"	"{i:party_mmr}"
"dota_ready_up_count"	"{s:ready_up_ready} / {s:ready_up_lobby_members}"
"dota_play_practice_1v1"	"Tren 1v1"
"dota_play_practice_1v1_playtab"	"TREN 1v1"
"dota_play_button_label"	"{s:play_button_label}"
"dota_play"	"Spill Dota"
"dota_reconnect"	"Koble til igjen"
"dota_abandon_game"	"Forlat"
"dota_safe_leave_game"	"Forlat kamp"
"dota_disconnect"	"Koble fra"
"dota_play_unavailable"	"Ikke tilgjengelig"
"dota_leaver_consequence_tooltip_header"	"Konskvenser"
"dota_leaver_consequences"	"{s:leaver_consequences}"
"dota_leaver_consequences_details"	"{s:leaver_consequences_details}"
"dota_leaver_view_tooltip"	"Vis detaljer"
"dota_reconnect_popup_title"	"Koble til igjen?"
"dota_matchmaking_region_ping"	"{s:region_ping}"
"dota_matchmaking_region_offline"	"Frakoblet for vedlikehold"
"DOTA_VAC_Verification_Button1"	"Mer informasjon"
"DOTA_VAC_Verification_Button2"	"Lukk"
"dota_matchmaking_regions_button"	"{s:regions_selected}"
"dota_region_automatic"	"Region: automatisk"
"dota_regions_selected"	"Regioner: "
"dota_lobby_region_invalid"	"Ingen"
"dota_play_no_language_selected"	"VELG SPRÅK"
"dota_play_language"	"{s:match_language}"
"dota_ready_fail"	"GJORDE DEG IKKE KLAR"
"dota_ready_fail_desc"	"Kampen din var klar, men du svarte ikke i tide og har blitt fjernet fra matchmaking-køen."
"dota_chatwheel_label_Ok"	"Okay"
"dota_chatwheel_label_GetBack"	"Trekk tilbake"
"dota_chatwheel_label_Help"	"Hjelp"
"dota_chatwheel_label_GoodJob"	"Bra spilt"
"dota_chatwheel_label_Missing"	"Borte"
"dota_chatwheel_label_Follow"	"Følg meg"
"dota_chatwheel_label_OMW"	"Jeg er på vei"
"dota_chatwheel_label_Bait"	"Lokk dem"
"dota_chatwheel_label_Enemy_Incoming"	"Innkommende"
"dota_chatwheel_label_Fight_Under_Tower"	"Under tårn"
"dota_chatwheel_label_Deny_Tower"	"Deny tårn"
"dota_chatwheel_label_Wait"	"Vent"
"dota_chatwheel_label_Current_Time"	"Nåværende tid"
"dota_chatwheel_label_GLHF"	"Lykke til"
"dota_chatwheel_label_Nice"	"Bra"
"dota_chatwheel_label_Thanks"	"Takk"
"dota_chatwheel_label_Sorry"	"Beklager"
"dota_chatwheel_label_No_Give_Up"	"Gi ikke opp"
"dota_chatwheel_label_Regret"	"Angrer"
"dota_chatwheel_label_GG"	"GG"
"dota_chatwheel_header_enemy"	"Fiende"
"dota_chatwheel_header_items"	"Gjenstander"
"dota_chatwheel_header_neutrals"	"Nøytrale"
"dota_chatwheel_header_flavor"	"Stemning"
"dota_chatwheel_message_Ok"	"Okay."
"dota_chatwheel_message_Care"	"Forsiktig!"
"dota_chatwheel_message_GetBack"	"Tilbake!"
"dota_chatwheel_message_Help"	"Hjelp!"
"dota_chatwheel_message_GoodJob"	"Bra spilt!"
"dota_chatwheel_message_Missing"	"Borte!"
"dota_chatwheel_message_Go"	"Gå!"
"dota_chatwheel_message_Follow"	"Følg meg"
"dota_chatwheel_message_Attack"	"Angrip nå!"
"dota_chatwheel_message_BRB"	"Straks tilbake"
"dota_chatwheel_message_Dive"	"Dykk!"
"dota_chatwheel_message_Invis_Enemy"	"Usynlig fiende i nærheten!"
"dota_chatwheel_message_Wait"	"Vent"
"dota_chatwheel_message_Thanks"	"Takk!"
"dota_chatwheel_message_Sorry"	"Beklager"
"dota_settings_options"	"Innstillinger"
"dota_settings_audio"	"Lyd"
"dota_settings_voice"	"Stemme"
"dota_settings_volume"	"Volum"
"dota_settings_video"	"Video"
"dota_settings_abilities"	"Evner"
"dota_settings_abilities_hero"	"Helt"
"dota_settings_abilities_neutrals"	"Nøytrale"
"dota_settings_abilities_primary1"	"1"
"dota_settings_abilities_primary2"	"2"
"dota_settings_abilities_primary3"	"3"
"dota_settings_abilities_secondary1"	"4"
"dota_settings_abilities_secondary2"	"5"
"dota_settings_abilities_neutral1"	"1"
"dota_settings_abilities_neutral2"	"2"
"dota_settings_abilities_neutral3"	"3"
"dota_settings_abilities_neutral4"	"4"
"dota_settings_abilities_courier1"	"1"
"dota_settings_abilities_courier2"	"2"
"dota_settings_abilities_courier3"	"3"
"dota_settings_abilities_courier4"	"4"
"dota_settings_abilities_courier5"	"5"
"dota_settings_abilities_courier6"	"6"
"dota_settings_abilities_ultimate"	"U"
"dota_settings_upgradestats"	"Oppgrader attributt"
"dota_settings_move"	"Bevegelse"
"dota_settings_stop"	"Avbryt gjeldende handling"
"dota_settings_holdposition"	"Hold posisjon"
"dota_settings_selecthero"	"Velg helt"
"dota_settings_selectall"	"Velg alle kontrollerte enheter"
"dota_settings_selectallothers"	"Velg alle andre enheter"
"dota_settings_items"	"Gjenstander"
"dota_settings_camera"	"Kamera"
"dota_settings_cameraup"	"Kamera opp"
"dota_settings_scoreboardtoggle"	"Resultattavle"
"dota_settings_console"	"Konsoll"
"dota_settings_group1"	"Gruppe 1"
"dota_settings_group2"	"Gruppe 2"
"dota_settings_group3"	"Gruppe 3"
"dota_settings_group4"	"Gruppe 4"
"dota_settings_group5"	"Gruppe 5"
"dota_settings_group6"	"Gruppe 6"
"dota_settings_group7"	"Gruppe 7"
"dota_settings_group8"	"Gruppe 8"
"dota_settings_group9"	"Gruppe 9"
"dota_settings_group10"	"Gruppe 10"
"dota_settings_advancedpanel_goto"	"Avansert"
"dota_settings_spectatordropdown_sort"	"Endre sortering"
"dota_settings_spectatordropdown_kda"	"Drap/Dødsfall/Assister"
"dota_settings_spectatordropdown_xp_per_min"	"XP per minutt"
"dota_settings_spectatordropdown_gold_per_min"	"Gull per minutt"
"dota_settings_or"	"Eller"
"dota_settings_cancel"	"Avbryt"
"dota_settings_apply"	"Bruk"
"dota_settings_game"	"Spill"
"dota_settings_profile"	"Profil"
"dota_settings_trade_friends"	"Bare venner"
"dota_settings_network"	"Nettverk"
"dota_settings_networkquality_low"	"Jeg har et svakt nettverk"
"dota_settings_networkquality_high"	"Jeg har et sterkt nettverk"
"dota_settings_customresolution"	"Bruk avanserte innstillinger"
"dota_settings_resolution"	"Oppløsning"
"dota_settings_aspectratio43"	"4:3"
"dota_settings_aspectratio169"	"16:9"
"dota_settings_aspectratio1610"	"16:10"
"dota_settings_resolution_size"	"Størrelse:"
"dota_settings_window"	"I vindu"
"dota_settings_fastestvideo"	"Raskest"
"dota_settings_shadowquality_low"	"Lav"
"dota_settings_musicvolume"	"Musikk"
"dota_settings_voicevolume"	"Stemme"
"dota_settings_defaultaudio"	"Standard"
"dota_settings_sounddevice"	"Lydenhet:"
"dota_settings_headphones"	"Hodetelefoner"
"dota_settings_2speakers"	"2 Høytalere"
"dota_settings_4speakers"	"4 Høytalere"
"dota_settings_unitspeech_off"	"Av"
"dota_settings_unitspeech_all"	"Alle"
"DOTA_Keybind_WASD"	"WASD"
"DOTA_Keybind_MMO"	"MMO"
"DOTA_Hotkeys_Tooltip_HeroSelect"	"Velg helten din."
"DOTA_Hotkeys_Tooltip_ShopToggle"	"Åpne butikkvinduet."
"DOTA_Hotkeys_Tooltip_Autocast"	"Skru på for å automatisk bruke en egenskap når den er klar. Gjelder bare enkelte egenskaper."
"DOTA_Hotkeys_Tooltip_ItemCast"	"Hurtigtaster for å bruke en gjenstand i lagret ditt."
"DOTA_Settings_Tooltip_Autoattack"	"Du vil automatisk bevege deg mot og angripe fiender i nærheten."
"DOTA_Settings_Tooltip_AutoattackAfterSpell"	"Angrip ethvert mål i nærheten med mindre du nettopp har beveget deg, denied et creep, eller trykt på knappen for \"Avbryt gjeldende handling\" eller \"Hold posisjon\"."
"DOTA_Lobby_BotDifficulty"	"BOT-vanskelighetsgrad"
"DOTA_Lobby_BotDifficulty_passive"	"Passiv"
"DOTA_Lobby_BotDifficulty_easy"	"Lett"
"DOTA_Lobby_BotDifficulty_medium"	"Medium"
"DOTA_Lobby_BotDifficulty_hard"	"Vanskelig"
"DOTA_Lobby_BotDifficulty_unfair"	"Urettferdig"
"DOTA_Lobby_BotTeam"	"Velg lag"
"dota_lobby_title"	"{g:dota_filtered_string:lobby_name}"
"dota_lobby_title_local_game"	"Lokal lobby"
"lobby_row_player_name"	"{s:player_name}"
"dota_lobby_row_game_name"	"{s:game_name}"
"dota_lobby_row_slots"	"{s:slots}"
"dota_lobby_row_game_mode"	"{s:game_mode}"
"dota_lobby_row_join"	"Bli med"
"dota_lobby_row_leave"	"Forlat"
"dota_lobby_browser_all_game_modes"	"Alle spillmoduser"
"dota_lobby_browser_refresh"	"Oppdater"
"dota_lobby_submit_filter"	"Send"
"DOTA_Items_SetEquipped_Label"	"Utstyrt"
"DOTA_EquippedItem_Label"	"Utstyrt"
"DOTA_EquippedItem_Rarity"	"{s:equipped_econ_set_rarity}"
"DOTA_EquippedItem_SetName"	"{s:equipped_econ_set_name}"
"DOTA_EquippedItem_Style"	"{i:equipped_econ_set_style_count} stil(er)"
"DOTA_EquippedItem_Button_Details"	"{s:equipped_details_button_text}"
"DOTA_EquippedItem_Customize"	"Tilpass"
"DOTA_EquippedItem_Equip"	"Utstyr"
"DOTA_EquippedItem_Details"	"Detaljer om {s:equipped_econ_set_type_name}"
"DOTA_EquippedItem_Purchase_Button"	"Kjøp"
"DOTA_EquippedItem_Marketplace_Button"	"Marked"
"DOTA_EquippedItem_RegularSetPrice"	"{s:equipped_econ_regular_set_price}"
"DOTA_EquippedItem_SetPrice"	"{s:equipped_econ_set_price}"
"DOTA_EquippedItem_TreasurePrice"	"{s:equipped_econ_treasure_price}"
"DOTA_EquippedItem_Item"	"Gjenstand"
"DOTA_EconItemSet_Name"	"{s:econ_set_name}"
"DOTA_EconItemSet_Rarity"	"{s:econ_set_rarity}"
"DOTA_EconItemSet_Status"	"{s:econ_set_status}"
"DOTA_EconItemSet_Price"	"{s:econ_set_price}"
"DOTA_EconItemSet_SaleAmount"	"-{i:econ_sale_amount}%"
"DOTA_EconItemSet_DeveloperOnly"	"Ikke offentlig"
"DOTA_HeroGrid_OptionCategory_Role"	"Roller:"
"DOTA_HeroGrid_OptionCategory_Attributes"	"Egenskaper:"
"DOTA_HeroLoadout_PreviousHeroName"	"{s:previous_hero_name}"
"DOTA_HeroLoadout_NextHeroName"	"{s:next_hero_name}"
"DOTA_HeroLoadout_CurrentHeroName"	"{s:hero_name}"
"DOTA_HeroLoadout_AttackType"	"{s:hero_attack_type}"
"DOTA_HeroLoadout_HeroFilterName"	"Helt"
"DOTA_HeroCustomize_OwnedItems"	"Eide gjenstander"
"DOTA_HeroCustomize_Slot"	"Plass"
"DOTA_HeroCustomize_SlotName"	"{s:slot_name}"
"DOTA_HeroCustomize_SlotEquippedItemName"	"{s:equipped_item_name}"
"DOTA_HeroCustomize_PreviewItemName"	"{s:preview_item_name}"
"DOTA_HeroCustomize_PreviewStyle"	"{s:preview_style_name}"
"DOTA_HeroCustomize_PreviewItemSlot"	"{s:preview_item_slot}"
"DOTA_HeroCustomize_Rarity"	"{s:preview_item_rarity}"
"DOTA_UIEconItem_StyleIndex"	"{i:style_index}"
"dota_ready_up_num_accepted"	"{i:num_accepted} / {i:total_players} aksepterte"
"returning_top_of_queue"	"Går tilbake til matchmaking med høy prioritet"
"GC_nosteam"	"Mistet tilkobling til Steam"
"GC_Wait_Time_Unknown"	"Ukjent"
"DOTA_CurrentTime"	"{t:t:current_time}"
"DOTA_MonthlyPlayers"	"{s:users_last_month}"
"DOTA_CurrentPlayers"	"{s:current_users}"
"join_error_generic"	"

"
"join_error_lobby_full"	"Lobbyen er full."
"DOTA_Friends_Ready_To_Play"	"Åpne spill"
"DOTA_Friend_Finding_Match"	"Finner kamp..."
"DOTA_Friend_In_Match"	"I kamp"
"DOTA_Friend_Solo_Open_Party"	"{s:player_name} ønsker å spille"
"DOTA_Friend_In_Party_Open"	"{s:player_name} er i en åpen gruppe"
"DOTA_Friend_Solo_Open_Party_Self"	"Du ser etter gruppemedlemmer"
"DOTA_Friend_In_Open_Party_Self"	"Du er i en åpen gruppe"
"DOTA_Friends_In_Party_Open"	"{d:num_friends} venner i åpen gruppe"
"DOTA_Friend_Lobby_Mode_1_Friend"	"{s:player_name} i {s:game_mode}-lobby"
"DOTA_Friend_Lobby_Mode_N_Friends"	"{d:num_friends} venner i {s:game_mode}-lobby"
"DOTA_Friend_Lobby_Mode_Small"	"{s:game_mode}-lobby"
"DOTA_Friend_Lobby_Players"	"{d:player_count} / {d:max_player_count}"
"DOTA_Friend_Lobby_Join_Button"	"{s:join_button_text}"
"DOTA_Friend_Lobby_Friend_Count"	"+{d:extra_friend_count}"
"DOTA_Friend_Invite_To_Party"	"Inviter til gruppe"
"DOTA_Friend_JoinParty"	"Bli med i gruppe"
"DOTA_Friend_Watch"	"Se på"
"DOTA_PartyVisTooltip_SoloTitleOpen"	"Ønsker å spille"
"DOTA_Feed_Timestamp_Recently"	"Nå nettopp"
"DOTA_Feed_Timestamp_MinutesAgo"	"{i:value} minutter siden"
"DOTA_Feed_Timestamp_HourAgo"	"{i:value} time siden"
"DOTA_Feed_Timestamp_HoursAgo"	"{i:value} timer siden"
"DOTA_Feed_Timestamp_Date"	"{s:day} {s:month}"
"dota_lobby_type_general"	"Urangert"
"dota_lobby_type_practice"	"Trening"
"dota_lobby_type_tournament"	"Turnering"
"dota_lobby_unknown"	"Ukjent"
"dota_match_result_none"	"???"
"DOTA_LoadingPlayerUnknown"	"-"
"DOTA_LoadingPlayerFullyConnected"	"Klar"
"DOTA_LoadingPlayerFailed"	"Mislyktes"
"LoadingScreenTimer"	"{t:d:countdown_timer_seconds}"
"HeroSelectionTimer"	"{i:timer_seconds}"
"LoadingScreenMapInfo"	"Kart: {s:map_name}"
"custom_end_screen_victory_message"	"{s:winning_team_name} vant!"
"custom_end_screen_legend_player"	"Spiller"
"custom_end_screen_legend_level"	"Nivå"
"custom_end_screen_legend_hero"	"Helt"
"custom_end_screen_legend_kills"	"K"
"custom_end_screen_legend_deaths"	"D"
"custom_end_screen_legend_assists"	"A"
"custom_end_screen_legend_items"	"Gjenstander"
"custom_end_screen_legend_gold"	"Gull"
"custom_end_screen_legend_team_score"	"Poeng"
"CustomEndScreenClose"	"Lukk"
"DOTA_Armory_Category_Heroes"	"Helter"
"DOTA_Armory_Category_World"	"Verden"
"DOTA_Armory_Category_Emoticons"	"Uttrykksikon"
"DOTA_Armory_Category_Audio"	"Lyd"
"DOTA_Armory_Category_Music"	"Musikk"
"DOTA_Armory_Category_All"	"Alle"
"DOTA_Armory_SortBy_Rarity"	"Sjeldenhet"
"DOTA_Armory_SortBy_Quality"	"Kvalitet"
"DOTA_Armory_SortBy_Name"	"Navn"
"DOTA_Armory_ContextMenu_Equip"	"Utstyr gjenstand"
"DOTA_Armory_ContextMenu_Delete"	"Slett"
"dota_page_match_details_loading"	"Laster kamp..."
"dota_page_match_details_victory"	"Vinner: {s:winner}"
"dota_page_match_details_legend_player"	"Spiller"
"dota_page_match_details_legend_level"	"Nivå"
"dota_page_match_details_legend_hero"	"Helt"
"dota_page_match_details_legend_kills"	"K"
"dota_page_match_details_legend_deaths"	"D"
"dota_page_match_details_legend_assists"	"A"
"dota_page_match_details_legend_items"	"Gjenstander"
"dota_page_match_details_legend_gold"	"Gull"
"dota_page_match_details_legend_denies"	"DN"
"dota_page_match_details_legend_gold_per_min"	"GPM"
"dota_page_match_details_legend_xp_per_min"	"XPM"
"dota_page_match_details_legend_winner_tooltip"	"Vinnerlag"
"dota_page_match_details_legend_kills_tooltip"	"Drap"
"dota_page_match_details_legend_deaths_tooltip"	"Dødsfall"
"dota_page_match_details_legend_assists_tooltip"	"Assister"
"dota_page_match_details_legend_gold_per_min_tooltip"	"Gull per minutt"
"dota_page_match_details_header_game_mode"	"Spillmodus"
"dota_page_match_details_header_duration"	"Varighet"
"dota_page_match_details_voting_votes"	"{i:num_votes} stemmer"
"dota_page_match_details_comment_placeholder"	"Skriv en kommentar.."
"dota_page_match_details_comment_loading_comments"	"Laster inn kommentarer..."
"dota_page_match_details_replay_existence_cdn_found"	"Last ned reprise"
"dota_page_match_details_replay_existence_downloading"	"Laster ned..."
"dota_page_match_details_replay_existence_disk_found_highlights"	"Se høydepunkter"
"dota_profile_content_tab_activity_feed"	"Aktivitetsfeed"
"dota_profile_recent_game_header_timestamp"	"Dato / Tid"
"dota_profile_recent_game_header_result"	"Resultat"
"dota_profile_recent_game_header_duration"	"Varighet"
"dota_profile_recent_game_result_abandon"	"Forlat"
"dota_profile_recent_game_icon_source1"	"S1"
"dota_profile_hero_with_index"	"{d:hero_index} {s:hero_name}"
"dota_profile_hero"	"{s:hero_name}"
"DOTA_tooltip_econ_item_name"	"{g:dota_filtered_string:item_name}"
"DOTA_tooltip_econ_item_description"	"{g:dota_filtered_string:item_description}"
"DOTA_tooltip_econ_item_rarity_label"	"Sjeldenhet: "
"DOTA_tooltip_econ_item_rarity"	"{s:item_rarity}"
"DOTA_tooltip_econ_item_gifter"	"{g:dota_persona:gifter_name}"
"DOTA_tooltip_econ_item_market_restriction_permanent"	"Ikke omsettelig"
"DOTA_tooltip_econ_item_gem_type"	"{s:gem_type}"
"DOTA_tooltip_econ_item_gem_strange_count"	"{d:strange_count}"
"DOTA_tooltip_econ_item_gem_description"	"{s:gem_description}"
"DOTA_tooltip_econ_item_partner"	"{s:partner}"
"DOTA_econ_item_details_item_name"	"{g:dota_filtered_string:item_name}"
"DOTA_econ_item_details_rarity_label"	"Sjeldenhet: "
"DOTA_econ_item_details_item_rarity"	"{s:item_rarity}"
"DOTA_econ_item_details_item_description"	"{g:dota_filtered_string:item_description}"
"DOTA_econ_item_details_gem_type"	"{s:gem_type}"
"DOTA_econ_item_details_gem_strange_count"	"{d:strange_count}"
"DOTA_econ_item_details_gem_description"	"{s:gem_description}"
"DOTA_Treasure_Name"	"{s:treasure_name}"
"custom_game_team_select_timer"	"{i:countdown_timer_seconds}"
"custom_game_team_select_starting"	"Starter"
"custom_game_team_select_join"	"Bli med"
"DOTA_GlobalItems_Emoticons"	"Uttrykksikon"
"DOTA_GlobalItems_Audio"	"Lyd"
"DOTA_GlobalItems_Music"	"Musikk"
"DOTA_Search"	"Søk"
"DOTA_PleaseWait"	"Vennligst vent..."
"dota_lobby_settings_edit"	"Rediger"
"dota_lobby_leave"	"Forlat denne lobbyen"
"DOTA_Custom_Game_Friends_Who_Play"	"Venner som spiller"
"DOTA_Custom_Game_Friends_Playing_Now"	"Venner som spiller nå"
"DOTA_Custom_Game_Browse_Sort"	"Sorter:"
"DOTA_WatchLive_WatchLabel"	"SE PÅ:"
"DOTA_WatchLive_Steam"	"STEAM"
"DOTA_WatchLive_InGame"	"I SPILL"
"dota_play_connecting_to_server"	"Kobler til..."
"dota_reconnecting"	"Kobler til på nytt..."
"dota_matchmaking_regions_retry"	"Prøv på nytt"
"dota_matchmaking_region_or"	"Eller"
"dota_settings_fullscreenbrightness"	"Lysstyrke"
"dota_lobby_browser_header_name"	"Lobbynavn"
"dota_lobby_browser_header_slots"	"Plasser"
"dota_lobby_browser_header_game_mode"	"Spillmodus"
"dota_lobby_browser_region"	"Region"
"dota_lobby_browser_lobby_name"	"Lobbynavn"
"DOTA_Friend_Game_Mode_1_Friend"	"{s:player_name} spiller {s:game_mode}"
"DOTA_Friend_Game_Mode_N_Friends"	"{d:num_friends} venner spiller {s:game_mode}"
"Compendium_DefaultText_CD_Days"	"Dager"
"Compendium_DefaultText_CD_Hours"	"Timer"
"Compendium_DefaultText_CD_Minutes"	"Minutter"
"Compendium_DefaultText_CD_Seconds"	"Sekunder"
"DOTA_ActorCredits_28_Name"	"

"
"DOTA_ActorCredits_28_Heroes"	"

"
"DOTA_WatchLive_Fullscreen"	"FULLSKJERM"
"DOTA_JoinChatChannel_ChannelMemberCount"	"Medlemmer"
"DOTA_Chat_ChannelMemberCount"	"{d:channel_member_count}"
"DOTA_GiftWrap_Success_Header"	"Suksess"
"DOTA_GiftWrap_Success"	"Din gave har blitt levert."
"dota_settings_about"	"Om"
"DOTA_Previous"	"Forrige"
"DOTA_PreviousShort"	"Forrige"
"DOTA_Next"	"Neste"
"DOTA_Friends_Add_Friend_Tooltip"	"Legg til venn"
"DOTA_Armory_ActiveFilter"	"{s:filter_field} {s:filter_op} {s:filter_value}"
"DOTA_Treasure_ViewAll"	"Vis alle skatter"
"DOTA_Treasure_Gift"	"Gave"
"DOTA_Treasure_Open"	"Åpne"
"DOTA_Treasure_OpenQuantity"	"{d:owned_quantity}"
"DOTA_Treasure_Owned"	"Eid"
"DOTA_Treasure_Received"	"Mottatt"
"DOTA_Treasure_Autographed"	"Autograf"
"DOTA_Treasure_AutographName"	"{s:treasure_autograph_name}"
"DOTA_OpenTreasureTooltip_UnitName"	"{g:dota_item_unit_name:item_def}"
"DOTA_OpenTreasureTooltip_ItemName"	" - {g:dota_item_name:item_def}"
"dota_profile_oi_team"	"LAG"
"dota_profile_oi_country"	"LAND"
"dota_profile_oi_submit_info"	"Send"
"dota_profile_oi_submit_success"	"Suksess!"
"dota_role_core"	"Kjerne"
"dota_role_support"	"Støtte"
"DOTA_Treasure"	"Skatt"
"DOTA_SortBy"	"Sorter etter"
"DOTA_SortOption_Newest"	"Nyeste"
"DOTA_SortOption_Owned"	"Eid"
"DOTA_SortOption_Price"	"Pris"
"DOTA_SortOption_Alphabetical"	"Alfabetisk"
"Action_Use"	"Bruk"
"DOTA_BadgeLevel"	"{d:badge_level}"
"DOTA_AHC_CurrentHeroName"	"{s:current_hero_name}"
"DOTA_AHC_CurrentHeroAttempts"	"{s:current_hero_attempts} forsøk"
"DOTA_AHC_CurrentHeroAverageAttempts"	"{f:1:current_hero_average_attempts} forsøk"
"DOTA_AHC_NextHeroName"	"{s:next_hero_name}"
"DOTA_AHC_HeroesCompletedValue"	"{d:heroes_completed} / {d:heroes_total}"
"DOTA_AHC_TotalAttempts"	"Totale forsøk"
"DOTA_AHC_TotalAttemptsValue"	"{d:challenge_total_attempts} kamper"
"DOTA_AHC_EquivalentWorldAverageValue"	"{d:challenge_average_total_attempts} kamper"
"DOTA_AHC_FullChallengesCompletedValue"	"{d:full_challenges_completed}"
"DOTA_AHC_BestFullChallengeValueNone"	"N/A"
"DOTA_AHC_BestFullChallengeValue"	"{d:best_full_challenge} kamper"
"DOTA_AHC_FullChallengeAverageValue"	"{f:2:full_challenge_average} kamper"
"DOTA_AHC_ChallengeTrophyName"	"{s:challenge_trophy_name}"
"DOTA_AHC_ChallengeTrophyLevel"	"Nivå {d:challenge_trophy_level}"
"DOTA_Trophies_ViewEarned"	"Oppnådd"
"DOTA_Party_Add_Friends"	"Legg til venner for å opprette en gruppe"
"DOTA_ItemSet_Count_text"	"{d:item_current_group} / {d:item_group_count}"
"dota_settings_enable_console"	"Aktiver konsoll"
"DOTA_HeroLoadout_About"	"Om"
"DOTA_HeroLoadout_Guides"	"Guider"
"DOTA_HeroLoadout_Roles"	"Roller"
"DOTA_HeroLoadout_Biography"	"Biografi"
"DOTA_EffigyEditor_Model"	"Helt"
"DOTA_EffigyEditor_Animation"	"Animasjon:"
"DOTA_tooltip_econ_item_modifier_animation"	"Animasjon"
"DOTA_tooltip_econ_item_modifier_announcer"	"Oppleser"
"DOTA_tooltip_econ_item_modifier_model"	"Modell"
"DOTA_tooltip_econ_item_modifier_scale"	"Skala"
"DOTA_tooltip_econ_item_modifier_wearable"	"Brukbar"
"DOTA_tooltip_econ_item_modifier_weather"	"Vær"
"DOTA_tooltip_econ_item_modifier_sound"	"Lyd"
"DOTA_tooltip_econ_item_modifier_icon"	"Ikon"
"DOTA_econ_item_details_style_label"	"Stiler:"
"DOTA_econ_item_details_gift_label"	"Gave fra:"
"Compendium_DLFailed"	"Nedlasting mislyktes"
"Compendium_Retry"	"Prøv på nytt"
"Compendium_preview_click"	"Klikk for mer informasjon"
"Compendium_level"	"NIVÅ"
"Compendium_to_next_level"	"TIL NESTE NIVÅ"
"Compendium_LevelupPts_Plural"	"{d:next_comp_level} poeng"
"DOTA_AntiAddiction_CompleteInfoNotNow"	"Ikke nå"
"DOTA_AntiAddiction_Initial_DateFormat"	"%s1Y%s2M%s3D %s4:%s5:%s6"
"DOTA_Workshop_TextureName_color"	"Farge"
"DOTA_Workshop_Model"	"Modell"
"DOTA_Workshop_Animations"	"Animasjoner"
"DOTA_Workshop_SaveSettings"	"Lagre innstillinger"
"DOTA_Workshop_LoadSettings"	"Last inn innstillinger"
"DOTA_Workshop_Ready"	"Klar"
"DOTA_Workshop_Optional"	"Valgfri"
"DOTA_Workshop_Required"	"Påkrevd"
"DOTA_Workshop_Models_Title"	"Modeller"
"DOTA_Workshop_Materials_Title"	"Materialer"
"DOTA_Workshop_Attachments_Title"	"Vedlegg"
"DOTA_Workshop_Particles_Title"	"Partikler"
"DOTA_Workshop_Images_Title"	"Bilder"
"DOTA_Workshop_ImportChatEmoticon_Preview"	"Forhåndsvisning"
"DOTA_Workshop_Animation_Title"	"Animasjoner"
"DOTA_Workshop_Animation_UIBlock"	"Animasjoner %s1"
"DOTA_Workshop_Preview_Anim"	"Animasjon:"
"DOTA_Workshop_Preview_Gesture"	"Overlegg:"
"DOTA_Workshop_Preview_Skin"	"Tekstur:"
"DOTA_Workshop_Preview_Model"	"Modell:"
"DOTA_Workshop_Preview_NoAttachment"	"Ingen"
"DOTA_Workshop_Import"	"Importer"
"DOTA_Workshop_Importing"	"Importerer"
"DOTA_Workshop_Import_Failed"	"IMPORT FEILET"
"DOTA_Workshop_Animation_Idle"	"Uvirksom"
"DOTA_Workshop_Animation_Run"	"Løp"
"DOTA_Workshop_Animation_Die"	"Dø"
"DOTA_Workshop_Animation_Attack"	"Angrip"
"DOTA_Workshop_GameDay"	"Dag"
"DOTA_Workshop_GameNight"	"Natt"
"DOTA_Workshop_Next"	"Neste"
"DOTA_Workshop_Prev"	"Forrige"
"DOTA_Event_Level"	"Nivå"
"DOTA_Done"	"Ferdig"
"DOTA_Treasure_OpenTreasure"	"Åpne skatt"
"DOTA_Treasure_OpenSuccess"	"Gratulerer! Du mottok:"
"DOTA_TabName_Heroes"	"Helter"
"DOTA_Profile_ViewSteamProfile"	"Vis Steam-profil"
"DOTA_Trophies_ViewAvailable"	"Tilgjengelige"
"DOTA_TrophyXPProgress"	"{d:trophy_xp} / {d:total_trophy_xp}<span class=\"TrophyPointTextSmall\">TP</span>"
"DOTA_TrophyDetails_XP"	"{d:trophy_details_xp}<span class=\"TrophyPointTitleSmall\">TP</span>"
"DOTA_Lobby_Settings_Tournament_None"	"Ingen"
"DOTA_WatchReplays_Game1"	"Spill 1"
"DOTA_WatchReplays_Game2"	"Spill 2"
"DOTA_WatchReplays_Game3"	"Spill 3"
"DOTA_WatchReplays_Game4"	"Spill 4"
"DOTA_WatchReplays_Game5"	"Spill 5"
"DOTA_WatchTournaments_View"	"Vis"
"DOTA_WatchTournaments_Region_NA"	"Nord-Amerika"
"DOTA_WatchTournaments_Region_SA"	"Sør-Amerika"
"DOTA_WatchTournaments_Region_EU"	"Europa"
"DOTA_WatchTournaments_Region_RU"	"Russland"
"DOTA_WatchTournaments_Region_CN"	"Kina"
"DOTA_WatchTournament_BestOf3"	"Best av 3"
"DOTA_WatchTournament_BestOf5"	"Best av 5"
"DOTA_WatchTournament_Spectators"	"{i:spectators} tilskuere"
"DOTA_Armory_Category_Gifts"	"Gaver"
"DOTA_Popup_Item_Received_Header_Purchased"	"Du har kjøpt en gjenstand!!"
"DOTA_Popup_Item_Received_Header_PreviewItem"	"Du tester en ny gjenstand!"
"DOTA_Popup_Item_Received_Header_PreviewItemPurchased"	"Du har kjøpt en gjenstand!"
"DOTA_Popup_Item_Received_Header_CommunityMarketPurchase"	"Du har kjøpt en gjenstand!"
"DOTA_Popup_Item_Received_Label_IOfN"	"{d:item_i} av {d:item_n}"
"DOTA_Popup_Item_Received_Button_Accept"	"Godta"
"DOTA_Popup_Item_Received_Button_AcceptAll"	"Godta alle ({d:item_n})"
"LobbySetting_League_Value"	"{s:lobbysetting_league}"
"DOTA_Treasure_HelpHeader"	"Hver skatt inneholder {d:items_per_treasure} av disse gjenstandene"
"DOTA_Treasure_FilterAvailable"	"Tilgjengelig"
"DOTA_Treasure_FilterAll"	"Alle"
"dota_settings_shadowquality_off"	"Av"
"dota_lobby_host"	"Lobbyvert: {g:dota_filtered_string:lobby_host_name}"
"dota_lobby_row_region"	"{s:region}"
"dota_lobby_browser_header_region"	"Region"
"DOTA_Armory_Category_CompendiumLevels"	"Nivåer"
"dota_profile_recent_game_result_win_ranked"	"{i:ranked_mmr} (+{i:ranked_mmr_delta})"
"dota_profile_recent_game_result_loss_ranked"	"{i:ranked_mmr} ({i:ranked_mmr_delta})"
"DOTA_tooltip_econ_item_gift_dedication"	"{g:dota_filtered_string:gift_dedication}"
"DOTA_econ_item_details_original_name_label"	"Orginal navn:"
"DOTA_econ_item_details_style_name"	"{s:style_name}"
"DOTA_econ_item_details_style_available"	"Velg"
"DOTA_econ_item_details_tooltip_lock_reason"	"{s:style_lock_reason}"
"DOTA_econ_item_details_description_edit"	"Rediger"
"DOTA_Workshop_BrowseForImageFilter"	"Bilde"
"DOTA_Teams_WindowTitle"	"LAG"
"DOTA_TeamImages"	"Bilder"
"DOTA_JoinChatChannel_Custom"	"Bruker"
"DOTA_Chat_ChannelDistance"	"{s:channel_distance}km"
"DOTA_Chat_CustomGameChannelName"	"{g:dota_custom_game_name:channel_name}"
"DOTA_ChatTarget_Format_CustomGame"	"{g:dota_custom_game_name:custom_game_id}"
"DOTA_Frontpage_LastMatch_Items"	"Gjenstander"
"dota_profile_oi_cancel"	"Avbryt"
"DOTA_tooltip_econ_item_leaguename"	"{s:league_name}"
"DOTA_tooltip_econ_item_matchevent"	"{s:tournament_event}"
"DOTA_tooltip_econ_item_matchdate"	"MOTTATT: {t:l:tournament_date}"
"DOTA_tooltip_econ_item_team1_name"	"{s:team1_name}"
"DOTA_tooltip_econ_item_team2_name"	"{s:team2_name}"
"DOTA_tooltip_econ_item_event_description"	"{s:event_description}"
"DOTA_Compendium_Coin_Bank"	"{d:coin_bank}"
"DOTA_Compendium_Coin_Plus"	"+"
"DOTA_Compendium_Coins_Gained"	"{d:coins_gained}"
"DOTA_Workshop_ItemImport_HeroName_Label"	"Helt:"
"DOTA_ItemPicker_Title"	"Velg en gjenstand"
"LoadingScreenGameMode"	"{s:game_mode}"
"DOTA_Compendium_Level_Number"	"{d:compendium_level}"
"DOTA_Compendium_Level_Points"	"{d:compendium_points}"
"DOTA_ReforgeItem_Title"	"{g:dota_item_name:header_item_def}"
"DOTA_ChatCommand_ShareLobby_Name"	"Del lobby"
"dota_settings_application"	"Program"
"DOTA_econ_item_details_go_to_loadout"	"Oppakning: {s:item_owner_type}"
"DOTA_Profile_LeaguePassCount"	"{d:league_pass_count} turneringspass"
"DOTA_TournamentBracket_MatchList_Timestamp"	"{T:l:timestamp}"
"DOTA_WatchLive_Game_ProInfo"	"{g:dota_persona:pro:account_id} {s:hero_name}"
"DOTA_WatchLive_Game_AverageMMR"	"{i:avg_mmr} gjennomsnittlig MMR"
"DOTA_WatchLive_Game_TimeAndScore"	"{t:d:duration} / {i:radiant_score} – {i:dire_score}"
"DOTA_WatchLive_Game_Round"	"
"
"competitive_team_identity_checkbox"	"Spill som {s:team_identity_tag}"
"ranked_mmr_team_label"	"Lag"
"ranked_mmr_team_value"	"{d:team_identity_rank}"
"DOTA_econ_item_details_toggle_equip_state"	"{s:item_toggle_equip_state}"
"DOTAWatchDownloads_Size"	"{i:disk_space} MB"
"DOTAWatchDownloads_Teams"	"{s:team_1} vs. {s:team_2}"
"LoadingScreen_TipText"	"{s:tip}"
"DOTA_econ_item_details_original_item_name"	"{s:original_item_name}"
"DOTA_Purchase_Popup_Title"	"{s:purchase_item_title}"
"DOTA_Purchase_Popup_Body"	"{s:purchase_item_body}"
"DOTA_Purchase_Popup_RegularSetPrice"	"{m:item_regular_price}"
"DOTA_Purchase_Popup_SetPrice"	"{m:item_price}"
"DOTA_Generic_Popup_Title"	"{s:generic_popup_title}"
"DOTA_Generic_Popup_Body"	"{s:generic_popup_body}"
"Customization_Name"	"Navn"
"Customization_Description_Tool"	"Merkelapp"
"DOTA_OwnedItemDetails_Style"	"{i:item_style_count} stil(er)"
"UI_Off"	"Av"
"DOTA_PartnerPurchase_ItemName"	"{s:item_name}"
"DOTA_PartnerPurchase_ItemCount"	"{d:item_count}"
"DOTA_PartnerPurchase_ItemPrice"	"{m:item_price}"
"DOTA_TournamentBracket_GrandFinals"	"Hovedfinale"
"DOTA_TournamentBracket_UBFinals"	"Øvre finale"
"DOTA_TournamentBracket_UBSemiFinals"	"Øvre semifinale"
"DOTA_TournamentBracket_UBQuarterFinals"	"Øvre kvartfinale"
"DOTA_TournamentBracket_LosersMatch"	"Elimineringskamp"
"DOTA_TournamentBracket_Qualification1"	"Første kvalik"
"DOTA_TournamentBracket_Qualification2"	"Andre kvalik"
"DOTA_TournamentBracket_AllStar"	"All-Star-kamp"
"DOTA_TournamentBracket_TieBreaker"	"Omspill"
"DOTA_TournamentBracket_Group1"	"Gruppe A"
"DOTA_TournamentBracket_Group2"	"Gruppe B"
"DOTA_TournamentBracket_Group3"	"Gruppe C"
"DOTA_TournamentBracket_Group4"	"Gruppe D"
"DOTA_TournamentBracket_Group5"	"Gruppe E"
"DOTA_TournamentBracket_Group6"	"Gruppe F"
"DOTA_TournamentBracket_Group7"	"Gruppe G"
"DOTA_TournamentBracket_Group8"	"Gruppe H"
"DOTA_TournamentBracket_Match1"	"Kamp 1"
"DOTA_TournamentBracket_Match2"	"Kamp 2"
"DOTA_TournamentBracket_Match3"	"Kamp 3"
"DOTA_TournamentBracket_Match4"	"Kamp 4"
"DOTA_TournamentBracket_Match5"	"Kamp 5"
"DOTA_TournamentBracket_Match6"	"Kamp 6"
"DOTA_TournamentBracket_Match7"	"Kamp 7"
"DOTA_TournamentBracket_Match8"	"Kamp 8"
"DOTA_TournamentBracket_Match9"	"Kamp 9"
"DOTA_TournamentBracket_Match10"	"Kamp 10"
"DOTA_TournamentBracket_LBR1"	"Nedre runde 1"
"DOTA_TournamentBracket_LBR2"	"Nedre runde 2"
"DOTA_TournamentBracket_LBR3"	"Nedre runde 3"
"DOTA_TournamentBracket_LBR4"	"Nedre runde 4"
"DOTA_TournamentBracket_LBR5"	"Nedre runde 5"
"DOTA_TournamentBracket_LBR6"	"Nedre runde 6"
"DOTA_TournamentBracket_LBFinals"	"Nedre finale"
"DOTA_TournamentBracket_Sidebar_Watch"	"Se på"
"DOTA_TournamentBracket_MatchList_TBD"	"Ikke bestemt"
"DOTA_TournamentBracket_Sidebar_Stage"	"{s:stage} (best av {i:best_of})"
"DOTA_TournamentBracket_Sidebar_Live"	"Pågår"
"DOTA_TournamentBracket_Sidebar_TimeRemaining"	"Start: {t:m:r:duration}"
"DOTA_TournamentBracket_Sidebar_WinnerGoes"	"Vinneren avanserer til {s:winner_goes}"
"DOTA_TournamentBracket_Sidebar_LoserGoes"	"Taperen rykker ned til {s:loser_goes}"
"DOTA_TournamentBracket_Sidebar_LoserEliminated"	"Taperen blir slått ut"
"DOTA_TournamentBracket_Sidebar_WinnerChampion"	"Vinneren får mestertittelen"
"DOTA_TournamentBracket_Sidebar_PreviousMatch"	"Foregående kamp for {s:name}: {s:prevscore} mot {s:prevopponent}"
"DOTA_TournamentNewsDate"	"{t:r:m:date}"
"DOTATournamentBracket_MatchDate"	"{t:s:date}"
"DOTA_TournamentBracket_RowRank"	"{i:rank}"
"DOTA_TournamentBracket_RowTeamName"	"{s:team_name}"
"DOTA_TournamentBracket_RowGamesPlayed"	"{i:played}"
"DOTA_TournamentBracket_RowPoints"	"{i:won} – {i:tied} – {i:lost}"
"DOTA_TournamentBracket_Score"	"{i:score}"
"DOTA_TournamentMatchListTime"	"{t:s:time}"
"DOTA_TournamentMatchListTeam1"	"{s:team1}"
"DOTA_TournamentMatchListTeam2"	"{s:team2}"
"DOTA_TournamentMatchListScore"	"{i:score1} – {i:score2}"
"DOTA_TournamentButtonWatch"	"Se på"
"DOTATournamentBracketGroupPhase"	"Gruppespill"
"DOTATournamentDetailsPhase"	"{s:phase}"
"DOTATournamentBracketTeams"	"Lag"
"DOTATournamentStage"	"{s:stage_name}"
"DOTA_econ_item_details_item_creation_date"	"Utgitt: {t:l:creation_date}"
"DOTA_Workshop_MoreInfoURL"	"(Mer informasjon)"
"FrontPage_VideoStream_Live"	"Direkte"
"FrontPage_VideoStream_Teams"	"{s:team_1} vs. {s:team_2}"
"FrontPage_VideoStream_GameState"	"{s:stage_name}"
"FrontPage_VideoStream_BroadcastUpcomingTime"	"{t:r:m:upcoming_broadcast_time}"
"DOTA_TournamentBracket_Sidebar_Soon"	"Starter snart"
"UI_month_0"	"januar"
"UI_month_1"	"februar"
"UI_month_2"	"mars"
"UI_month_3"	"april"
"UI_month_4"	"mai"
"UI_month_5"	"juni"
"UI_month_6"	"juli"
"UI_month_7"	"august"
"UI_month_8"	"september"
"UI_month_9"	"oktober"
"UI_month_10"	"november"
"UI_month_11"	"desember"
"UI_month_short_0"	"jan."
"UI_month_short_1"	"feb."
"UI_month_short_2"	"mars"
"UI_month_short_3"	"apr."
"UI_month_short_4"	"mai"
"UI_month_short_5"	"juni"
"UI_month_short_6"	"juli"
"UI_month_short_7"	"aug."
"UI_month_short_8"	"sep."
"UI_month_short_9"	"okt."
"UI_month_short_10"	"nov."
"UI_month_short_11"	"des."
"UI_day_1"	"Søndag"
"UI_day_2"	"Mandag"
"UI_day_3"	"Tirsdag"
"UI_day_4"	"Onsdag"
"UI_day_5"	"Torsdag"
"UI_day_6"	"Fredag"
"UI_day_7"	"Lørdag"
"UI_day_short_1"	"sø."
"UI_day_short_2"	"ma."
"UI_day_short_3"	"ti."
"UI_day_short_4"	"on."
"UI_day_short_5"	"to."
"UI_day_short_6"	"fr."
"UI_day_short_7"	"lø."
"UI_day_shorter_1"	"sø."
"UI_day_shorter_2"	"ma."
"UI_day_shorter_3"	"ti."
"UI_day_shorter_4"	"on."
"UI_day_shorter_5"	"to."
"UI_day_shorter_6"	"fr."
"UI_day_shorter_7"	"lø."
"DOTATournamentDetailsDatesYearDiff"	"{s:start_day}. {s:start_month} {s:start_year}–{s:end_day}. {s:end_month} {s:end_year}"
"DOTATournamentDetailsDatesMonthDiff"	"{s:start_day}. {s:start_month}–{s:end_day}. {s:end_month} {s:end_year}"
"DOTATournamentDetailsDatesDayDiff"	"{s:start_day}.–{s:end_day}. {s:start_month} {s:end_year}"
"DOTATournamentDetailsDates"	"{s:start_day}. {s:start_month} {s:end_year}"
"DOTA_TeamTransferAdmin_Failure_Message_OnOtherTeam"	"{s:player_name} er allerede på spillerlisten til et annet lag."
"DOTA_TeamTransferAdmin_Failure_Message_AdminOfOtherTeam"	"{s:player_name} er administrator for et annet lag"
"DOTA_MainMenu_Store"	"Butikk"
"DOTA_Lobby_Settings_Team1"	"{s:team1}"
"DOTA_Lobby_Settings_Team2"	"{s:team2}"
"DOTA_Lobby_Settings_Empty"	"-"
"DOTA_HeroDemo_Button_Hero"	"Test helt"
"DOTA_econ_item_details_owning_bundle_item_name"	"{s:item_owning_bundle_name}"
"DOTA_store_item_details_associated_league_name"	"{s:league_name}"
"DOTA_store_item_details_associated_prize_pool_amount"	"{s:prize_pool_amount}"
"FrontPage_Debut_Arc_Warden_Header"	"Ny helt"
"DOTA_RecentArmoryItems_ItemType"	"{s:item_type}"
"DOTA_Store_NewReleases"	"Nye utgivelser"
"DOTA_Hud_HealthRegen"	"{s:health_regen}"
"DOTA_Hud_ManaRegen"	"{s:mana_regen}"
"DOTA_Hud_BuybackCooldown"	"{s:buyback_cooldown}"
"DOTA_Hud_XP"	"{d:r:current_xp} / {d:r:xp_to_level}"
"DOTA_Hud_Lifetime"	"{s:lifetime}"
"DOTA_Hud_AttributeTooltip_Title"	"{s:attribute_name}"
"DOTA_HUD_RespawnTime"	"{d:respawn_time}"
"DOTA_HUD_BuybackCost_Surplus"	"{d:buyback_gold_surplus} i overskudd"
"DOTA_HUD_Wagering_TimeLeft"	"{i:wagering_time}s"
"DOTA_HeroStatColumn_Hero"	"Helt"
"DOTA_HeroStatColumn_Header_Hero"	" 

"
"DOTA_HeroStatColumn_Header_Ratings"	" "
"DOTA_HeroStat_GameType"	"{s:tooltip_game_mode}"
"DOTA_Workshop_Publish_CancelUploadText"	"Er du sikker på at du vil avbryte filopplastingen?"
"UI_ordinal_suffix_0"	"."
"UI_ordinal_suffix_1"	"."
"UI_ordinal_suffix_2"	"."
"UI_ordinal_suffix_3"	"."
"UI_ordinal_suffix_4"	"."
"UI_ordinal_suffix_5"	"."
"UI_ordinal_suffix_6"	"."
"UI_ordinal_suffix_7"	"."
"UI_ordinal_suffix_8"	"."
"UI_ordinal_suffix_9"	"."
"DOTA_WatchLive_FriendsOnly"	"Venner"
"DOTA_econ_item_details_item_uneditable_description"	"{s:item_uneditable_description}"
"DOTA_Home_BattlePass_ResetTime"	"Tilbakestilles om: {i:reset_days} d {i:reset_hours} t {i:reset_minutes} min"
"BattlePass_LevelUp_Header"	"Gratulerer!"
"DOTA_SeasonPass_PreviousReward"	"{s:previous_reward}"
"DOTA_SeasonPass_NextReward"	"{s:next_reward}"
"DOTA_SeasonPass_WagerXP"	"{d:wager_xp}XP"
"DOTA_SeasonPass_QuestXP"	"{d:quest_xp}XP"
"DOTA_SeasonPass_AchievementXP"	"{d:achievement_xp}XP"
"DOTA_SeasonPass_AccountExperience"	"{d:current_xp}/{d:nextlevel_xp}"
"DOTA_SeasonPassAchievement_Name"	"{s:achievement_name}"
"DOTA_SeasonPassAchievement_Description"	"{s:achievement_description}"
"DOTA_SeasonPassAchievement_Status"	"{u:achievement_status}/{u:achievement_goal}"
"DOTA_SeasonPassAchievement_Reward"	"{u:achievement_reward}"
"DOTA_SeasonPassAchievement_Achievements_Current"	"{u:current}"
"DOTA_SeasonPassAchievement_Achievements_Total"	"{u:total}"
"DOTA_SeasonPassAchievement_Achievements_Points"	"{u:points}"
"DOTA_Wheel_ItemCategory"	"{s:category}"
"DOTA_WinterMajor2016_Achievement_Complete_20_Daily_Missions_Description"	"Gjennomfør 25 daglige helteutfordringer"
"DOTA_RewardPath_Level"	"{i:level}"
"DOTA_XPBar_Tooltip_Default"	"{s:xp_amount} erfaringspoeng"
"DOTA_XPBar_Tooltip_Quest"	"{s:xp_amount} erfaringspoeng mottatt fra et oppdrag"
"DOTA_XPBar_Tooltip_Achievement"	"{s:xp_amount} erfaringspoeng mottatt fra prestasjoner"
"DOTA_EventGoal_Progress"	"{d:goal_value} av {d:goal_target_value}"
"DOTA_ConductScorecard_Reports_GoodPct"	"{d:reports_good_pctile}% av alle spillere har like lav rapporteringsrate som deg."
"DOTA_ConductScorecard_Commend"	"Anbefal"
"DOTA_DB_SeasonPass_PointsPerLevel"	"{i:points_per_level} poeng = 1 nivå"
"DOTA_DB_SeasonPass_CommunityGoalNumbers"	"{d:current_goal_progress} av {d:current_goal_complete}"
"DOTA_DB_Page_QuestReward"	"{d:point_reward}"
"DOTA_DailyHero_Reward"	"{d:daily_hero_points}"
"DOTA_Weekly1_Challenge_Reward"	"{d:weekly_1_points}"
"DOTA_Weekly2_Challenge_Reward"	"{d:weekly_2_points}"
"DOTA_Tooltip_Challenge_Progress"	"{d:progress} av {d:complete_limit}<span class=\"ChallengeProgressText\"> fullført</span>"
"DOTA_Weekly1Challenge_Progress"	"{d:weekly_1_progress} av {d:weekly_1_complete_limit}<span class=\"WeeklyProgressText\"></span>"
"DOTA_Weekly2Challenge_Progress"	"{d:weekly_2_progress} av {d:weekly_2_complete_limit}<span class=\"WeeklyProgressText\"></span>"
"DOTA_CompendiumRecap_Region2"	"Europa"
"DOTA_Home_BattlePass_EndTime"	"{i:end_days}d {i:end_hours}t {i:end_minutes}m"
"DOTA_SeasonPass_Friends_N_Of"	"{i:friend_rank}{s:rank_ordinal_suffix} av {i:friend_count} venner"
"DOTA_econ_item_details_emoticon_text"	"{s:emoticon_text}"
"DOTA_econ_item_details_apply_tool"	"{s:tool_use_name}"
"DOTA_Credits_EnglishVoices"	"Engelske stemmeskuespillere"
"DOTA_Credits_RussianVoices"	"Russiske stemmeskuespillere"
"DOTA_Compendium_SecondaryTabHeader_GroupStage"	"Gruppespill"
"DOTA_CompendiumTeam_TournamentFinish"	"{i:tournament_finish}{s:tournament_finish_ordinal} plass"
"DOTA_CompendiumTeam_Game_Time"	"Tid"
"DOTA_Compendium_ShowRanking"	"Vis gjeldende resultater"
"DOTA_Compendium_Rank"	"Rang"
"DOTA_Compendium_Amount"	"Mengde"
"DOTA_Compendium_Votes"	"Stemmer"
"DOTA_StoreItem_InTreasure"	"I skatt"
"dota_settings_activateradar"	"Aktiver skann"
"DOTA_Hotkeys_Tooltip_ActivateRadar"	"Aktiverer skann."
"DOTA_HUD_RadarCooldown"	"Nedkjøling: {s:cooldown_time}"
"DOTA_Workshop_ItemImport_CreateItem_SetPaymentRule"	"Opprett betalingsregel %1"
"DOTA_Workshop_ItemImport_UpdateItem_SetPaymentRule"	"Oppdater betalingsregel %1"
"DOTA_Hud_Health"	"{u:health} <span class='MaxHealthLabel'>/ {u:max_health}</span>"
"DOTA_Hud_Mana"	"{u:mana} <span class='MaxManaLabel'>/ {u:max_mana}</span>"
"DOTA_HeroLoadout_Instructions"	"Hold over for å se, trykk for å utstyre"
"DOTA_Workshop_ShowParticles"	"Vis partikler"
"DOTA_TournamentBracket_GSL1"	"GSL – Første kamp"
"DOTA_TournamentBracket_GSL2"	"GSL – Andre kamp"
"DOTA_TournamentBracket_LosersMatchNew"	"Taperkamp"
"DOTA_HUD_NetGraph_Left_1"	"FPS / Ping"
"DOTA_HUD_NetGraph_Right_1"	"{d:fps} / {d:ping}"
"DOTA_HUD_NetGraph_Right_2"	"{d:loss} / {d:kbps}"
"DOTA_SplashAd_TI6_Immortals_2_Available"	"Tilgjengelig nå"
"DOTA_SplashAd_TI6_Immortals_3_Available"	"Tilgjengelig nå"
"DOTA_TournamentBracket_GroupNumber"	"Gruppe {i:group_num}"
"DOTA_NowAvailable"	"Tilgjengelig nå"
"DOTA_Treasure_ViewTreasure"	"Vis skatt"
"DOTA_TrueSight_AvailableNow"	"Tilgjengelig nå"
"DOTA_HeroLoadout_AvailableItems"	"Tilgjengelig"
"DOTA_ChatCommand_GameLobby_Name"	"Lobby"
"DOTA_EconItemSearchPrefix_Slot"	"plass"
"FrontPage_Elemental_Fury_Music_Pack_Description"	"Komponert av samfunnsartisten Daniel Sadowski"
"DOTA_BattlePassRewards_Level225"	"Nivå 225"
"DOTA_PurchaseError_Ok"	"OK"
"DOTA_Siltbreaker_OpenTreasure"	"Vis skatt"
"DOTA_Workshop_Jakiro_Left_Head"	"Venstre hode"
"DOTA_Workshop_Jakiro_Right_Head"	"Høyre hode"
"DOTA_Workshop_Jakiro_Wings"	"Vinger"
"DOTA_Play_Turbo"	"Spill Dota Turbo"
"DOTA_Popup_RankCalibration_Congrats"	"Gratulerer!"
"DOTA_PatchNotes_ReleaseDate"	"Utgitt {t:s:patch_date}"
"DOTA_PlusWelcome_Finished_Title"	"Gratulerer"
"DOTA_TI8_Ticket_Location"	"Rogers Arena – Vancouver, Canada"
"DOTA_TI8_Ticket_Dates"	"20.08.2018 – 25.08.2018"
"DOTA_TI8_Ticket_Waves_Tooltip"	"Billetter til International tilbys i to bølger:<br>• Første bølge starter kl. 18.00 fredag 23. mars.<br>• Andre bølge starter kl. 6.00 lørdag 24. mars."
"DOTA_TI8_Ticket_Wave1"	"Første bølge"
"DOTA_TI8_Ticket_Wave2"	"Andre bølge"
"DOTA_TI8_Ticket_SalesStart"	"Billettsalget starter om"
"DOTA_TI8_Ticket_CallToAction"	"Gjør klar kontoen din på TicketMaster.ca"
"DOTA_TI8_Ticket_CallToAction2"	"Kjøp billetter på Ticketmaster.ca"
"DOTA_PurchaseItemWithEventPoints_Info"	"Kjøpte gjenstander kan ikke byttes eller selges."
"DowntimeFrontpageHeader"	"SPILLTJENESTER FRAKOBLET"
"DowntimeFrontpageSubheader"	"Nedetiden forventes å vare rundt 4–5 timer."
"DOTA_StoreItem_AlreadyOwned"	"Du eier allerede denne gjenstanden."
"DOTA_713_Update"	"Spilloppdatering 7.13"
"DOTA_714_Update"	"Spilloppdatering 7.14"
"DOTA_715_Update"	"Spilloppdatering 7.15"
"DOTA_716_Update"	"Spilloppdatering 7.16"
"DOTA_Chat_PublicChannelHeader"	"Telefonnummer ikke registrert"
"DOTA_Chat_PublicChannelRegister"	"Registrer telefon"
"DOTA_Chat_PublicChannelCancel"	"Avbryt"
"dota_page_match_details_return_to_details"	"Returner til kampdetaljer"
"DOTA_SeasonPass_International2018_Rewards_Expire_Date"	"26. august 2018"
"DOTA_OwnedItemDetails_ItemName"	"{g:dota_filtered_string:item_name}"
"DOTA_GameMode_10"	"Opplæring"
"DOTA_GameMode_15"	"Tilpasset spillmodus"
"DOTA_TI8_FrontPage_Underhollow_Header_Available"	"Tilgjengelig nå"
"dota_play_lobbies_section"	"Tilpassede lobbyer"
"dota_play_create_lobby"	"Opprett"
"dota_play_browse_lobbies"	"Bla gjennom"
"FrontPage_BattlePassBundle_Savings_75"	"75% avslag"
"DOTA_SplashAd_TI8_Weekend_Savings"	"Spar 75%"
}
