"dota"
{
"DOTA_Workshop_SubmissionType_CursorPack_Desc_obs"	"HUD デフォルトを差し替えるカーソルのパッケージ"
"DOTA_Accept"	"承諾"
"DOTA_Cancel"	"キャンセル"
"DOTA_Console"	"コンソール"
"DOTA_Create"	"作成"
"DOTA_Decline"	"拒否"
"DOTA_Error"	"エラー"
"DOTA_Join"	"参加"
"DOTA_Leave"	"退室"
"DOTA_New"	"New"
"DOTA_Ok"	"OK"
"DOTA_Sale"	"セール"
"DOTA_Close"	"閉じる"
"DOTA_Continue"	"続行"
"DOTA_Add"	"追加"
"DOTA_Edit"	"編集"
"DOTA_Enable"	"有効"
"DOTA_Disable"	"無効"
"DOTA_Refresh"	"更新"
"DOTA_Loading"	"ロード中"
"DOTA_None"	"なし"
"DOTA_Customize"	"カスタマイズ"
"DOTA_AcceptChanges"	"変更を承認"
"dota_team_radiant"	"Radiant"
"dota_team_dire"	"Dire"
"Unknown"	"不明"
"UI_Yes"	"はい"
"UI_No"	"いいえ"
"UI_File_Filter_Any"	"全てのファイル (*.*)"
"DOTA_MainMenu_Heroes"	"ヒーロー"
"DOTA_MainMenu_Watch"	"観戦"
"DOTA_MainMenu_Learn"	"学ぶ"
"DOTA_MainMenu_Mods"	"アーケード"
"DOTA_TabName_GlobalItems"	"グローバルアイテム"
"DOTA_TabName_Treasury"	"宝庫"
"DOTA_TabName_Armory"	"保管庫"
"DOTA_ConfirmQuit"	"ゲーム終了"
"DOTA_ConfirmQuitDesc"	"Dota 2 を終了してよろしいですか？"
"DOTA_ConfirmQuitDescUnsafe"	"ゲーム終了前に退出すると、他のプレイヤーに迷惑をかけることがあります。本当に Dota 2 を終了してよろしいですか？"
"DOTA_InvalidPersonaName"	"[不明]"
"DOTA_Friends_WindowTitle"	"フレンド"
"DOTA_FriendsCategory_ReadyToPlay"	"公開ゲーム内 <font color='#63C290'><b></b>({d:friend_count})</font>"
"DOTA_FriendsCategory_PlayingDota"	"Dota 内<font color='#ACEBA9'>({d:friend_count})</font>"
"DOTA_FriendsCategory_Online"	"オンライン <font color='#6a9dcc'>({d:friend_count})</font>"
"DOTA_FriendsCategory_Pending"	"保留中 <font color='#eeee82'>({d:friend_count})</font>"
"DOTA_FriendsCategory_Offline"	"オフライン <font color='#676666'>({d:friend_count})</font>"
"DOTA_Friends_Empty"	"あなたのフレンドリストは空です"
"DOTA_FriendsMenu_Tooltip_NoneReady"	"フレンド"
"DOTA_UserName"	"{g:dota_persona:user_account_id}"
"DOTA_UserNamePro"	"{g:dota_persona_pro:user_account_id}"
"DOTA_UserNickname"	"{g:dota_persona_nickname:user_account_id}"
"DOTA_UserRichPresence"	"{s:user_rich_presence}"
"DOTA_ProfileCard_StatTitle_SoloRank"	"ソロ MMR"
"DOTA_ProfileCard_StatTitle_PartyRank"	"パーティ MMR"
"DOTA_ProfileCard_StatTitle_Wins"	"勝利数"
"DOTA_ProfileCard_StatTitle_Commends"	"称賛"
"DOTA_ProfileCard_StatTitle_GamesPlayed"	"試合数"
"DOTA_ProfileCard_StatTitle_FirstMatchDate"	"第一試合"
"DOTA_ProfileCard_StatValue_Int"	"{d:stat_value}"
"DOTA_ProfileCard_StatValue_Date"	"{t:s:stat_value}"
"DOTA_ProfileCard_StatValue_String"	"{s:stat_value}"
"DOTA_ProfileCard_SlotTab_Trophies"	"トロフィー"
"DOTA_ProfileCard_SlotTab_Items"	"保管庫"
"DOTA_ProfileCard_SlotTab_Heroes"	"ヒーロー"
"DOTA_ProfileCard_SlotTab_Emoticons"	"絵文字"
"DOTA_ProfileCard_NoTrophies"	"入手可能なトロフィーはありません。"
"DOTA_ProfileCard_NoItems"	"入手可能なアイテムはありません。"
"DOTA_ProfileCard_HeroOnly"	"ヒーローのみ"
"DOTA_ProfileCard_HeroShowWins"	"勝利数を表示"
"DOTA_ProfileCard_HeroShowWinsAndLosses"	"勝敗を表示"
"DOTA_ProfileCard_ItemSearchPrefix"	"検索:"
"DOTA_ProfileCard_ItemSearchPlaceholder"	"アイテムの名前順"
"DOTA_ProfileCard_ItemArmoryLink"	"保管庫全て表示"
"DOTA_HeroTooltip_HeroName"	"{s:hero_name}"
"DOTA_HeroTooltip_HeroRecord"	"{s:hero_wins_string}, {s:hero_losses_string}"
"DOTA_ProfileCard_HeroSearchPlaceholder"	"ヒーロー名で検索"
"DOTA_Wins_Singular"	"1 勝"
"DOTA_Wins_Plural"	"{d:hero_wins} 勝"
"DOTA_Losses_Singular"	"1 敗"
"DOTA_Losses_Plural"	"{d:hero_losses} 敗"
"DOTA_Profile_TotalGames"	"総試合数"
"DOTA_Profile_Solo_MMR"	"ソロ MMR"
"DOTA_Profile_Team_MMR"	"チーム MMR"
"DOTA_Profile_Party_MMR"	"パーティ MMR"
"DOTA_Profile_VictoryCount"	"勝利数"
"DOTA_Profile_ProfilePage"	"プロフィール"
"DOTA_Profile_TrophyPage"	"トロフィー"
"DOTA_Profile_RecentGamesPage"	"最近の試合"
"DOTA_Profile_HeroPage"	"ヒーロー"
"DOTA_Profile_PlayStyle"	"プレイスタイル"
"DOTA_Profile_MostRecent"	"最も最近 {s:num_style_games} 試合"
"DOTA_Profile_RecentActivity"	"最近のアクティビティ"
"DOTA_Profile_Fighting"	"戦闘"
"DOTA_Profile_Fighting_TooltipTitle"	"戦闘"
"DOTA_Profile_Fighting_Tooltip"	"敵ヒーロー相手に戦闘をこなすプレイヤー。"
"DOTA_Profile_Farming"	"ファーム"
"DOTA_Profile_Farming_TooltipTitle"	"ファーム"
"DOTA_Profile_Farming_Tooltip"	"クリーチャーを倒してゴールドを稼ぐプレイヤー。"
"DOTA_Profile_Supporting"	"サポート"
"DOTA_Profile_Supporting_TooltipTitle"	"サポート"
"DOTA_Profile_Supporting_Tooltip"	"チーム用にワードやアイテムを購入したり、回復させたりしてサポートするプレイヤー。"
"DOTA_Profile_Pushing"	"プッシュ"
"DOTA_Profile_Pushing_TooltipTitle"	"プッシュ"
"DOTA_Profile_Pushing_Tooltip"	"安全圏を広げる為にタワー破壊を進めるプレイヤー。"
"DOTA_Profile_Versatility"	"万能"
"DOTA_Profile_Versatility_TooltipTitle"	"万能"
"DOTA_Profile_Versatility_Tooltip"	"異なるヒーローを多才に操る万能タイプのプレイヤー。"
"DOTA_Profile_Tooltip_Value"	"{s:CurrentStatValue}"
"DOTA_Profile_Tooltip_Comparison"	"{s:CurrentComparisonValue}"
"DOTA_Profile_StatsCompare"	"自分のデータと比較"
"DOTA_Profile_Self"	"自分"
"DOTA_Profile_GPM"	"平均 GPM"
"DOTA_Profile_XPM"	"平均 XPM"
"DOTA_Profile_LH"	"平均 ラストヒット"
"DOTA_Profile_Rampages"	"大暴れ"
"DOTA_Profile_TripleKills"	"トリプルキル"
"DOTA_Profile_FirstBlood"	"ファーストブラッドキル"
"DOTA_Profile_FirstBled"	"最初の犠牲"
"DOTA_Profile_CourierKills"	"クーリエキル"
"DOTA_Profile_Aegises"	"盗まれた Aegis"
"DOTA_Profile_CheeseEaten"	"チーズ消費回数"
"DOTA_Profile_CreepStack"	"キャンプのスタック数"
"DOTA_Profile_GPMValue"	"{s:GPM}"
"DOTA_Profile_XPMValue"	"{s:XPM}"
"DOTA_Profile_LHValue"	"{s:LH}"
"DOTA_Profile_RampagesValue"	"{d:Rampages}"
"DOTA_Profile_TripleKillsValue"	"{d:TripleKills}"
"DOTA_Profile_FirstBloodValue"	"{d:FirstBlood}"
"DOTA_Profile_FirstBledValue"	"{d:FirstBled}"
"DOTA_Profile_CourierKillsValue"	"{d:CourierKills}"
"DOTA_Profile_AegisesValue"	"{d:Aegises}"
"DOTA_Profile_CheeseEatenValue"	"{d:CheeseEaten}"
"DOTA_Profile_CreepStackValue"	"{d:CreepStack}"
"DOTA_Profile_GPMLocalValue"	"{s:GPMLocal}"
"DOTA_Profile_XPMLocalValue"	"{s:XPMLocal}"
"DOTA_Profile_LHLocalValue"	"{s:LHLocal}"
"DOTA_Profile_RampagesLocalValue"	"{d:RampagesLocal}"
"DOTA_Profile_TripleKillsLocalValue"	"{d:TripleKillsLocal}"
"DOTA_Profile_FirstBloodLocalValue"	"{d:FirstBloodLocal}"
"DOTA_Profile_FirstBledLocalValue"	"{d:FirstBledLocal}"
"DOTA_Profile_CourierKillsLocalValue"	"{d:CourierKillsLocal}"
"DOTA_Profile_AegisesLocalValue"	"{d:AegisesLocal}"
"DOTA_Profile_CheeseEatenLocalValue"	"{d:CheeseEatenLocal}"
"DOTA_Profile_CreepStackLocalValue"	"{d:CreepStackLocal}"
"DOTA_RecentGames_Title"	"最近のゲーム"
"DOTA_RecentGames_TimeStamp"	"日付/時間"
"DOTA_RecentGames_HeroSelection"	"プレイしたヒーロー"
"DOTA_RecentGames_GameResult"	"結果"
"DOTA_RecentGames_GameLength"	"時間"
"DOTA_RecentGames_Team"	"チーム"
"DOTA_RecentGames_GameType"	"タイプ"
"DOTA_RecentGames_Items"	"アイテム"
"DOTA_RecentGame_Timestamp_Entry"	"{t:s:timestamp} {t:t:timestamp}"
"DOTA_RecentGame_Duration"	"{t:d:duration}"
"DOTA_RecentGame_Downloading"	"{s:DownloadPercent} ダウンロード中"
"DOTA_RecentGame_Watch"	"リプレイを観戦"
"DOTA_RecentGame_NoReplay"	"リプレイがありません"
"DOTA_RecentGame_Expired"	"リプレイ期限切れ"
"DOTA_RecentGame_Finding"	"探しています..."
"DOTA_RecentGame_Download"	"マッチをダウンロード"
"DOTA_RecentGame_Pending"	"保留中のリプレイ"
"DOTA_RecentGame_Unavailable"	"使用できないリプレイ"
"DOTA_RecentGame_MatchID"	"マッチ ID: #{s:match_id}"
"DOTA_No_Team_Name"	"--"
"DOTA_TrophyCount"	"{d:trophy_count} トロフィー"
"DOTA_TrophiesCount"	"{d:trophy_count} トロフィー"
"DOTA_TrophyCount_Number"	"{d:trophy_count}"
"DOTA_TrophyCount_NoNum"	"トロフィー"
"DOTA_TrophiesCount_NoNum"	"トロフィー"
"DOTA_Trophies_ViewAll"	"全て"
"DOTA_TrophyName"	"{s:trophy_name}"
"DOTA_TrophyCategory"	"{s:trophy_category}"
"DOTA_TrophyDescription"	"{s:trophy_description}"
"DOTA_TrophyXP"	"{d:trophy_xp}<span class=\"TrophyPointTextSmall\">TP</span>"
"DOTA_NextTrophy"	"次のアワード"
"DOTA_NewPlayerQuestion_Title"	"DOTA 2へようこそ"
"DOTA_PlayerOriginQuestion_Question"	"より良いゲーム体験のため、Dota 2 や類似ゲームについての精通度について情報をご提供ください："
"DOTA_PlayerOriginQuestion_BeginnerButton"	"初心者です。"
"DOTA_PlayerOriginQuestion_RTSButton"	"RTSゲームをプレイしたことがあります。"
"DOTA_PlayerOriginQuestion_MOBAButton"	"Dota 2 に似たゲームをプレイしたことがあります。"
"DOTA_PlayerOriginQuestion_Dota2Button"	"Dota 2 をプレイしたことがあります。"
"DOTA_PlayerOriginQuestion_MOBAExplanation"	"最も慣れているゲームを選択してください："
"DOTA_OtherGames_LOL"	"League of Legends"
"DOTA_OtherGames_DOTA"	"DotA 1"
"DOTA_OtherGames_HON"	"Heroes of Newerth"
"DOTA_OtherGames_Smite"	"Smite"
"DOTA_OtherGames_Other"	"他のゲーム"
"DOTA_PlayerOriginQuestion_ConfirmationButton"	"さあ始めよう"
"DOTA_PlayerOriginQuestion_ConfirmationTutorial"	"Dota を始めてプレイする場合、プレイタブのトレーニングセクションにあるチュートリアルをお試しください。全世界のプレイヤーを制圧するための第一歩として最適です。"
"DOTA_PlayerOriginQuestion_ConfirmationSettings"	"あなたと同じ精通度のユーザーが最も良く使用しているキーバインドとオプションに設定してあります。設定アイコンをクリックすれば、これらをいつでも好きなようにカスタマイズすることができます。"
"DOTA_Tutorial_SkipButton"	"チュートリアルをスキップ"
"DOTA_ConfirmSkip"	"Dota 2 イントロをスキップしますか？"
"DOTA_ConfirmSkipDesc"	"Dota 2 のチュートリアルをスキップして本当に良いですか？"
"DOTA_Tutorial_Start_Quest"	"クエスト開始"
"DOTA_Tutorial_Quest0_Title"	"クエスト 1"
"DOTA_Tutorial_Quest0_TitleDesc"	"RANGED ヒーロー"
"DOTA_Tutorial_Quest0DetailsDesc"	"このクエストの完了には\n およそ10分かかります。"
"DOTA_Tutorial_QuestDetailsLearn"	"学習するのは:"
"DOTA_Tutorial_Quest0DetailsLesson"	"ヒーローの移動\nヒーローのレベルアップ\nアビリティの使用\nアイテム\n基本的な戦闘\nラストヒット"
"DOTA_Tutorial_Quest1_Title"	"クエスト 2"
"DOTA_Tutorial_Quest1_TitleDesc"	"レーン戦"
"DOTA_Tutorial_Quest1DetailsDesc"	"このクエストの完了には\n およそ10分かかります。"
"DOTA_Tutorial_Quest1DetailsLesson"	"長距離戦闘 \n AOE アビリティ \n ミニマップ \n タワー \n クーリエとスタッシュ \n テレポート"
"DOTA_Tutorial_Quest2_Title"	"クエスト 3"
"DOTA_Tutorial_Quest2_TitleDesc"	"レーン戦"
"DOTA_Tutorial_Quest2DetailsDesc"	"このクエストの完了には\n およそ10 - 15 分かかります。"
"DOTA_Tutorial_Quest2DetailsLesson"	"レーン戦 \n タワーの防御と攻撃 \n 開始時のアイテム"
"DOTA_Challenges_Title"	"学ぶ"
"DOTA_ChallengeGroup_0_Title"	"ゲーム紹介"
"DOTA_ChallengeGroup_1_Title"	"ガイド付きボット戦"
"DOTA_ChallengeGroup_1_Desc"	"ここから開始！"
"DOTA_ChallengeGroup_2_Title"	"ボット戦"
"DOTA_ChallengeGroup_More"	"今後も追加されます"
"DOTA_ChallengeGroup_Locked"	"ロック"
"DOTA_LearnMechanics_Title"	"ゲーム紹介"
"DOTA_LearnMechanics_SubTitle"	"ヒーローのコントロールからアイテムショップの使い方などまで Dota の基礎を学ぼう。Dota のようなゲームをプレイしたことがない場合、ここから始めてください。"
"DOTA_Mechanics_0_Title"	"ゲーム紹介 1"
"DOTA_Mechanics_0_Desc"	"ヒーローの移動\nヒーローのレベルアップ\nアビリティの使用\nアイテム\n基本的な戦闘\nラストヒット"
"DOTA_Mechanics_1_Title"	"ゲーム紹介 2"
"DOTA_Mechanics_1_Desc"	"長距離戦闘\n範囲アビリティ\nミニマップ\nタワー\nクーリエとスタッシュ\nテレポート"
"DOTA_LearnGuidedBotMatches_Title"	"ガイド付きボット戦"
"DOTA_LearnGuidedBotMatches_SubTitle"	"ボット制御のヒーロー相手に Dota のプレイ方法を学びましょう。選んだヒーローが驚異的な存在に成長するまで、試合の段階ごとにガイドします。"
"DOTA_GuidedBotMatches_0_Title"	"Luna"
"DOTA_GuidedBotMatches_0_Desc"	"短距離攻撃\n高攻撃ダメージ\n高速移動\nやや虚弱\nアビリティスタック使用"
"DOTA_GuidedBotMatches_1_Title"	"Sven"
"DOTA_GuidedBotMatches_1_Desc"	"近接攻撃\n爆発的攻撃ダメージe\n高耐久性\n減速に脆弱\nStrength ヒーロー"
"DOTA_GuidedBotMatches_2_Title"	"Lina"
"DOTA_GuidedBotMatches_2_Desc"	"長距離攻撃\n爆発的なアビリティダメージ\n短クールダウン\n非常に脆弱\nIntelligence ヒーロー"
"DOTA_LearnBotMatches_Title"	"ボット戦"
"DOTA_LearnBotMatches_SubTitle"	"ボット制御のヒーローを相手にストレスフリーで練習しよう。"
"DOTA_BotMatches_0_Title"	"イージーボット"
"DOTA_BotMatches_0_Desc"	"新ヒーローを学ぶ。"
"DOTA_BotMatches_1_Title"	"ミディアムボット"
"DOTA_BotMatches_1_Desc"	"ゲームに慣れる。"
"DOTA_BotMatches_2_Title"	"ハードボット"
"DOTA_BotMatches_2_Desc"	"実力を試す。"
"DOTA_BotMatches_3_Title"	"インセインボット"
"DOTA_BotMatches_3_Desc"	"傷つき、学ぶ。"
"FileOpenDialog_Open"	"開く"
"FileOpenDialog_Save"	"保存"
"FileOpenDialog_Select"	"選択"
"FileOpenDialog_FileType_Folder"	"フォルダ"
"DOTA_FindMatch"	"マッチを検索"
"DOTA_FindingMatch"	"マッチを検索中 ( {s:find_match_time} )"
"DOTA_FindMatchTime"	"{s:find_match_time}"
"DOTA_Searching"	"検索中"
"DOTA_StartSoloBotMatch"	"ボットマッチを開始"
"DOTA_Create_Lobby"	"ロビーを作成"
"DOTA_Join_Lobby"	"ロビーに入る"
"DOTA_LobbyStartGame"	"ゲームを開始"
"DOTA_ReturnToLobby"	"ロビーに戻る"
"DOTA_FindMatchStatus"	"{s:searching_matchtype} / {s:searching_gamemodes} / {s:searching_region}"
"DOTA_FindGameModesMany"	"ゲームモード: "
"DOTA_FindRegionsMany"	"地域: "
"DOTA_GameMode_AllPick"	"オールピック"
"DOTA_GameMode_SingleDraft"	"シングルドラフト"
"DOTA_GameMode_CaptainsMode"	"キャプテンズモード"
"DOTA_GameMode_RandomDraft"	"ランダムドラフト"
"DOTA_GameMode_AbilityDraft"	"アビリティドラフト"
"DOTA_GameMode_LeastPlayed"	"低使用度プレイ"
"DOTA_GameMode_AllRandom"	"オールランダム"
"DOTA_GameMode_LimitedHeroes"	"限定ヒーロー"
"DOTA_GameMode_CaptainsDraft"	"キャプテンズドラフト"
"DOTA_GameMode_AllRandomDeathMatch"	"オールランダムデスマッチ"
"DOTA_ImmediatePurchase_SendFailed"	"購入リクエストの送信に失敗しました。 Dota サーバーがオフラインになっている可能性があります。後でもう一度ご購入をお試しください。"
"DOTA_ImmediatePurchase_Timeout"	"購入リクエストへの返信がタイムアウトしました。後でもう一度お試しください。"
"DOTA_ImmediatePurchase_InitFailed"	"Perfect World での購入処理を開始することができませんでした。後でもう一度お試しください。"
"DOTA_ImmediatePurchase_InsufficientFundsPW"	"あなたの Perfect World アカウントの残高が不足しているため購入できません。残高を追加したうえで、もう一度お試しください。"
"DOTA_ImmediatePurchase_Success_Title"	"成功"
"DOTA_ImmediatePurchase_Success_Text"	"購入処理が正常に完了しました！購入したアイテムは、すぐにあなたの保管庫に送られます。"
"DOTA_ImmediatePurchase_Cancelled_Title"	"取り消しました"
"DOTA_ImmediatePurchase_UnbundleTimeout"	"バンドル開封リクエストへの返信がタイムアウトしました。後でもう一度お試しください。"
"DOTA_ImmediatePurchase_UnbundleFailure"	"バンドルを開封することができません。後でもう一度お試しください。"
"DOTA_ImmediatePurchase_LateCancel"	"購入処理は既にキャンセルされていました。お客様へのご請求はありません。"
"DOTA_ConfirmPurchaseTitle"	"購入の確認"
"DOTA_ConfirmPurchaseText"	"このアイテムを購入しますか？"
"DOTA_PurchaseInProgress_Title"	"購入処理中"
"DOTA_PurchaseInProgress_Text"	"あなたの購入リクエストを処理中です。"
"DOTA_UnbundleInProgress_Title"	"バンドルを開封中"
"DOTA_UnbundleInProgress_Text"	"バンドルを開封しています。"
"DOTA_ConfirmUnbundleTitle"	"バンドル開封の確認"
"DOTA_ConfirmUnbundleText"	"このバンドルに入っているアイテムを装備するには開封する必要があります。続けますか？"
"DOTA_RequestingBalance_Title"	"残高をリクエスト中"
"DOTA_RequestingBalance_Text"	"あなたの Perfect World アカウントの残高をリクエストしています ..."
"DOTA_PartnerPurchaseRecharge_Title"	"残高をチャージ"
"DOTA_PartnerPurchaseRecharge_Text"	"アカウント残高の再チャージに移ります..."
"DOTA_PartnerPurchase_Purchase"	"{g:dota_item_price:item_def}"
"DOTA_PartnerPurchase_Balance"	"残高： {m:balance}"
"StoreCheckout_Error_Title"	"エラー"
"StoreCheckout_NoItems"	"ショッピングカートが空です！"
"StoreCheckout_TooManyItems"	"ショッピングカート内のアイテムが多すぎます！"
"StoreCheckout_Loading"	"支払い処理中..."
"StoreCheckout_Unavailable"	"現在、支払い処理ができません。"
"StoreCheckout_Cancelling"	"キャンセルしています..."
"StoreCheckout_Fail"	"ストアは、現在閉店しています。"
"StoreCheckout_InvalidParam"	"プログラムでエラーが発生しました！ 無効なパラメータがゲームコーディネータに渡されました。購入手続きをやり直してください。"
"StoreCheckout_InternalError"	"お取引の初期化あるいは更新の際にエラーが発生しました。後ほど購入手続きをやり直すか、サポートにご連絡ください。"
"StoreCheckout_ContactSupport"	"処理の実行中にエラーが発生しました。　Steam サポートに連絡してください。"
"StoreCheckout_NotApproved"	"Steam でのお取引が、ゲームコーディネータに承認されませんでした。後で、購入手続きをやり直してください。"
"StoreCheckout_NotLoggedin"	"購入手続きを完了するには、Steam にログインする必要があります。"
"StoreCheckout_WrongCurrency"	"このお取引で選択された通貨は、お客様の Steam ウォレットの通貨と一致していません。"
"StoreCheckout_NoAccount"	"あなたのSteam アカウントは、現在利用できません。後で、購入手続きをやり直してください。"
"StoreCheckout_InsufficientFunds"	"購入手続きを完了するのに、十分な残金がありません。"
"StoreCheckout_TimedOut"	"このお取引は、タイムアウトで無効になりました。購入手続きをやり直してください。"
"StoreCheckout_SteamAccountDisabled"	"あなたのSteam アカウントが無効になっており、購入することができません。"
"StoreCheckout_SteamAccountNoPurchase"	"この Steam アカウントでは、Steam ウォレットでのお取引ができなくなっています。"
"StoreCheckout_OldPriceSheet"	"ローカルの製品リストは、最新版ではありません。新しい製品リストを要求中です。"
"StoreCheckout_TransactionNotFound"	"ゲームコーディネータでは、このお取引の ID が見つかりませんでした。購入手続きをやり直してください。"
"StoreCheckout_TransactionCancelled"	"この取引はキャンセルされました。お客様へのご請求はありません。"
"StoreCheckout_TransactionCompleted"	"お取引が完了しました！\\\n存分にお楽しみください！"
"StoreCheckout_CompleteButUnfinalized"	"お取引の完了を確認できません。正常に完了した場合、ご注文のアイテムが後日配信されます。"
"StoreCheckout_NotEnoughRoom"	"購入希望のアイテムが多すぎて、保管庫の容量が不足しています。"
"StoreCheckout_ContactSupport_Dialog_Title"	"警告"
"StoreCheckout_ContactSupport_Dialog_Btn"	"連絡する"
"StoreCheckout_LimitedQuantityItemsUnavailable"	"ご購入しようとしていたアイテムは売り切れか、現在入手不可です。"
"DOTA_AbilityTooltip_Name"	"{s:name}"
"DOTA_AbilityTooltip_Level"	"レベル {s:level}"
"DOTA_AbilityTooltip_TargetType"	"対象: {s:targettype}"
"DOTA_AbilityTooltip_CastType"	"アビリティ: {s:casttype}"
"DOTA_AbilityTooltip_DamageType"	"ダメージタイプ: {s:damagetype}"
"DOTA_AbilityTooltip_SpellImmunityType"	"スペル耐性を貫通: {s:spellimmunity}"
"DOTA_AbilityTooltip_Description"	"{s:description}"
"DOTA_AbilityTooltip_ScepterDescription"	"{s:scepterdescription}"
"DOTA_AbilityTooltip_ExtraDescription"	"{s:extradescription}"
"DOTA_AbilityTooltip_Attributes"	"{s:attributes}"
"DOTA_AbilityTooltip_Cooldown"	"{s:cooldown}"
"DOTA_AbilityTooltip_ManaCost"	"{s:manacost}"
"DOTA_AbilityTooltip_Lore"	"{s:lore}"
"DOTA_AbilityTooltip_UpgradeLevel"	"次のアップグレードはヒーローレベル {d:upgradelevel}"
"DOTA_AbilityTooltip_BuildHeader"	"アビリティガイド"
"DOTA_AbilityTooltip_BuildComment"	"{s:buildcomment}"
"DOTA_PersonaTooltip_Title"	"{g:dota_persona:account_id}"
"DOTA_PersonaTooltip_TitlePro"	"{g:dota_persona_pro:account_id}"
"DOTA_PendingInvites"	"パーティ招待"
"DOTA_ChatTab_Close"	"このタブを閉じる。"
"DOTA_ChatTab_Leave"	"このチャンネルから退出。"
"DOTA_JoinChatChannel_Title"	"チャンネルに参加"
"DOTA_JoinChatChannel_Description"	"チャットチャンネルを作成あるいは参加する。"
"DOTA_JoinChatChannel_AddToCurrentTab"	"現在のタブ '{s:current_tab_name}'に追加"
"DOTA_JoinChatChannel_CreateNewTab"	"新しいタブを作成:"
"DOTA_Chat_ChannelName"	"{s:channel_name}"
"DOTA_Chat_ChannelMemberCount_Singular"	"1 人"
"DOTA_Chat_ChannelMemberCount_Plural"	"{d:channel_member_count} 人"
"DOTA_EditChatTab_Title"	"チャットタブを変更"
"DOTA_EditChatTab_Target"	"{s:target}"
"DOTA_Chat_TimestampFormat"	"{t:t:timestamp}"
"DOTA_Chat_Autocomplete_Title"	"{s:autocomplete_title}"
"DOTA_Chat_Autocomplete_CommandName"	"/{s:command_name}"
"DOTA_Chat_Autocomplete_CommandDescription"	"{s:command_description}"
"dota_suggest_invite_format"	"%s1 をパーティーに招待してください。"
"DOTA_ChatMessage_System"	"<span class=\"{s:target_class}\"><span class=\"ChatTarget\">({s:target})</span>: {s:message}</span>"
"DOTA_ChatTarget_Format_Default"	"{s:target}"
"DOTA_ChatTarget_Prompt_Default"	"({s:target})へ:"
"DOTA_ChatTarget_Format_Whisper"	"{s:persona}"
"DOTA_ChatTarget_Party"	"パーティ"
"DOTA_ChatTarget_Lobby"	"ロビー"
"DOTA_ChatTarget_Team"	"チーム"
"DOTA_ChatTarget_Guild"	"ギルド"
"DOTA_ChatTarget_Fantasy"	"ファンタジー"
"DOTA_ChatTarget_Console"	"コンソール"
"DOTA_ChatTarget_GameAll"	"全員"
"DOTA_ChatTarget_GameAllies"	"味方"
"DOTA_ChatTarget_GameCoaching"	"コーチ"
"DOTA_ChatTarget_GameSpectator"	"観戦者"
"DOTA_ChatTargetMenu_Title"	"{s:target}"
"DOTA_ChatTargetMenu_ToggleEnabled"	"{s:toggle_enabled}"
"DOTA_ChatTargetMenu_NotActive"	"(Not Active)"
"DOTA_Chat_MissedMessages"	"{s:missed_message_count}"
"DOTA_ChatCommand_Party"	"p"
"DOTA_ChatCommand_Party_Name"	"パーティ"
"DOTA_ChatCommand_Party_Description"	"現在のパーティとチャット。"
"DOTA_ChatCommand_Lobby"	"l"
"DOTA_ChatCommand_Lobby_Name"	"ロビー"
"DOTA_ChatCommand_Lobby_Description"	"現在のロビーとチャット。"
"DOTA_ChatCommand_Channel"	"c"
"DOTA_ChatCommand_Channel_Name"	"チャンネル"
"DOTA_ChatCommand_Channel_Description"	"特定のチャットチャンネルとチャット。"
"DOTA_ChatCommand_Whisper"	"w"
"DOTA_ChatCommand_Reply"	"r"
"DOTA_ChatCommand_Reply_Name"	"返信"
"DOTA_ChatCommand_Help"	"?"
"DOTA_ChatCommand_Help_Name"	"ヘルプ"
"DOTA_ChatCommand_Help_Description"	"チャットコマンドにヘルプを表示。"
"DOTA_ChatCommand_InviteToParty"	"パーティ招待"
"DOTA_ChatCommand_InviteToParty_Name"	"パーティに招待"
"DOTA_ChatCommand_InviteToParty_Description"	"フレンドに現在のパーティへ招待する。"
"DOTA_ChatCommand_LeaveParty"	"パーティ退出"
"DOTA_ChatCommand_LeaveParty_Name"	"パーティから退出"
"DOTA_ChatCommand_LeaveParty_Description"	"現在のパーティから退出する。"
"DOTA_ChatCommand_JoinChannel"	"チャンネル参加"
"DOTA_ChatCommand_JoinChannel_Name"	"チャンネルに参加"
"DOTA_ChatCommand_JoinChannel_Description"	"チャットチャンネルに参加または作成する。"
"DOTA_ChatCommand_LeaveChannel"	"チャンネル退出"
"DOTA_ChatCommand_LeaveChannel_Name"	"チャンネルから退出"
"DOTA_ChatCommand_LeaveChannel_Description"	"特定のチャットチャンネルから退出する。"
"DOTA_ChatCommand_GameAll"	"全員"
"DOTA_ChatCommand_GameAll_Name"	"全員"
"DOTA_ChatCommand_GameAll_Description"	"ゲーム内全てのプレイヤーとチャットする。"
"DOTA_ChatCommand_GameAllies"	"味方"
"DOTA_ChatCommand_GameAllies_Name"	"味方"
"DOTA_ChatCommand_GameAllies_Description"	"味方とチャットする。"
"DOTA_ChatCommand_GameCoaching"	"コーチ"
"DOTA_ChatCommand_GameCoaching_Name"	"コーチ"
"DOTA_ChatCommand_GameCoaching_Description"	"生徒あるいはコーチとチャットする。"
"DOTA_ChatCommand_GameSpectator"	"観戦者"
"DOTA_ChatCommand_GameSpectator_Name"	"観戦者"
"DOTA_ChatCommand_GameSpectator_Description"	"他の観戦者とチャットする。"
"DOTA_ChatCommand_Clear"	"クリア"
"DOTA_ChatCommand_Clear_Name"	"クリア"
"DOTA_ChatCommand_Clear_Description"	"このタブ内の全チャットをクリアする。"
"DOTA_Chat_UnknownCommandMessage"	"不明なチャットコマンド '{s:chat_command}'"
"DOTA_ChatHelp_Targets"	"対象"
"DOTA_ChatHelp_Commands"	"コマンド"
"DOTA_ChatHelp_NameFormat"	"{s:command_name}:"
"DOTA_ChatHelp_CommandFormat"	"/{s:command}"
"DOTA_Chat_JoinedParty"	"パーティに参加: {s:party_members}"
"DOTA_Chat_LeftParty"	"パーティが解散しました。"
"DOTA_Chat_MemberJoinedParty"	"プレイヤーがパーティに参加: {s:party_members}"
"DOTA_Chat_MemberLeftParty"	"プレイヤーがパーティから退出: {s:party_members}"
"DOTA_Chat_InvitedToJoinParty"	"招待: {s:party_members}"
"DOTA_Chat_PartyMemberSeparator"	", "
"DOTA_Treasure_Purchase_Under_Construction_Text"	"トレジャーの購入はまだできませんが、Dota ストアからの購入はサポートされています。左側で、購入可能なアイテムセットをご覧いただけます。"
"DOTA_Invite_IOfN"	"{d:received_invite_index} / {d:received_invite_count}"
"DOTA_PartyInvite_Description"	"{g:dota_persona:b:inviter} があなたをパーティに招待しました。"
"DOTA_PartyInvite_BlockNonFriendInvitesDescription"	"設定パネルのオプション/プロフィールから設定できます"
"DOTA_PartySettings"	"パーティ設定"
"DOTA_LobbyInvite_Description"	"{g:dota_persona:inviter} があなたをロビーに招待しました。"
"DOTA_PartyLeader"	"パーティリーダー"
"DOTA_PlayerContextMenu_ViewProfile"	"プロフィールを表示"
"DOTA_PlayerContextMenu_ChatWithPlayer"	"メッセージを送信"
"DOTA_PlayerContextMenu_InviteToParty"	"パーティーに招待"
"DOTA_PlayerContextMenu_SuggestInviteToParty"	"パーティに誘う"
"DOTA_PlayerContextMenu_KickFromParty"	"パーティから追放する"
"DOTA_PlayerContextMenu_SetPartyLeader"	"パーティリーダーに任命する"
"DOTA_PlayerContextMenu_LeaveParty"	"パーティを抜ける"
"DOTA_PlayerContextMenu_CoachParty"	"このパーティをコーチする"
"DOTA_PlayerContextMenu_StopCoachingParty"	"このパーティのコーチをやめる"
"DOTA_PlayerContextMenu_AddFriend"	"フレンドを追加"
"DOTA_PlayerContextMenu_RemoveFriend"	"フレンドを削除"
"DOTA_PlayerContextMenu_AcceptFriendRequest"	"フレンドリクエストを承認"
"DOTA_PlayerContextMenu_IgnoreFriendRequest"	"フレンドリクエストを無視"
"DOTA_PlayerContextMenu_Spectate"	"ゲームを観戦"
"DOTA_PlayerContextMenu_InviteToLobby"	"ロビーに招待"
"DOTA_PlayerContextMenu_SuggestInviteToLobby"	"ロビーに誘う"
"DOTA_PlayerContextMenu_KickFromLobby"	"ロビーから追放する"
"DOTA_PlayerContextMenu_KickFromLobbyTeam"	"チームロビーから追放する"
"DOTA_FeaturedHero_HeroName"	"{s:hero_name}"
"DOTA_FeaturedHero_ItemName"	"{g:dota_item_name:item_def}"
"DOTA_FeaturedHeroReason_NewItem"	"新 {s:item_rarity}"
"DOTA_FeaturedHeroReason_FeaturedItem"	"注目のアイテム"
"DOTA_FeaturedHeroReason_PopularItem"	"売り上げ上位"
"DOTA_FeaturedHeroReason_SaleItem"	"セール中"
"DOTA_HeroSelectorCategory_Default"	"全てのヒーロー"
"DOTA_HeroSelectorCategory_NewItems"	"新アイテム"
"DOTA_HeroSelectorCategory_Favorites"	"お気に入り"
"DOTA_HeroSelectorCategory_MostPlayed"	"最もプレイ"
"DOTA_HeroSelectorCategory_PrimaryAttribute_Strength"	"Strength"
"DOTA_HeroSelectorCategory_PrimaryAttribute_Agility"	"Agility"
"DOTA_HeroSelectorCategory_PrimaryAttribute_Intelligence"	"Intelligence"
"DOTA_HeroSelectorCategory_AttackRange_Melee"	"近距離"
"DOTA_HeroSelectorCategory_AttackRange_Ranged"	"遠距離"
"DOTA_HeroSelector_SelectHero_Label"	"ピック"
"DOTA_HeroSelector_ClearFilters"	"フィルタをクリア"
"DOTA_EquippedItemSet_Selector_Title"	"装備中"
"DOTA_OwnedItemSet_Available_Title"	"入手可能"
"DOTA_FeaturedItemSet_Selector_Title"	"一押し"
"DOTA_AllItemSet_Selector_Title"	"全て"
"DOTA_ConfirmLANLobby_desc"	"あなたのマシンでローカルゲームをホストしています。ローカルゲームのホストに必要なシステム要件はより高くなります。"
"DOTA_ConfirmLANLobbyDisconnect_title"	"ローカルロビーから退出しますか？"
"DOTA_ConfirmLANLobbyDisconnect_ok"	"はい、切断します"
"DOTA_Lobby_Settings_Required"	"必須"
"DOTA_Lobby_Settings_Confirm"	"{s:lobby_confirm_label}"
"DOTA_Lobby_Settings_Game_Mode"	"ゲームモード"
"DOTA_Lobby_Settings_Region"	"サーバーの位置"
"DOTA_Lobby_Settings_Password"	"ロビーパスワード"
"DOTA_Lobby_Settings_Game_Name"	"ゲーム名"
"DOTA_Lobby_Settings_Advanced"	"上級者向けロビー設定"
"DOTA_Lobby_Settings_Competitive"	"対戦"
"DOTA_Lobby_Settings_Starting_Team"	"開始チーム"
"DOTA_Lobby_Settings_Starting_Team_Random"	"ランダム"
"DOTA_Lobby_Settings_Starting_Team_Radiant"	"RADIANT"
"DOTA_Lobby_Settings_Starting_Team_Dire"	"DIRE"
"DOTA_Lobby_Settings_Penalty_Radiant"	"ペナルティ - RADIANT"
"DOTA_Lobby_Settings_Penalty_Dire"	"ペナルティ - DIRE"
"DOTA_Lobby_Settings_Penalty_Level_0"	"ペナルティなし"
"DOTA_Lobby_Settings_Series_Best_of_3"	"3番勝負"
"DOTA_Lobby_Settings_Series_Best_of_5"	"5番勝負"
"DOTA_Lobby_Settings_Gameplay_Rules"	"ゲームプレイのルール"
"DOTA_Lobby_Settings_Enable_Cheats"	"チートを有効化"
"DOTA_Lobby_Settings_All_Chat"	"全体チャット"
"DOTA_Lobby_Settings_Fill_Bots"	"ボットで空のスロットを埋める"
"DOTA_Lobby_Settings_Bot_Difficulty"	"ボットの難易度"
"DOTA_Lobby_Settings_Bot_Difficulty_Passive"	"パッシブ"
"DOTA_Lobby_Settings_Bot_Difficulty_Easy"	"イージー"
"DOTA_Lobby_Settings_Bot_Difficulty_Medium"	"ミディアム"
"DOTA_Lobby_Settings_Bot_Difficulty_Hard"	"ハード"
"DOTA_Lobby_Settings_Bot_Difficulty_Unfair"	"アンフェア"
"DOTA_Lobby_Settings_Version"	"バージョン"
"DOTA_Lobby_Settings_Version_Latest"	"最新"
"DOTA_Lobby_Settings_Version_Tournament"	"トーナメント"
"DOTA_Lobby_Settings_Spectator_Section"	"観戦者"
"DOTA_Lobby_Settings_Dota_TV_Delay"	"DOTA TV 遅延"
"DOTA_Lobby_Settings_Dota_TV_Delay_2_Minutes"	"2分"
"DOTA_Lobby_Settings_Dota_TV_Delay_5_Minutes"	"5分"
"DOTA_Lobby_Settings_Dota_TV_Delay_10_Seconds"	"10秒"
"DOTA_Lobby_Settings_Spectators"	"観戦者"
"DOTA_Lobby_Settings_Spectators_Enabled"	"有効"
"DOTA_Lobby_Settings_Spectators_Disabled"	"無効"
"dota_lobby_settings_hide_password"	"パスワードを非表示"
"dota_lobby_settings_local_host"	"ローカルホスト"
"DOTA_Lobby_Settings_Visibility"	"ロビー公開度"
"DOTA_Lobby_Settings_Visibility_Public"	"公開"
"DOTA_Lobby_Settings_Visibility_Friends"	"フレンド"
"DOTA_LeagueUnsetHeader"	"リーグが選択されていません"
"dota_radiant"	"The Radiant"
"dota_dire"	"The Dire"
"dota_lobby_team_name_radiant"	"{s:team_name_good_guys}"
"dota_lobby_team_name_dire"	"{s:team_name_bad_guys}"
"dota_lobby_no_team"	"チームなし"
"dota_lobby_broadcast_default_channel_name"	"チャンネル名"
"dota_lobby_broadcast_join"	"参加"
"dota_lobby_broadcast_leave"	"退出"
"dota_lobby_broadcast_create"	"新しいチャンネルを作成"
"dota_popup_broadcast_channel_edit_title"	"ブロードキャストチャンネルのカスタマイズ"
"dota_lobby_broadcast_default_channel_name_custom"	"{s:custom_title}"
"dota_popup_broadcast_channel_edit_channel_name"	"チャンネルタイトル"
"dota_popup_broadcast_channel_edit_country"	"国"
"dota_popup_broadcast_channel_edit_language"	"言語"
"DOTA_Lobby_Broadcaster_Channel_Other_Language"	"他の言語"
"lobby_slot_error_header"	"スロット変更ができません"
"generic_gc_timeout"	"メッセージがタイムアウトしました。"
"lobby_slot_success_header"	"成功"
"lobby_slot_denied"	"このスロットに参加できません。"
"lobby_slot_cameramanalready"	"ブロードキャスターチャンネルのカメラマンは一人だけです"
"lobby_slot_cameramanon"	"現在あなたはカメラマンです"
"lobby_slot_cameramanoff"	"あなたはもうカメラマンではありません"
"lobby_slot_error"	"ロビースロットの変更に失敗しました。"
"lobby_create_timeout"	"ロビーの作成に失敗しました。"
"DOTA_DialogVariableTest1"	"シンプル: {s:var}"
"DOTA_DialogVariableTest3"	"アイテムのリンク： {g:dota_item_link:item_def}"
"DOTA_DialogVariableTest4"	"アイテムの価格： {g:dota_item_price:item_def}"
"DOTA_DialogVariableTest5"	"アカウント ID 名: {g:dota_persona:account_id}, プロネーム: {g:dota_persona:pro:account_id}"
"LobbySetting_GameMode"	"ゲームモード"
"LobbySetting_GameMode_Value"	"{s:lobbysetting_gamemode}"
"LobbySetting_Bots"	"ボット"
"LobbySetting_Password"	"パスワード"
"LobbySetting_Password_Value"	"{s:lobbysetting_password}"
"LobbySetting_Server"	"サーバー"
"LobbySetting_Server_Value"	"{s:lobbysetting_server}"
"LobbySetting_Cheats"	"チート"
"LobbySetting_Cheats_Value"	"{s:lobbysetting_cheats}"
"LobbySetting_Spectators"	"観戦者"
"LobbySetting_Spectators_Value"	"{s:lobbysetting_spectators}"
"LobbySetting_Visibility"	"公開設定"
"LobbySetting_Visibility_Value"	"{s:lobbysetting_visibility}"
"dota_lobby_lan_title"	"ローカルロビー"
"dota_lobby_coaches_none"	"コーチ: なし"
"dota_lobby_coaches"	"コーチ:"
"DOTA_Custom_Game"	"カスタムゲーム"
"DOTA_Custom_Game_Info"	"情報"
"DOTA_Custom_Game_View_Details"	"ゲーム詳細を表示"
"DOTA_Custom_Game_Author"	"{g:dota_persona:author}作成"
"DOTA_Custom_Game_Lobby_Count"	"{d:lobby_count} ロビー"
"DOTA_Custom_Game_Lobby_Count_Plural"	"{d:lobby_count} ロビー"
"DOTA_Custom_Game_Friend_Lobbies_Alert"	"{d:friend_count} 人のフレンドがオープンなゲームロビー内にいます。"
"DOTA_Custom_Game_Friend_Lobbies_Alert_Plural"	"{d:friend_count} 人のフレンドがオープンなゲームロビー内です。"
"DOTA_Custom_Game_Quick_Join"	"すぐ参加"
"DOTA_Custom_Game_View_Lobbies"	"ロビーを表示"
"DOTA_Custom_Game_Find_Lobby"	"ロビーを検索"
"DOTA_Custom_Game_Create_Lobby"	"ロビーを作成"
"DOTA_Custom_Game_Game_Page"	"ゲームページ"
"DOTA_Custom_Game_Workshop_Page"	"ワークショップページ"
"DOTA_Custom_Game_Download_Queued"	"ダウンロードキューに追加済み"
"DOTA_Custom_Game_Downloading"	"ダウンロード中..."
"DOTA_Custom_Game_Downloading_Percent"	"ダウンロード中 - {d:lobby_download_percent}%"
"DOTA_Custom_Game_Needs_Update"	"要アップデート"
"DOTA_Custom_Game_Play"	"{s:game_mode_name}をプレイ"
"DOTA_Custom_Game_Uninstall"	"アンインストール"
"DOTA_Custom_Game_Install"	"インストール"
"DOTA_Custom_Game_Installed"	"インストール済み"
"DOTA_Custom_Game_Not_Installed"	"インストールしていません"
"DOTA_Custom_Game_Connect"	"ロビーに参加"
"DOTA_Custom_Game_FileSize"	"{d:file_size} MB"
"DOTA_Custom_Game_Name"	"{s:game_mode_name}"
"DOTA_Custom_Game_Subscription"	"{s:subscriptions_count} サブスクリプション"
"DOTA_Custom_Game_Subscriptions"	"{s:subscriptions_count} サブスクリプション"
"DOTA_Custom_Game_Rating"	"評価"
"DOTA_Custom_Game_Release_Date"	"リリース日"
"DOTA_Custom_Game_Playing_Now"	"{s:player_count} 人プレイ中"
"DOTA_Custom_Game_Ratings_Count"	"({d:ratings_count})"
"DOTA_Custom_Game_Description"	"{s:game_description}"
"DOTA_Custom_Game_Last_Updated"	"最終更新 {t:r:t:last_updated}"
"DOTA_Custom_Game_Update_Note_Title"	"{s:timestamp}"
"DOTA_Custom_Game_Screenshots"	"スクリーンショット"
"DOTA_Custom_Game_Map_Label"	"マップ"
"DOTA_Custom_Game_Map_Any"	"任意"
"DOTA_Custom_Game_Update"	"更新"
"DOTA_Custom_Game_Spectate"	"観戦"
"DOTA_Custom_Game_Already_In_Lobby"	"現在のゲームを終了してこのゲームモードを開始する。"
"DOTA_Custom_Game_Friends_Playing"	"カスタムゲームをプレイ中のフレンド"
"DOTA_Custom_Game_Friends_In_Lobbies"	"{d:friends_in_open_lobbies} 人がオープンンロビー内"
"DOTA_Custom_Game_Friends_In_Game"	"{d:friends_in_game} 人のフレンドがカスタムゲーム"
"DOTA_Custom_Games_Friends_Play"	"フレンドがプレイしているカスタムゲーム"
"DOTA_Custom_Game_Invite_Friend"	"フレンドを招待"
"DOTA_Custom_Game_Tooltip_Subscribers"	"{d:subscriber_count} サブスクリプション"
"DOTA_Custom_Game_Tooltip_Subscriber"	"{d:subscriber_count} サブスクリプション"
"DOTA_Custom_Game_Most_Popular"	"人気"
"DOTA_Custom_Game_Installed_Games"	"インストール済みのゲーム"
"DOTA_Custom_Game_Favorite_Games"	"お気に入りのみを表示"
"DOTA_Custom_Game_Add_Favorite"	"お気に入り"
"DOTA_Custom_Game_Vote_Box_Title"	"ワークショップ投票"
"DOTA_Custom_Game_Vote_Start"	"投票を開始"
"DOTA_Custom_Game_VoteThanks"	"投票ありがとう！"
"DOTA_Custom_Game_Vote_PrevLabel"	"前のゲーム"
"DOTA_Custom_Game_Vote_NextLabel"	"次のゲーム"
"DOTA_Custom_Game_Vote_ControlsLabel"	"ワークショップ投票"
"DOTA_Custom_Game_Suggested_Title"	"おすすめのゲーム"
"DOTA_Custom_Game_Search"	"カスタムゲームを検索"
"DOTA_Custom_Lobby_Create_Button"	"カスタムロビーを作成"
"DOTA_Custom_Lobby_Settings_Title"	"ロビーを作成"
"DOTA_Custom_Lobby_Settings_Mode"	"ゲームモード"
"DOTA_Custom_Lobby_Settings_Map"	"マップ"
"DOTA_Custom_Lobby_Public"	"公開"
"DOTA_Custom_Lobby_Passworded"	"招待を受けたプレイヤーか、パスワードでロビーリストをフィルタしたユーザーのみこのロビーに参加できます。"
"DOTA_Custom_Lobby_Join_Failed_Title"	"参加に失敗"
"DOTA_Custom_Lobby_Join_Failed_Reason"	"{s:join_error}"
"DOTA_Custom_Lobby_Join_Failed_Prompt"	"オープン {s:game_name} ロビーを検索しますか？"
"DOTA_Custom_Lobby_Create_Private_Button"	"プライベートロビーを作成"
"DOTA_Custom_Lobby_List_Game_Header"	"ゲーム"
"DOTA_Custom_Lobby_List_Name_Header"	"説明"
"DOTA_Custom_Lobby_List_Players_Header"	"プレイヤー"
"DOTA_Custom_Lobby_List_Map_Header"	"マップ"
"DOTA_Custom_Lobby_List_Region_Header"	"地域"
"DOTA_Custom_Lobby_List_Connection_Header"	"接続"
"DOTA_Custom_Lobby_List_Status_Header"	"ローカルステータス"
"DOTA_Custom_Lobby_List_Game"	"{s:lobby_game}"
"DOTA_Custom_Lobby_List_Lobby_Name"	"{s:lobby_name}"
"DOTA_Custom_Lobby_List_Players"	"{s:lobby_players} / {s:lobby_max_players}"
"DOTA_Custom_Lobby_List_Map"	"{s:lobby_map}"
"DOTA_Custom_Lobby_List_Region"	"{s:lobby_region}"
"DOTA_Custom_Lobby_List_Connection"	"..."
"DOTA_Custom_Lobby_List_Status"	"{s:lobby_status}"
"DOTA_Custom_Lobby_List_Connect"	"{s:connect_button_text}"
"DOTA_Custom_Lobby_Game_Name"	"{s:game_name}"
"DOTA_Custom_Lobby_Map_Name"	"マップ: {s:map_name}"
"DOTA_Custom_Lobby_Player_Count"	"プレイヤー: {d:player_count} / {d:max_player_count}"
"DOTA_Custom_Lobby_Player_Count_Short"	"{d:player_count} / {d:max_player_count}"
"DOTA_Custom_Lobby_Visibility"	"ロビー公開設定"
"DOTA_Custom_Join_Chat"	"チャットに参加"
"DOTA_Custom_Join_Chat_Member_Count"	"({d:ChatMemberCount})"
"DOTA_Custom_Leave_Chat"	"チャットを退出"
"DOTA_Page_Number"	"ページ: {d:current_page} / {d:num_pages}"
"DOTA_TabName_ModsOverview"	"概要"
"DOTA_TabName_ModsSubscribed"	"ライブラリ"
"DOTA_TabName_ModsWorkshop"	"ワークショップ"
"DOTA_TabName_ModsBrowse"	"閲覧"
"DOTA_WatchTabName_Live"	"ライブ"
"DOTA_WatchTabName_Featured"	"一押し"
"DOTA_WatchTabName_Replays"	"リプレイ"
"DOTA_WatchTabName_Tournaments"	"トーナメント"
"DOTA_WatchTabName_Downloads"	"ダウンロード"
"DOTA_WatchLive_Search"	"ヒーローで検索して観戦"
"DOTA_WatchLive_DataPending"	"ライブゲームを検索中..."
"DOTA_WatchLive_DataError"	"ライブゲームロード中のエラー"
"DOTA_WatchLive_NoGames"	"プレイ中のライブゲームがありません"
"DOTA_WatchLive_Connecting"	"ゲームデータを待機中..."
"DOTA_WatchLive_HeroFilter"	"フィルタ: {s:hero_filter_name}"
"DOTA_WatchLive_CountSpec"	"{i:num_spectating} 観戦中"
"DOTA_WatchLive_CountSpecFriend"	"{i:num_friends_spectating} 人のフレンドと {i:num_spectating} 人の観戦者"
"DOTA_WatchLive_CountSpecFriends"	"{i:num_friends_spectating} 人のフレンドと {i:num_spectating} 人の観戦者"
"DOTA_WatchLive_CountFriends"	"{i:num_friends_playing} 人のフレンドがプレイ中"
"DOTA_WatchLive_ParticipantsVs"	"<font color='#ffffff'>{s:team_1}</font> <font color='#888888'>対</font> <font color='#ffffff'>{s:team_2}</font>"
"DOTA_WatchLive_ParticipantsMMR"	"<font color='#ffffff'>{i:mmr}</font> <font color='#888888'>平均 MMR</font>"
"DOTA_WatchLive_Participants1"	"{s:friend_1}"
"DOTA_WatchLive_Participants2"	"{s:friend_1} と {s:friend_2}"
"DOTA_WatchLive_Participants3"	"{s:friend_1}, {s:friend_2}, と {s:friend_3}"
"DOTA_WatchLive_Participants4Plus"	"{s:friend_1}, {s:friend_2}, {s:friend_3}, と {i:friend_count_over_3} など等..."
"DOTA_WatchLive_MatchType_MM_Kills"	"{s:game_mode}"
"DOTA_WatchLive_MatchType_MM"	"{s:game_mode}"
"DOTA_WatchLiveDotaTV"	"DotaTV で観戦"
"DOTA_WatchLivePurchase"	"トーナメントパスを入手 {g:dota_item_price:ticket_itemdef}"
"DOTA_WatchLiveSpectatorFriends1"	"{g:dota_persona:spectator_friend_1} 人観戦中"
"DOTA_WatchLiveSpectatorFriends2"	"{g:dota_persona:spectator_friend_1} と {g:dota_persona:spectator_friend_2} 人観戦中"
"DOTA_WatchLiveSpectatorFriends3"	"{g:dota_persona:spectator_friend_1}, {g:dota_persona:spectator_friend_2}, 更に {g:dota_persona:spectator_friend_3} 人観戦中"
"DOTA_WatchLiveSpectatorFriends4Plus"	"{g:dota_persona:spectator_friend_1}, {g:dota_persona:spectator_friend_2}, {g:dota_persona:spectator_friend_3}, と {i:spectator_friend_count_over_3} 人のフレンドが観戦中"
"DOTA_WatchLiveSpectatorCount"	"{i:spectator_count} 人観戦中"
"DOTA_WatchLivePreGame"	"ゲーム前"
"DOTA_WatchLive_ElapsedTime"	"経過時間："
"DOTA_WatchLive_Spectating"	"観戦中："
"DOTA_WatchReplays_TournamentsHeader"	"人気のトーナメントマッチ"
"DOTA_WatchReplays_FriendsHeader"	"フレンドのマッチ"
"DOTA_WatchReplays_Popular"	"人気のマッチ"
"DOTA_WatchReplays_ParticipantsVs"	"{s:team_1} 対 {s:team_2}"
"DOTA_WatchReplays_MatchType_League"	"{s:league_name}"
"DOTA_WatchReplays_MatchType_Public"	"マッチ {s:match_id} - {s:game_mode}"
"DOTA_WatchReplays_Recommendations"	"{i:recommendations}"
"DOTA_WatchReplays_Recommendations1"	"{g:dota_persona:friend_1} + {i:recommendations}"
"DOTA_WatchReplays_Recommendations2"	"{g:dota_persona:friend_1}, {g:dota_persona:friend_2} + {i:recommendations}"
"DOTA_WatchReplays_Recommendations3Plus"	"{g:dota_persona:friend_1} + {i:friend_count_over_1} 人以上のフレンド + {i:recommendations}"
"DOTA_WatchReplays_Friends1"	"{g:dota_persona:b:friend_1} がプレイしました"
"DOTA_WatchReplays_Friends2"	"{g:dota_persona:b:friend_1} と {g:dota_persona:friend_2} がプレイしました"
"DOTA_WatchReplays_Friends3Plus"	"{g:dota_persona:b:friend_1}, {g:dota_persona:b:friend_2} と {i:friend_count_over_2} 人のフレンド"
"DOTA_WatchReplays_Views"	"{i:views} 回再生"
"DOTA_WatchReplays_Price"	"{g:dota_item_price:ticket_itemdef}"
"DOTA_WatchReplays_SharedMatch"	"{g:dota_persona:shared_by} が共有 - '{s:shared_text}'"
"DOTA_WatchReplays_SharedHighlight"	"{g:dota_persona:shared_by} がハイライトを共有"
"DOTA_WatchReplays_Duration"	"{s:minutes}:{s:seconds}"
"DOTA_WatchReplays_Tag"	"\"{s:recommendation_text}\""
"DOTA_WatchTournaments_FeaturedTitle"	"{s:tournament_featured_title}"
"DOTA_WatchTournaments_FeaturedDates"	"{s:tournament_featured_start} - {s:tournament_featured_end}"
"DOTA_WatchTournaments_FeaturedDescription"	"{s:tournament_featured_description}"
"DOTA_WatchTournaments_FeaturedTeams"	"チーム"
"DOTA_WatchTournaments_PrizePool"	"賞金プール:"
"DOTA_WatchTournaments_PrizePoolAmt"	"{s:tournament_featured_prize_pool}"
"DOTA_WatchTournaments_Purchase"	"トーナメントパス - {s:tournament_featured_price}"
"DOTA_WatchTournament_TournamentName"	"{s:tournament_name}"
"DOTA_WatchTournament_Price"	"{s:price}"
"DOTA_Replays_Search"	"MatchID で検索"
"DOTA_Watch_Pending"	"ゲーム観戦を待っています..."
"DOTA_Watch_GameServerNotFound"	"このゲームをホストしているゲームサーバーが見つかりません。"
"DOTA_Watch_Unavailable"	"現在このゲームの観戦はできません。"
"DOTA_Watch_LobbyNotFound"	"ロビーがありません。"
"vs"	"対"
"dota_matchmaking_language_title"	"マッチメイキング言語を選択"
"dota_matchmaking_language_primary_label"	"あなたの第一マッチメイキング言語は:"
"dota_matchmaking_language_primary"	"{s:environment_language}"
"dota_matchmaking_language_primary_invalid"	"あなたの言語, {s:environment_language}, は Dota 2内でマッチメイキング言語として使用できません。"
"dota_matchmaking_language_select_secondary"	"ご希望なら第二言語を選択できます:"
"dota_matchmaking_language_select_primary"	"マッチメイキング言語を選択してください:"
"dota_matchmaking_language_no_selection"	"選択なし"
"dota_matchmaking_language_english"	"英語"
"dota_matchmaking_language_russian"	"ロシア語"
"dota_matchmaking_language_chinese"	"中国語"
"dota_matchmaking_language_schinese"	"中国語"
"dota_matchmaking_language_korean"	"韓国語"
"dota_matchmaking_language_koreana"	"韓国語"
"dota_matchmaking_language_spanish"	"スペイン語"
"dota_matchmaking_language_portuguese"	"ポルトガル語"
"GameUI_Language_English"	"英語"
"GameUI_Language_German"	"ドイツ語"
"GameUI_Language_French"	"フランス語"
"GameUI_Language_Italian"	"イタリア語"
"GameUI_Language_Korean"	"韓国語"
"GameUI_Language_Spanish"	"スペイン語"
"GameUI_Language_Simplified_Chinese"	"簡体中国語"
"GameUI_Language_Traditional_Chinese"	"繁体中国語"
"GameUI_Language_Russian"	"ロシア語"
"GameUI_Language_Thai"	"タイ語"
"GameUI_Language_Japanese"	"日本語"
"GameUI_Language_Portuguese"	"ポルトガル語"
"GameUI_Language_Polish"	"ポーランド語"
"GameUI_Language_Danish"	"デンマーク語"
"GameUI_Language_Dutch"	"オランダ語"
"GameUI_Language_Finnish"	"フィンランド語"
"GameUI_Language_Norwegian"	"ノルウェー語"
"GameUI_Language_Swedish"	"スウェーデン語"
"GameUI_Language_Hungarian"	"ハンガリー語"
"GameUI_Language_Czech"	"チェコ語"
"GameUI_Language_Romanian"	"ルーマニア語"
"GameUI_Language_Turkish"	"トルコ語"
"GameUI_Language_Brazilian"	"ブラジルポルトガル語"
"GameUI_Language_Bulgarian"	"ブルガリア語"
"GameUI_Language_Greek"	"ギリシャ語"
"GameUI_Language_Ukrainian"	"ウクライナ語"
"client_version_out_of_date_title"	"更新必須"
"client_version_out_of_date"	"ゲームクライアントが最新版ではありません。Dota 2 を終了してから再起動し、最新版を入手してください。"
"dota_matchmaking_region_title"	"マッチメイキングの地域を選択"
"dota_matchmaking_region_auto"	"お住まいの地域に基づいて自動で地域を選択します。"
"dota_matchmaking_region_select"	"マッチメイキングの地域は最大 3 つまで選択できます。快適に遊ぶためには最も近い地域を選択してください。"
"limited_heroes_abandon_header"	"限定ヒーローモード"
"limited_heroes_abandon_explanation"	"限定ヒーローモードを抜けたとしてもあなたの代わりにボットがプレイを続けるので、罰はありません。他のゲームモードにおいてゲームを放棄すると、優先度の低いキューに入れられてしまいます。"
"dota_leave_dialog_yes"	"はい、退出します。"
"dota_accept_match_title"	"ゲームの準備が整いました"
"dota_accept_match_readyup_title"	"プレイヤーを待っています"
"dota_accept_match_accept"	"承認"
"dota_accept_match_accept_button"	"{s:accept}"
"dota_accept_match_subtitle"	"{s:subtitle}"
"dota_finding_match_players"	"（マッチを検索しています...  {s:searching_player_count})"
"dota_finding_match_generic"	"ノーマルマッチ"
"dota_finding_match_ranked"	"ランクマッチ"
"dota_finding_match_bot"	"ボットマッチ"
"dota_finding_match_bot_passive"	"ボットマッチ (パッシブ)"
"dota_finding_match_bot_easy"	"ボットマッチ (イージー)"
"dota_finding_match_bot_medium"	"ボットマッチ (ミディアム)"
"dota_finding_match_bot_hard"	"ボットマッチ (ハード)"
"dota_finding_match_bot_unfair"	"ボットマッチ (アンフェア)"
"dota_finding_1v1_match_casual"	"1v1 マッチ"
"dota_finding_match_practice_lobby"	"ロビーゲーム"
"dota_match_connected"	"ゲームに接続"
"dota_match_local_game"	"ローカルゲームに接続済み"
"dota_match_connecting"	"ゲームに接続中..."
"dota_match_in_progress"	"ゲーム中"
"dota_match_finished"	"ゲーム終了"
"matchmaking_waiting_for_players"	"他のプレイヤーを待っています"
"matchmaking_player_declined"	"プレイヤーがマッチを拒否しました"
"dota_match_wait_for_host"	"ホストを待っています"
"dota_match_find_server"	"サーバーを検索中"
"ranked_mmr_solo_label"	"ソロ"
"ranked_mmr_solo_value"	"{i:solo_mmr}"
"ranked_mmr_party_label"	"パーティ"
"ranked_mmr_party_value"	"{i:party_mmr}"
"dota_ready_up_count"	"{s:ready_up_ready} / {s:ready_up_lobby_members}"
"dota_play_normal_match"	"ノーマルマッチ"
"dota_play_ranked_match"	"ランクマッチ"
"dota_play_practice_1v1"	"プラクティス 1v1"
"dota_play_practice_with_bots"	"ボットとプラクティス"
"dota_play_practice_1v1_playtab"	"プラクティス 1v1"
"dota_play_button_label"	"{s:play_button_label}"
"dota_play"	"Dota をプレイ"
"dota_play_searching"	"マッチを検索中"
"dota_play_lobby_find_server"	"サーバーを検索中"
"dota_reconnect"	"再接続"
"dota_abandon_game"	"ゲームから退出"
"dota_safe_leave_game"	"ゲームを退出"
"dota_disconnect"	"切断"
"dota_play_unavailable"	"使用不可"
"dota_leaver_consequences"	"{s:leaver_consequences}"
"dota_leaver_consequences_details"	"{s:leaver_consequences_details}"
"dota_leaver_view_tooltip"	"詳細を表示"
"dota_reconnect_popup_title"	"再接続しますか？"
"dota_matchmaking_region_ping"	"{s:region_ping}"
"dota_matchmaking_region_unknown_ping"	"Ping: 不明"
"dota_matchmaking_region_ping_time"	"Ping: {i:ping_ms}ms"
"DOTA_VAC_Verification_Header"	"Valve Anti-Cheat (VAC)"
"DOTA_VAC_Verification_Header_Solo"	"お使いのコンピュータの問題がVACシステムをブロックしているため、マッチメイキングに参加できません。VACと競合する可能性のあるプログラムが使用されておらず、Steamが正しくインストールされていることをご確認ください。"
"DOTA_VAC_Verification_Header_Party"	"お使いのコンピュータの問題がパーティーメンバーの1人以上の VAC システムをブロックしているため、マッチメイキングに参加できません。VAC と競合する可能性のあるプログラムが使用されておらず、Steam が正しくインストールされていることをご確認ください。"
"DOTA_VAC_Verification_Button2"	"閉じる"
"dota_matchmaking_regions_button"	"{s:regions_selected}"
"dota_region_automatic"	"地域: 自動"
"dota_regions_selected"	"地域："
"dota_lobby_region_invalid"	"なし"
"dota_play_no_language_selected"	"言語を選択"
"dota_play_language"	"{s:match_language}"
"dota_play_language_many"	"言語: {i:match_language_count}"
"dota_all_chat_label"	"[全員]"
"dota_chatwheel_label_Ok"	"OK"
"dota_chatwheel_label_Care"	"要注意"
"dota_chatwheel_label_GetBack"	"戻れ"
"dota_chatwheel_label_NeedWards"	"ワードが必要"
"dota_chatwheel_label_Stun"	"スタン"
"dota_chatwheel_label_Help"	"助けて"
"dota_chatwheel_label_Push"	"プッシュ"
"dota_chatwheel_label_GoodJob"	"ナイスプレイ"
"dota_chatwheel_label_Missing"	"行方不明"
"dota_chatwheel_label_Missing_Top"	"行方不明@トップ"
"dota_chatwheel_label_Missing_Mid"	"行方不明@ミドル"
"dota_chatwheel_label_Missing_Bottom"	"行方不明@ボトム"
"dota_chatwheel_label_Go"	"行け！"
"dota_chatwheel_label_Initiate"	"戦闘開始！"
"dota_chatwheel_label_Follow"	"ついて来て"
"dota_chatwheel_label_Group_Up"	"集まれ"
"dota_chatwheel_label_Spread_Out"	"広がれ"
"dota_chatwheel_label_Split_Farm"	"別々にファーム"
"dota_chatwheel_label_Attack"	"今すぐ攻撃！"
"dota_chatwheel_label_BRB"	"直ぐ戻る"
"dota_chatwheel_label_Dive"	"飛び込め！"
"dota_chatwheel_label_OMW"	"今行く"
"dota_chatwheel_label_Get_Ready"	"準備して"
"dota_chatwheel_label_Bait"	"罠だ"
"dota_chatwheel_label_Heal"	"回復して"
"dota_chatwheel_label_Mana"	"マナ"
"dota_chatwheel_label_OOM"	"マナが足りない"
"dota_chatwheel_label_Skill_Cooldown"	"クールダウン"
"dota_chatwheel_label_Ulti_Ready"	"Ulti準備OK"
"dota_chatwheel_label_Enemy_Returned"	"戻った"
"dota_chatwheel_label_Enemy_Incoming"	"やってくる"
"dota_chatwheel_label_Invis_Enemy"	"透明状態の敵"
"dota_chatwheel_label_Enemy_Had_Rune"	"敵はルーンを持っている"
"dota_chatwheel_label_Split_Push"	"分かれてプッシュ"
"dota_chatwheel_label_Coming_To_Gank"	"ギャンクに行く"
"dota_chatwheel_label_Request_Gank"	"ギャンクに来て"
"dota_chatwheel_label_Fight_Under_Tower"	"タワーの下"
"dota_chatwheel_label_Deny_Tower"	"タワーをディナイ"
"dota_chatwheel_label_Buy_Courier"	"クーリエを買って"
"dota_chatwheel_label_Upgrade_Courier"	"クーリエをアップグレード"
"dota_chatwheel_label_They_Have_Detection"	"敵に見つかった"
"dota_chatwheel_label_Buy_TP"	"TP を買って"
"dota_chatwheel_label_Reuse_Courier"	"クーリエを再使用して"
"dota_chatwheel_label_Deward"	"ワードを壊して"
"dota_chatwheel_label_Building_Mek"	"Mek を作っている"
"dota_chatwheel_label_Building_Pipe"	"Pipe を作っている"
"dota_chatwheel_label_Pull"	"クリープをプルして"
"dota_chatwheel_label_Pulling"	"クリープをプルしている"
"dota_chatwheel_label_Roshan"	"Roshan"
"dota_chatwheel_label_Affirmative"	"了解"
"dota_chatwheel_label_Wait"	"待って"
"dota_chatwheel_label_Pause"	"一時停止"
"dota_chatwheel_label_Current_Time"	"今の時間"
"dota_chatwheel_label_Check_Runes"	"ルーンをチェックして"
"dota_chatwheel_label_Smoke_Gank"	"スモークギャンク！"
"dota_chatwheel_label_GLHF"	"グッドラック"
"dota_chatwheel_label_Nice"	"いいね"
"dota_chatwheel_label_Thanks"	"ありがとう"
"dota_chatwheel_label_Sorry"	"ごめん"
"dota_chatwheel_label_No_Give_Up"	"あきらめるな"
"dota_chatwheel_label_My_Bad"	"悪かった"
"dota_chatwheel_label_Relax"	"リラックス"
"dota_chatwheel_label_GG"	"GG"
"dota_chatwheel_label_GGWP"	"GGWP"
"dota_chatwheel_label_All_GG"	"(全員) GG"
"dota_chatwheel_label_All_GGWP"	"(全員) GGWP"
"dota_chatwheel_label_What_To_Buy"	"何を買うべき？"
"dota_chatwheel_label_Im_Retreating"	"撤退する"
"dota_chatwheel_label_Whoops"	"おっと"
"dota_chatwheel_label_Ward_Bottom_Rune"	"ボトムルーンにワード設置"
"dota_chatwheel_label_Ward_Top_Rune"	"トップルーンにワード設置"
"dota_chatwheel_header_positioning"	"ポジショニング"
"dota_chatwheel_header_status"	"状況"
"dota_chatwheel_header_enemy"	"敵"
"dota_chatwheel_header_lane"	"レーン"
"dota_chatwheel_header_items"	"アイテム"
"dota_chatwheel_header_neutrals"	"ニュートラル"
"dota_chatwheel_header_misc"	"その他"
"dota_chatwheel_header_flavor"	"感情"
"dota_chatwheel_message_Ok"	"オーケー。"
"dota_chatwheel_message_Care"	"注意して！"
"dota_chatwheel_message_GetBack"	"戻って!"
"dota_chatwheel_message_NeedWards"	"ワードが必要。"
"dota_chatwheel_message_Stun"	"今すぐスタン！"
"dota_chatwheel_message_Help"	"ヘルプ！"
"dota_chatwheel_message_Push"	"今すぐプッシュ"
"dota_chatwheel_message_GoodJob"	"ナイスプレイ！"
"dota_chatwheel_message_Missing"	"姿が見えない！"
"dota_chatwheel_message_Missing_Top"	"トップには居ない！"
"dota_chatwheel_message_Missing_Mid"	"ミドルには居ない！"
"dota_chatwheel_message_Missing_Bottom"	"ボトムには居ない！"
"dota_chatwheel_message_Go"	"行け！"
"dota_chatwheel_message_Initiate"	"戦闘開始！"
"dota_chatwheel_message_Follow"	"ついて来て"
"dota_chatwheel_message_Group_Up"	"集まれ"
"dota_chatwheel_message_Split_Farm"	"別々にファームしよう"
"dota_chatwheel_message_Attack"	"今すぐ攻撃！"
"dota_chatwheel_message_BRB"	"すぐ戻る"
"dota_chatwheel_message_Dive"	"飛び込め！"
"dota_chatwheel_message_OMW"	"今行く"
"dota_chatwheel_message_Get_Ready"	"準備して"
"dota_chatwheel_message_Bait"	"罠だ"
"dota_chatwheel_message_Heal"	"回復して"
"dota_chatwheel_message_Mana"	"マナ"
"dota_chatwheel_message_OOM"	"マナが足りない"
"dota_chatwheel_message_Skill_Cooldown"	"スキルがクールダウン中"
"dota_chatwheel_message_Enemy_Returned"	"敵が戻った"
"dota_chatwheel_message_Enemy_Incoming"	"敵が来る！"
"dota_chatwheel_message_Invis_Enemy"	"近くに透明状態の敵がいる！"
"dota_chatwheel_message_Enemy_Had_Rune"	"敵はルーンを持っている"
"dota_chatwheel_message_Split_Push"	"分かれてプッシュ"
"dota_chatwheel_message_Coming_To_Gank"	"ギャンクに行く"
"dota_chatwheel_message_Request_Gank"	"ギャンクに来て"
"dota_chatwheel_message_Fight_Under_Tower"	"タワーの近くで戦って"
"dota_chatwheel_message_Deny_Tower"	"タワーをディナイして！"
"dota_chatwheel_message_Buy_Courier"	"クーリエを買ってください"
"dota_chatwheel_message_Upgrade_Courier"	"誰かクーリエをアップグレードして？"
"dota_chatwheel_message_Buy_TP"	"Teleport Scroll を買って"
"dota_chatwheel_message_Reuse_Courier"	"クーリエを再使用して"
"dota_chatwheel_message_Deward"	"ワードを壊してください"
"dota_chatwheel_message_Building_Pipe"	"Pipe を作っている"
"dota_chatwheel_message_Pull"	"クリープをプルしてください"
"dota_chatwheel_message_Pulling"	"クリープをプルしている"
"dota_chatwheel_message_Roshan"	"Roshan"
"dota_chatwheel_message_Affirmative"	"了解"
"dota_chatwheel_message_Wait"	"待って"
"dota_chatwheel_message_Pause"	"ポーズしてください！"
"dota_chatwheel_message_Current_Time"	"試合の経過時間"
"dota_chatwheel_message_Check_Runes"	"ルーンをチェックしてください"
"dota_chatwheel_message_Nice"	"ナイス"
"dota_chatwheel_message_Thanks"	"ありがとう！"
"dota_chatwheel_message_Sorry"	"ゴメン"
"dota_chatwheel_message_No_Give_Up"	"あきらめるな！"
"dota_chatwheel_message_My_Bad"	"悪かった"
"dota_chatwheel_message_MissingHero"	"%s1 を見失った！"
"dota_chatwheel_message_ReturnedHero"	"%s1 が戻った！"
"dota_chatwheel_message_What_To_Buy"	"何を買うべき？"
"dota_chatwheel_message_Im_Retreating"	"撤退する"
"dota_chatwheel_message_Whoops"	"おっと"
"dota_chatwheel_message_Tower_then_Back"	"タワーを破壊したら戻って"
"dota_chatwheel_message_Barracks_then_Back"	"バラックを破壊したら戻って"
"dota_settings_hotkeys"	"ホットキー"
"dota_settings_options"	"オプション"
"dota_settings_audio"	"オーディオ"
"dota_settings_voice"	"ボイス"
"dota_settings_voice_level"	"現在のレコーディングレベル"
"dota_settings_voice_steam_link"	"レコーディングデバイスは<a href=\"event:DOTAShowSteamVoiceSettings()\">Steam ボイス設定</a>を使用するよう設定されています。"
"dota_settings_volume"	"ボリューム"
"dota_settings_video"	"ビデオ"
"dota_settings_resetkeys"	"ホットキーをリセット..."
"dota_settings_legacykeys"	"レガシーキーを使用"
"dota_settings_abilities"	"アビリティ"
"dota_settings_abilities_hero"	"ヒーロー"
"dota_settings_abilities_neutrals"	"中立クリープ"
"dota_settings_abilities_courier"	"クーリエ"
"dota_settings_abilities_primary1"	"1"
"dota_settings_abilities_primary2"	"2"
"dota_settings_abilities_primary3"	"3"
"dota_settings_abilities_secondary1"	"4"
"dota_settings_abilities_secondary2"	"5"
"dota_settings_abilities_neutral1"	"1"
"dota_settings_abilities_neutral2"	"2"
"dota_settings_abilities_neutral3"	"3"
"dota_settings_abilities_neutral4"	"4"
"dota_settings_abilities_courier1"	"1"
"dota_settings_abilities_courier2"	"2"
"dota_settings_abilities_courier3"	"3"
"dota_settings_abilities_courier4"	"4"
"dota_settings_abilities_courier5"	"5"
"dota_settings_abilities_courier6"	"6"
"dota_settings_abilities_ultimate"	"U"
"dota_settings_cast"	"キャスト"
"dota_settings_autocast"	"自動キャスト"
"dota_settings_quickcast"	"クイックキャスト"
"dota_settings_upgradestats"	"ステータス向上"
"dota_settings_unitactions"	"ユニットアクション"
"dota_settings_attack"	"攻撃ムーブ / 強制攻撃"
"dota_settings_move"	"移動"
"dota_settings_holdposition"	"位置固定"
"dota_settings_selecthero"	"ヒーローを選択"
"dota_settings_selectallothers"	"他の全てのユニットを選択"
"dota_settings_selectcourier"	"クーリエを選択"
"dota_settings_courierdeliver"	"クーリエによるアイテム配達"
"dota_settings_courierhaste"	"クーリエのスピードバースト"
"dota_settings_useactionitem"	"アクションアイテム"
"dota_settings_herotaunt"	"挑発アイテム"
"dota_settings_items"	"アイテム"
"dota_settings_openshop"	"ショップを開く"
"dota_settings_purchasequickbuy"	"クイックバイの購入"
"dota_settings_purchasesticky"	"指定アイテムを購入"
"dota_settings_camera"	"カメラ"
"dota_settings_cameraactions"	"カメラアクション"
"dota_settings_cameraleft"	"カメラ左"
"dota_settings_cameraright"	"カメラ右"
"dota_settings_cameragrip"	"カメラグリップ"
"dota_settings_recentevent"	"最近のイベントを表示"
"dota_settings_inspectheroinworld"	"ショーケース表示"
"dota_settings_chat"	"チャット"
"dota_settings_phrases"	"フレーズ"
"dota_settings_chatwheel_show"	"チャットホイール"
"dota_settings_activateglyph"	"Glyph を起動"
"dota_settings_scoreboardtoggle"	"スコアボード"
"dota_settings_pause"	"一時停止"
"dota_settings_screenshot"	"スクリーンショット"
"dota_settings_console"	"コンソール"
"dota_settings_controlgroups"	"グループをコントロール"
"dota_settings_group1"	"グループ 1"
"dota_settings_group2"	"グループ 2"
"dota_settings_group3"	"グループ 3"
"dota_settings_group4"	"グループ 4"
"dota_settings_group5"	"グループ 5"
"dota_settings_group6"	"グループ 6"
"dota_settings_group7"	"グループ 7"
"dota_settings_group8"	"グループ 8"
"dota_settings_group9"	"グループ 9"
"dota_settings_group10"	"グループ 10"
"dota_settings_advancedpanel_goto"	"詳細"
"dota_settings_standardpanel_goto"	"標準"
"dota_settings_spectatorpause"	"観戦者一時停止"
"dota_settings_spectatorchat"	"観戦者チャット"
"dota_settings_spectatorstatsfantasy"	"観戦者のファンタジー統計"
"dota_settings_statsdropdown"	"データドロップダウン"
"dota_settings_spectatordropdown_sort"	"並び替え変更"
"dota_settings_spectatordropdown_close"	"カテゴリをクリア"
"dota_settings_spectatordropdown_kda"	"キル／死亡／アシスト"
"dota_settings_spectatordropdown_level"	"ヒーローレベル"
"dota_settings_spectatordropdown_xp_per_min"	"XP/分"
"dota_settings_spectatordropdown_gold"	"現在のゴールド"
"dota_settings_spectatordropdown_totalgold"	"純資産"
"dota_settings_spectatordropdown_gold_per_min"	"ゴールド/分"
"dota_settings_spectatordropdown_buyback"	"バイバックの状況"
"dota_settings_coaching"	"コーチ"
"dota_settings_keyboardtemplate"	"キーボードテンプレートを選択"
"dota_settings_or"	"あるいは"
"dota_settings_cancel"	"キャンセル"
"dota_settings_apply"	"適用"
"dota_settings_game"	"ゲーム"
"dota_settings_attackafterspell"	"スペル後の自動攻撃"
"dota_settings_autopurchase"	"自動アイテム購入"
"dota_settings_autoselect"	"召喚ユニットの自動選択"
"dota_settings_herofinder"	"ALT キーを押してヒーローをハイライト"
"dota_settings_showhitpoints"	"HP バーに数値を表示"
"dota_settings_colorblind"	"色盲モード"
"dota_settings_reducedflash"	"フラッシュ減少"
"dota_settings_minimap"	"ミニマップ"
"dota_settings_minimapsimplecolors"	"シンプルな配色のミニマップを使用"
"dota_settings_cameraspeed"	"カメラスピード"
"dota_settings_camerascreenshake"	"画面の振動を有効化"
"dota_settings_cameradeadcolorshift"	"カメラの色 - 死亡時切り替え"
"dota_settings_profile"	"プロフィール"
"dota_settings_allowtradeinvitesheader"	"トレード招待者:"
"dota_settings_trade_friends"	"フレンドのみ"
"dota_settings_trade_anyone"	"誰でも"
"dota_settings_network"	"ネットワーク"
"dota_settings_usenativeresolution"	"現在のモニターの解像度を使用"
"dota_settings_resolution"	"解像度"
"dota_settings_rendering"	"レンダリング"
"dota_settings_aspectratio"	"アスペクト比"
"dota_settings_aspectratio43"	"4:3"
"dota_settings_aspectratio169"	"16:9"
"dota_settings_aspectratio1610"	"16:10"
"dota_settings_resolution_size"	"サイズ"
"dota_settings_resolution_display_mode"	"ディスプレイモード"
"dota_settings_fullscreen"	"特製フルスクリーン"
"dota_settings_window"	"ウィンドウ"
"dota_settings_borderless"	"枠無しウィンドウ"
"dota_settings_videodefaults"	"初期設定に戻す"
"dota_settings_basicvideosettings"	"基本設定を使用"
"dota_settings_fastestvideo"	"最速"
"dota_settings_advancedvideosettings"	"詳細設定を使用"
"dota_settings_antialiasing"	"アンチエイリアス"
"dota_settings_specular"	"反射"
"dota_settings_animateportrait"	"動くポートレート"
"dota_settings_additivelight"	"光のパスを有効化"
"dota_settings_worldlight"	"ワールドのライティング"
"dota_settings_ambientcreatures"	"背景の生物"
"dota_settings_normal_maps"	"法線マップ"
"dota_settings_vsync"	"垂直同期"
"dota_settings_shadowquality"	"シャドウクオリティ"
"dota_settings_shadowquality_low"	"低"
"dota_settings_shadowquality_med"	"中"
"dota_settings_shadowquality_high"	"高"
"dota_settings_texturequality"	"テクスチャクオリティ"
"dota_settings_texturequality_low"	"低"
"dota_settings_texturequality_med"	"中"
"dota_settings_texturequality_high"	"高"
"dota_settings_mastervolume"	"マスターボリューム"
"dota_settings_gamevolume"	"ゲームサウンド"
"dota_settings_musicvolume"	"ミュージック"
"dota_settings_voicevolume"	"ボイス"
"dota_settings_gamevoicevolume"	"ユニットのセリフ"
"dota_settings_audiodefaults"	"オーディオデフォルト"
"dota_settings_defaultaudio"	"デフォルト"
"dota_settings_sounddevice"	"サウンドデバイス:"
"dota_settings_headphones"	"ヘッドホン"
"dota_settings_2speakers"	"2 スピーカー"
"dota_settings_4speakers"	"4 スピーカー"
"dota_settings_5speakers"	"5.1 スピーカー"
"dota_settings_7speakers"	"7.1 スピーカー"
"dota_settings_captions"	"字幕を使う"
"dota_settings_playsoundinbackground"	"デスクトップの音声を再生"
"dota_settings_mutecobroadcasters"	"共同放送者をミュートにする"
"dota_settings_unitspeeh"	"ユニットのセリフ"
"dota_settings_unitspeech_off"	"オフ"
"dota_settings_unitspeech_events"	"イベント"
"dota_settings_unitspeech_all"	"全て"
"OS_Default_Device"	"デフォルトのデバイス"
"DOTA_Keybind_ARROW"	"矢 (デフォルト)"
"DOTA_Keybind_WASD"	"WASD"
"DOTA_Keybind_MMO"	"MMO"
"DOTA_Keybind_LOL"	"League of Legends"
"DOTA_Keybind_HON"	"Heroes of Newerth"
"DOTA_Keybind_SMITE"	"Smite"
"DOTA_Hotkeys_Tooltip_LearnAbility"	"使用できるスキルポイントがある場合アビリティ学習モードを試そう。"
"DOTA_Hotkeys_Tooltip_HeroAttack"	"通り道にいる敵を攻撃しながら移動する/ディナイできるならば味方ユニットも攻撃する。"
"DOTA_Hotkeys_Tooltip_HeroMove"	"移動するか、攻撃せずにユニットに着いて行く。"
"DOTA_Hotkeys_Tooltip_HeroStop"	"現在のアクションを中断する。"
"DOTA_Hotkeys_Tooltip_HeroHold"	"現在のアクションを中断して静止する。"
"DOTA_Hotkeys_Tooltip_HeroSelect"	"ヒーローを選択する。"
"DOTA_Hotkeys_Tooltip_SelectAll"	"支配下にあるすべてのユニットを選択する。"
"DOTA_Hotkeys_Tooltip_SelectAllOthers"	"コントロールするそれ以外全てのユニットを選択。（あなたのヒーローは選択されません。）"
"DOTA_Hotkeys_Tooltip_CourierSelect"	"クーリエを選択。"
"DOTA_Hotkeys_Tooltip_CourierDeliver"	"クーリエに、スタッシュにあるアイテムをあなたまで届けさせる。"
"DOTA_Hotkeys_Tooltip_CourierHaste"	"使用可能な場合、自分のクーリエのスピードブーストを有効化する。"
"DOTA_Hotkeys_Tooltip_UseActionItem"	"アクションアイテムを使う。"
"DOTA_Hotkeys_Tooltip_HeroTaunt"	"ヒーローの挑発を使用する。装着アイテムとして入手できます。"
"DOTA_Hotkeys_Tooltip_ShopToggle"	"ショップパネルを開く。"
"DOTA_Hotkeys_Tooltip_PurchaseQuickbuy"	"高くて買えない場合にはクイックバイエリア内の次のアイテムを購入する。"
"DOTA_Hotkeys_Tooltip_GrabStashItems"	"スタッシュにある全てのアイテムをあなたのヒーローに移動させる。"
"DOTA_Hotkeys_Tooltip_RecentEvent"	"最も最近起きたイベントの場所にカメラを移動する。"
"DOTA_Hotkeys_Tooltip_ChatTeam"	"自チーム全員にメッセージを送信。"
"DOTA_Settings_Tooltip_Autoattack"	"自動で周辺にいる敵に近づき攻撃する。"
"DOTA_Settings_Tooltip_AutoPurchase"	"十分なゴールドを持っていれば、次のおすすめアイテムリスト内のアイテムを購入する。"
"DOTA_Settings_Tooltip_AutoSelectSummons"	"ヒーローが新ユニットを召喚すると、彼らはあなたの選択グループに追加される。"
"DOTA_Settings_Tooltip_DoubleTap"	"アイテムあるいはアビリティが使用可能なときに、ダブルクリックするかホットキーをダブルタップすると自身にキャストする。"
"DOTA_Settings_Tooltip_UnifiedOrders"	"オーダーの最中にCTRLを長押しすると、全てのコントロールユニットに送信される。"
"DOTA_Settings_Tooltip_TeleportStop"	"移動したりスペルをキャストしても、進行中のテレポートを取り消さない。適用は Teleport Scrolls あるいは Boots of Travel のみ。"
"DOTA_Settings_Tooltip_BroadcasterStats"	"ゲーム観戦時、放送者が使用している統計ドロップダウンを表示する。"
"DOTA_Settings_Tooltip_Deceleration"	"移動の後にカメラが停止する時の速度。数が大きければ大きいほど早く停まる。"
"DOTA_Settings_Tooltip_Screenshake"	"カメラを揺らすスペルとスタンがいくつかあります。"
"DOTA_Settings_Tooltip_CameraRespawn"	"復活すると同時にカメラをあなたのヒーローにフォーカスする。"
"DOTA_Settings_Tooltip_HideProfile"	"あなたの Dota 2 プロフィールには誰もアクセスできません。あなたの Steam プロフィールは Dota 2 からアクセスできません。"
"DOTA_Settings_Tooltip_ShareMatchData"	"外部組織にあなたのパブリックゲームからのマッチデータを公開します。"
"DOTA_Settings_Tooltip_NetworkQuality"	"ローエンドのネットワーク接続の場合、これを「低」に設定することでネットワークパフォーマンスが向上するかもしれません。"
"DOTA_Settings_Tooltip_MinimapSimple"	"ミニマップの色が、個人のプレイヤーではなくチームによって決定されます。"
"DOTA_Settings_Tooltip_MinimapNamesIcon"	"ミニマップ内では常にヒーロー名あるいはヒーローアイコンを表示。ALTを押しているあいだは一時的にXとOを表示。"
"DOTA_Settings_Tooltip_ShopHotkeys"	"ショップが開かれると、ショップ内のホットキーが他の機能に割り当てられたホットキーをオーバーライドする。"
"DOTA_create_bot_practice_desc"	"マッチメイキングを使ってチーム名をを探してボット相手にゲームをプレイ。"
"DOTA_Lobby_BotDifficulty"	"ボットの難易度"
"DOTA_Lobby_BotDifficulty_no_bot"	"ボットなし"
"DOTA_Lobby_BotDifficulty_passive"	"パッシブ"
"DOTA_Lobby_BotDifficulty_easy"	"イージー"
"DOTA_Lobby_BotDifficulty_medium"	"ミディアム"
"DOTA_Lobby_BotDifficulty_hard"	"ハード"
"DOTA_Lobby_BotDifficulty_unfair"	"アンフェア"
"DOTA_Lobby_BotTeam"	"チーム選択"
"DOTA_create_bot_practice_solo"	"ソロ"
"DOTA_create_bot_practice_solo_desc"	"ローカルゲームで、ボット相手に一人で練習。マッチメイキングは使わず、いつでもゲームを抜けられます。"
"DOTA_create_bot_practice_coop"	"協力"
"DOTA_create_bot_practice_coop_desc"	"マッチメイキングを使用して他のプレイヤーと一緒にボット相手にプレイ。 <font color='#dd6666'>注:</font>このボットゲームを放棄すると、ペナルティを受けます。"
"DOTA_Lobby_BotDifficulty_bot_passive"	"パッシブボット"
"DOTA_Lobby_BotDifficulty_bot_easy"	"イージーボット"
"DOTA_Lobby_BotDifficulty_bot_medium"	"ミディアムボット"
"DOTA_Lobby_BotDifficulty_bot_hard"	"ハードボット"
"DOTA_Lobby_BotDifficulty_bot_unfair"	"アンフェアボット"
"dota_lobby_title"	"{s:lobby_name}"
"dota_lobby_title_local_game"	"ローカルロビー"
"dota_lobby_title_default"	"ロビー"
"lobby_row_player_name"	"{s:player_name}"
"dota_lobby_row_game_name"	"{s:game_name}"
"dota_lobby_row_slots"	"{s:slots}"
"dota_lobby_row_game_mode"	"{s:game_mode}"
"dota_lobby_row_join"	"参加"
"dota_lobby_row_leave"	"退出"
"dota_lobby_coaches_title"	"コーチ"
"dota_lobby_browser_all_game_modes"	"全てのゲームモード"
"dota_lobby_browser_updating"	"ロビーリストを更新中..."
"dota_lobby_browser_game_mode"	"ゲームモード"
"dota_lobby_browser_refresh"	"更新"
"dota_lobby_browser_filter_title"	"ロビーを絞り込む"
"dota_lobby_submit_filter"	"送信"
"dota_popup_lobby_password_title"	"ロビーのパスワードを入力"
"DOTA_Item_OnMarket"	"マーケット"
"DOTA_Items_DefaultSet"	"デフォルト セット"
"DOTA_Items_SetEquipped_Label"	"装備中"
"DOTA_EquippedItem_Label"	"装備中"
"DOTA_EquippedItem_Rarity"	"{s:equipped_econ_set_rarity}"
"DOTA_EquippedItem_SetName"	"{s:equipped_econ_set_name}"
"DOTA_EquippedItem_DefaultSet"	"デフォルトセット"
"DOTA_EquippedItem_PartialSet"	"部分的セット"
"DOTA_EquippedItem_Style"	"{i:equipped_econ_set_style_count} スタイル"
"DOTA_EquippedItem_Button_Details"	"{s:equipped_details_button_text}"
"DOTA_EquippedItem_Customize"	"カスタマイズ"
"DOTA_EquippedItem_CustomSet"	"カスタムセット"
"DOTA_EquippedItem_Equip"	"装着"
"DOTA_EquippedItem_Unpack_And_Equip"	"開封して装着"
"DOTA_EquippedItem_Details"	"{s:equipped_econ_set_type_name} 詳細"
"DOTA_EquippedItem_Purchase_Button"	"購入"
"DOTA_EquippedItem_Marketplace_Button"	"マーケット"
"DOTA_EquippedItem_BundleName"	"バンドル内 \"{s:equipped_econ_set_bundle}\""
"DOTA_EquippedItem_FilterText"	"プレビュー中"
"DOTA_EquippedItem_SaleAmount"	"-{i:equipped_econ_set_sale_amount}%"
"DOTA_EquippedItem_RegularSetPrice"	"{s:equipped_econ_regular_set_price}"
"DOTA_EquippedItem_SetPrice"	"{s:equipped_econ_set_price}"
"DOTA_EquippedItem_TreasurePrice"	"{s:equipped_econ_treasure_price}"
"DOTA_HeroDemo_Button"	"デモ {s:econ_item_category_name}"
"DOTA_HeroDemo_Button_Tooltip"	"デモモードを起動してこのアイテムセット或いはヒーローのアビリティをチェック"
"DOTA_HeroDemo_Button_Return"	"デモに戻る"
"DOTA_HeroDemo_Button_Return_Tooltip"	"デモモードに戻り、選択したアイテムセット或いはヒーローをロード"
"DOTA_HeroDemo_Button_DBQuit"	"デモを終了する"
"DOTA_EquippedItem_Bundle"	"バンドル"
"DOTA_EquippedItem_ItemSet"	"セット"
"DOTA_EquippedItem_Item"	"アイテム"
"DOTA_EconItemSet_Name"	"{s:econ_set_name}"
"DOTA_EconItemSet_Rarity"	"{s:econ_set_rarity}"
"DOTA_EconItemSet_Status"	"{s:econ_set_status}"
"DOTA_EconItemSet_Price"	"{s:econ_set_price}"
"DOTA_EconItemSet_SaleAmount"	"-{i:econ_sale_amount}%"
"DOTA_EconItemSet_DeveloperOnly"	"非公開"
"DOTA_EconItemSet_Tooltip_InBundle"	"このセットはバンドル内に入っています"
"DOTA_HeroRole_Carry"	"キャリー"
"DOTA_HeroRole_Support"	"サポート"
"DOTA_HeroRole_Nuker"	"ヌーカー"
"DOTA_HeroRole_Disabler"	"ディスエイブラー"
"DOTA_HeroRole_Jungler"	"ジャングラー"
"DOTA_HeroRole_Durable"	"デュラブル"
"DOTA_HeroRole_Escape"	"エスケープ"
"DOTA_HeroRole_LaneSupport"	"レーンサポート"
"DOTA_HeroRole_Pusher"	"プッシャー"
"DOTA_HeroRole_Initiator"	"イニシエーター"
"DOTA_HeroGrid_OptionCategory_Role"	"役割:"
"DOTA_HeroGrid_OptionCategory_Attributes"	"属性:"
"DOTA_HeroGrid_OptionCategory_AttackType"	"攻撃タイプ:"
"DOTA_HeroLoadout_PreviousHeroName"	"{s:previous_hero_name}"
"DOTA_HeroLoadout_NextHeroName"	"{s:next_hero_name}"
"DOTA_HeroLoadout_CurrentHeroName"	"{s:hero_name}"
"DOTA_HeroLoadout_AttackType"	"{s:hero_attack_type}"
"DOTA_HeroLoadout_HeroFilterName"	"ヒーロー"
"DOTA_HeroLoadout_Search"	"{s:hero_name} 用のアイテムを検索"
"DOTA_HeroCustomize_Title"	"ヒーローをカスタマイズ"
"DOTA_HeroCustomize_OwnedItems"	"持っているアイテム"
"DOTA_HeroCustomize_Slot"	"スロット"
"DOTA_HeroCustomize_SlotName"	"{s:slot_name}"
"DOTA_HeroCustomize_SlotEquippedItemName"	"{s:equipped_item_name}"
"DOTA_HeroCustomize_DefaultItemName"	"デフォルトアイテム"
"DOTA_HeroCustomize_PreviewItemName"	"{s:preview_item_name}"
"DOTA_HeroCustomize_PreviewStyle"	"{s:preview_style_name}"
"DOTA_HeroCustomize_PreviewItemSlot"	"{s:preview_item_slot}"
"DOTA_HeroCustomize_Rarity"	"{s:preview_item_rarity}"
"DOTA_UIEconItem_StyleIndex"	"{i:style_index}"
"dota_ready_up_num_accepted"	"{i:num_accepted} / {i:total_players} 承認"
"returning_top_of_queue"	"優先的にマッチメイキングに戻ります..."
"GC_Wait_Time_Unknown"	"不明"
"dota_practice_vs_bots"	"ボットを相手にプラクティスを開始"
"dota_practice_vs_bots_difficulty"	"ボットの強さ"
"DOTA_practice_vs_bots_team_radiant"	"Radiant"
"DOTA_practice_vs_bots_team_dire"	"Dire"
"DOTA_practice_vs_bots_team_random"	"ランダム"
"DOTA_CurrentTime"	"{t:t:current_time}"
"DOTA_MonthlyPlayers"	"{s:users_last_month}"
"DOTA_CurrentPlayers"	"{s:current_users}"
"DOTA_CurrentPlayersLabel"	"現在ゲーム内のプレイヤー"
"DOTA_Search_NoResults"	"結果なし"
"DOTA_Search_ItemShortDescription"	"<span class=\"ItemRarityColor\">{s:item_rarity}</span> {s:item_slot}"
"join_error_already_in_game"	"すでにゲーム中のため、プラクティスロビーに参加できません。"
"join_error_invalid_lobby"	"指定したロビーは現在存在していません。"
"join_error_incorrect_password"	"パスワードが間違っています。"
"join_error_access_denied"	"アクセスが拒否されました。"
"join_error_generic"	""
"join_error_in_team_party"	"プラクティスロビーに参加できません。 プラクティスゲームに参加する前に、チームパーティを解散する必要があります。"
"join_error_lobby_full"	"ロビーは満員です。"
"join_error_timed_out"	"リクエストがタイムアウトしました。"
"DOTA_Friend_In_Match"	"対戦中"
"DOTA_Friend_Lobby_Mode_Small"	"{s:game_mode} ロビー"
"DOTA_Friend_Lobby_Players"	"{d:player_count} / {d:max_player_count}"
"DOTA_Friend_Lobby_Join_Button"	"{s:join_button_text}"
"DOTA_Friend_Lobby_Friend_Count"	"+{d:extra_friend_count}"
"DOTA_Friend_Invite_To_Party"	"パーティに招待"
"DOTA_Friend_SuggestInviteToParty"	"パーティに誘う"
"DOTA_Friend_PartyMergeRequestPending_Leader"	"パーティ参加リクエスト保留中<br/>クリックしてリクエストをキャンセル"
"DOTA_Friend_JoinParty"	"パーティに参加"
"DOTA_Friend_Watch"	"観戦"
"DOTA_Feed_Timestamp_Recently"	"今すぐ"
"DOTA_Feed_Timestamp_MinutesAgo"	"{i:value} 分前"
"DOTA_Feed_Timestamp_HourAgo"	"{i:value} 時間前"
"DOTA_Feed_Timestamp_HoursAgo"	"{i:value} 時間前"
"DOTA_Feed_Timestamp_Yesterday"	"昨日"
"DOTA_Feed_Timestamp_Date"	"{s:month} {s:day}"
"dota_lobby_type_practice"	"プラクティス"
"dota_lobby_type_practice_game_mode_custom"	"カスタムゲーム"
"dota_lobby_type_tournament"	"トーナメント"
"dota_lobby_type_coop_bot"	"協力ボット"
"dota_lobby_type_competitive"	"ランクマッチ"
"dota_lobby_type_casual_1v1"	"1v1 マッチ"
"dota_lobby_unknown"	"不明"
"dota_match_result_won"	"勝利"
"dota_match_result_lost"	"敗北"
"dota_match_result_none"	"???"
"dota_social_feed_loading"	"ロード中..."
"DOTA_LoadingPlayerUnknown"	"-"
"DOTA_LoadingPlayerLoading"	"ロード中..."
"DOTA_LoadingPlayerFullyConnected"	"準備完了"
"DOTA_LoadingPlayerFailed"	"失敗"
"LoadingScreenTimer"	"{t:d:countdown_timer_seconds}"
"HeroSelectionTimer"	"{i:timer_seconds}"
"LoadingScreenMapInfo"	"マップ: {s:map_name}"
"LoadingScreenPlayersInfo"	"プレイヤー: {i:players_loaded}/{i:players_total}"
"LoadingScreenSpectatorsInfo"	"観戦者: {i:spectators_loaded}/{i:spectators_total}"
"custom_end_screen_victory_message"	"{s:winning_team_name} の勝利！"
"custom_end_screen_legend_player"	"プレイヤー"
"custom_end_screen_legend_level"	"レベル"
"custom_end_screen_legend_hero"	"ヒーロー"
"custom_end_screen_legend_kills"	"K"
"custom_end_screen_legend_deaths"	"D"
"custom_end_screen_legend_assists"	"A"
"custom_end_screen_legend_items"	"アイテム"
"custom_end_screen_legend_gold"	"ゴールド"
"custom_end_screen_legend_team_score"	"スコア"
"custom_scoreboard_hero_name_and_desc"	"レベル {i:hero_level} {s:hero_name}"
"CustomEndScreenClose"	"閉じる"
"DOTA_Armory_Category_Heroes"	"ヒーロー"
"DOTA_Armory_Category_Companions"	"お供"
"DOTA_Armory_Category_Couriers"	"クーリエ"
"DOTA_Armory_Category_Pets"	"ペット"
"DOTA_Armory_Category_World"	"ワールド"
"DOTA_Armory_Category_Wards"	"ワード"
"DOTA_Armory_Category_Weather"	"天候エフェクト"
"DOTA_Armory_Category_Effigies"	"彫像"
"DOTA_Armory_Category_Interface"	"インターフェース"
"DOTA_Armory_Category_Emoticons"	"絵文字"
"DOTA_Armory_Category_LoadingScreens"	"ローディング画面"
"DOTA_Armory_Category_HUDs"	"HUD"
"DOTA_Armory_Category_CursorPacks"	"カーソルパック"
"DOTA_Armory_Category_Audio"	"オーディオ"
"DOTA_Armory_Category_VoicePacks"	"ボイスパック"
"DOTA_Armory_Category_AnnouncerPacks"	"アナウンサーパック"
"DOTA_Armory_Category_Music"	"ミュージック"
"DOTA_Armory_Category_All"	"全て"
"DOTA_Armory_Category_Other"	"その他"
"DOTA_Armory_Filter"	"フィルタを設定"
"DOTA_Armory_SortBy"	"並び替え:"
"DOTA_Armory_SortBy_Rarity"	"希少性"
"DOTA_Armory_SortBy_Quality"	"クオリティ"
"DOTA_Armory_SortBy_Name"	"名前"
"DOTA_Armory_SortBy_Recent"	"入手日"
"DOTA_Armory_SortBy_Sockets"	"ソケット数"
"DOTA_Armory_Search"	"保管庫アイテムを検索"
"DOTA_Armory_ContextMenu_Preview"	"アイテム詳細"
"DOTA_Armory_ContextMenu_PreviewSet"	"セット全体をプレビュー"
"DOTA_Armory_ContextMenu_Equip"	"アイテムを装備"
"DOTA_Armory_ContextMenu_Unequip"	"アイテムを装備"
"DOTA_Armory_ContextMenu_Socketing"	"ソケット追加"
"DOTA_Armory_ContextMenu_GiftWrap"	"アイテムをギフト包装"
"DOTA_Armory_ContextMenu_Delete"	"削除"
"dota_page_match_details_victory"	"勝者: {s:winner}"
"dota_page_match_details_legend_player"	"プレイヤー"
"dota_page_match_details_legend_level"	"レベル"
"dota_page_match_details_legend_hero"	"ヒーロー"
"dota_page_match_details_legend_kills"	"K"
"dota_page_match_details_legend_deaths"	"D"
"dota_page_match_details_legend_assists"	"A"
"dota_page_match_details_legend_items"	"アイテム"
"dota_page_match_details_legend_gold"	"ゴールド"
"dota_page_match_details_legend_last_hits"	"LH"
"dota_page_match_details_legend_denies"	"DN"
"dota_page_match_details_legend_gold_per_min"	"GPM"
"dota_page_match_details_legend_xp_per_min"	"XPM"
"dota_page_match_details_legend_winner_tooltip"	"勝利チーム"
"dota_page_match_details_legend_kills_tooltip"	"キル数"
"dota_page_match_details_legend_deaths_tooltip"	"死亡回数"
"dota_page_match_details_legend_assists_tooltip"	"アシスト数"
"dota_page_match_details_legend_last_hits_tooltip"	"クリープラストヒット数"
"dota_page_match_details_legend_denies_tooltip"	"クリープディナイ数"
"dota_page_match_details_legend_gold_per_min_tooltip"	"ゴールド／分"
"dota_page_match_details_legend_xp_per_min_tooltip"	"XP／分"
"dota_page_match_details_header_league_name"	"リーグ名"
"dota_page_match_details_header_custom_game_map_name"	"マップ名"
"dota_page_match_details_header_match_id"	"マッチ ID"
"dota_page_match_details_header_game_mode"	"ゲームモード"
"dota_page_match_details_header_duration"	"時間"
"dota_page_match_details_header_timestamp"	"マッチ日 / 時間"
"dota_page_match_details_voting_votes"	"{i:num_votes} 票"
"dota_page_match_details_replay_existence_cdn_found"	"リプレイをダウンロード"
"dota_page_match_details_replay_existence_downloading"	"ダウンロード中..."
"dota_page_match_details_replay_existence_disk_found_replay"	"リプレイを視聴"
"dota_profile_content_tab_recent_games"	"最近のゲーム"
"dota_profile_recent_game_header_timestamp"	"日付 / 時間"
"dota_profile_recent_game_header_hero_name"	"プレイしたヒーロー"
"dota_profile_recent_game_header_result"	"結果"
"dota_profile_recent_game_header_duration"	"時間"
"dota_profile_recent_game_header_type"	"タイプ"
"dota_profile_recent_game_result_win"	"勝利"
"dota_profile_recent_game_result_loss"	"敗北"
"dota_profile_recent_game_result_abandon"	"棄権"
"dota_profile_recent_game_icon_source1"	"S1"
"dota_profile_hero_with_index"	"{d:hero_index} {s:hero_name}"
"dota_profile_hero"	"{s:hero_name}"
"dota_replay_manager_error_chunk_failed"	"リプレイファイルのダウンロードに失敗しました。"
"dota_replay_manager_error_partial_compressed_open_failure"	"圧縮されたリプレイファイルを開くことができませんでした。"
"dota_replay_manager_error_partial_decompressed_open_failure"	"展開されたリプレイファイルを開くことができませんでした。"
"dota_replay_manager_error_partial_decompression_failure"	"リプレイファイルの展開に失敗しました。"
"dota_replay_manager_error_partial_decompression_write_failure"	"展開されたリプレイファイルの書き込みに失敗しました。"
"DOTA_tooltip_econ_item_name"	"{s:item_name}"
"DOTA_tooltip_econ_item_description"	"{s:item_description}"
"DOTA_tooltip_econ_item_set"	"<font color='#dddddd'>{s:item_set}</font> の一部"
"DOTA_tooltip_econ_item_rarity_label"	"希少性: "
"DOTA_tooltip_econ_item_rarity"	"{s:item_rarity}"
"DOTA_tooltip_econ_item_slot"	"Slot: {s:item_slot}"
"DOTA_tooltip_econ_item_gifter"	"{g:dota_persona:gifter_name}"
"DOTA_tooltip_econ_item_gift_received_date"	"受け取りました: {t:T:gift_received_date_time}"
"DOTA_tooltip_econ_item_trade_restriction_permanent"	"トレード不可かつ売買不可"
"DOTA_tooltip_econ_item_trade_restriction_date"	"{t:s:tradable_after_date_time} 後トレード及び売買可能"
"DOTA_tooltip_econ_item_market_restriction_permanent"	"マーケット不可"
"DOTA_tooltip_econ_item_gift_restriction_permanent"	"ギフト不可"
"DOTA_tooltip_econ_item_gift_restriction_date"	"この日までギフト不可: {t:T:giftable_after_date_time} {t:s:giftable_after_date_time}"
"DOTA_tooltip_econ_item_gem_type"	"{s:gem_type}"
"DOTA_tooltip_econ_item_gem_strange_count"	"{d:strange_count}"
"DOTA_tooltip_econ_item_gem_description"	"{s:gem_description}"
"DOTA_tooltip_econ_item_partner"	"{s:partner}"
"DOTA_econ_item_details_item_name"	"{s:item_name}"
"DOTA_econ_item_details_set_includes"	"次のアイテムが入っています:"
"DOTA_econ_item_details_item_set"	"<font color='#dddddd'>{s:item_set}</font> の一部"
"DOTA_econ_item_details_rarity_label"	"希少性: "
"DOTA_econ_item_details_item_rarity"	"{s:item_rarity}"
"DOTA_econ_item_details_item_slot"	"スロット: {s:item_slot}"
"DOTA_econ_item_details_item_description"	"{s:item_description}"
"DOTA_econ_item_details_gem_type"	"{s:gem_type}"
"DOTA_econ_item_details_gem_strange_count"	"{d:strange_count}"
"DOTA_econ_item_details_gem_description"	"{s:gem_description}"
"DOTA_Treasure_Name"	"{s:treasure_name}"
"DOTA_Treasure_Rarity"	"<span class=\"ItemRarityColor\">{s:treasure_rarity}</span> トレジャー"
"custom_game_team_select_timer"	"{i:countdown_timer_seconds}"
"custom_game_team_select_shuffle"	"シャッフル"
"custom_game_team_select_join"	"参加"
"custom_game_team_select_empty_slot"	"空のスロット"
"CompendiumPageError_ImageDL"	"Compendium イメージのダウンロード開始に失敗しました \\'%s1\\' (%s2)"
"CompendiumPageError_SelUsed"	"Compendium '{s:s2}' ページ内の '{s:s1}' '{s:s2}' にはユニークな'selection_index'がありません。"
"CompendiumPageError_SelVal"	"Compendium  '{s:s2}' ページ内の '{s:s1}'  '{s:s2}' は同じ値を含んでいます。"
"CompendiumPageError_SelValInv"	"compendium の '%s2' ページの選択肢 '%s1' に値が0以下(<=0)のものがあります。選択肢は必ず0より大きくなければいけません。"
"DOTA_GlobalItems_Couriers"	"クーリエ"
"DOTA_GlobalItems_Pets"	"ペット"
"DOTA_GlobalItems_World"	"ワールド"
"DOTA_GlobalItems_Wards"	"ワード"
"DOTA_GlobalItems_Effigies"	"彫像"
"DOTA_GlobalItems_Weather"	"天候エフェクト"
"DOTA_GlobalItems_Interface"	"インターフェース"
"DOTA_GlobalItems_Emoticons"	"絵文字"
"DOTA_GlobalItems_LoadingScreens"	"ローディング画面"
"DOTA_GlobalItems_HUDs"	"HUDs"
"DOTA_GlobalItems_Audio"	"オーディオ"
"DOTA_GlobalItems_Announcers"	"アナウンサーパック"
"DOTA_GlobalItems_Music"	"ミュージック"
"DOTA_Search"	"検索"
"DOTA_Start"	"開始"
"DOTA_PleaseWait"	"お待ちください..."
"DOTA_ChallengeGroup_2_Desc"	"AIのコントロールするヒーローを敵味方にしてストレスフリーで練習しよう。"
"dota_lobby_settings"	"ロビー設定"
"dota_lobby_settings_edit"	"編集"
"dota_lobby_leave"	"このロービーを退出"
"DOTA_Custom_Game_View_Lobby_List"	"ロビーリストを表示"
"DOTA_Custom_Game_Lobby_List_Title"	"ロビーリスト"
"DOTA_Custom_Game_Browse_All"	"すべてのゲームを表示"
"DOTA_Custom_Game_Browse_Sort"	"並び替え:"
"DOTA_Custom_Game_Sort_Popular_Today"	"好評 (今日)"
"DOTA_Custom_Game_Sort_Popular_Week"	"好評 (今週)"
"DOTA_Custom_Game_Sort_Top_Rated"	"好評 (これまで)"
"DOTA_Custom_Game_Sort_Date"	"公開日"
"DOTA_WatchLive_Steam"	"STEAM"
"dota_matchmaking_region_title_confirm"	"マッチメイキングの地域を確定"
"dota_play_lobby_games"	"ロビーを表示"
"dota_play_connecting_to_server"	"接続中..."
"dota_reconnecting"	"再接続中..."
"dota_matchmaking_regions_retry"	"再試行"
"dota_matchmaking_region_ping_calculating"	"Ping: 測定中..."
"dota_matchmaking_region_ping_failed"	"Ping: 失敗"
"dota_matchmaking_region_or"	"あるいは"
"dota_matchmaking_region_selected_offline"	"選択した地域が一時的にオフラインです。"
"dota_matchmaking_region_selected_unreachable"	"選択された地域へのネットワーク接続が確認できません。"
"dota_settings_networkhud"	"ネットワーク情報を表示"
"dota_settings_fullscreenbrightness"	"明るさ"
"dota_settings_dashboard_renderquality"	"高クオリティダッシュボード"
"dota_settings_lowlatency_audio"	"オーディオレイテンシー自動検出"
"dota_settings_quicktargetattack"	"クイック攻撃"
"dota_lobby_browser_header_name"	"ロビー名"
"dota_lobby_browser_header_slots"	"スロット"
"dota_lobby_browser_header_game_mode"	"ゲームモード"
"dota_lobby_browser_region"	"地域"
"dota_lobby_browser_lobby_name"	"ロビー名"
"DOTA_Friend_Game_Mode_1_Friend"	"{s:player_name} は {s:game_mode} をプレイ中"
"DOTA_Friend_Game_Mode_N_Friends"	"{d:num_friends} 人のフレンドが {s:game_mode} をプレイ中"
"Compendium_DefaultText_TimerTitle_Active"	"選択終了まで"
"Compendium_DefaultText_TimerTitle_Expired"	"締め切られました"
"Compendium_DefaultText_CD_Days"	"日"
"Compendium_DefaultText_CD_Hours"	"時間"
"Compendium_DefaultText_CD_Minutes"	"分"
"Compendium_DefaultText_CD_Seconds"	"秒"
"NetGraph_FPS"	"fps: {d:fps}"
"NetGraph_Ping"	"ping: {d:ping}ms"
"NetGraph_Loss"	"敗北: {d:loss}%"
"DOTA_Credits"	"謝辞"
"DOTA_ActorCredits_1_Name"	"Dee Bradley Baker"
"DOTA_ActorCredits_1_Heroes"	"techies"
"DOTA_ActorCredits_2_Name"	"Dennis Bateman"
"DOTA_ActorCredits_2_Heroes"	"invoker"
"DOTA_ActorCredits_3_Name"	"Tom Chantler"
"DOTA_ActorCredits_3_Heroes"	"centaur,lion,obsidian_destroyer,riki,slark,tusk,witch_doctor"
"DOTA_ActorCredits_4_Name"	"Merle Dandridge"
"DOTA_ActorCredits_4_Heroes"	"legion_commander,winter_wyvern"
"DOTA_ActorCredits_5_Name"	"Barry Dennen"
"DOTA_ActorCredits_5_Heroes"	"chaos_knight,phantom_lancer,rubick"
"DOTA_ActorCredits_6_Name"	"Dave Fennoy"
"DOTA_ActorCredits_6_Heroes"	"batrider,ember_spirit,faceless_void,jakiro,venomancer,skeleton_king"
"DOTA_ActorCredits_7_Name"	"Jim French"
"DOTA_ActorCredits_7_Heroes"	"elder_titan"
"DOTA_ActorCredits_8_Name"	"Michael Gregory"
"DOTA_ActorCredits_8_Heroes"	"bounty_hunter,clinkz,silencer"
"DOTA_ActorCredits_9_Name"	"Gin Hammond"
"DOTA_ActorCredits_9_Heroes"	"crystal_maiden,drow_ranger,enchantress,mirana,phantom_assassin,spectre,vengefulspirit"
"DOTA_ActorCredits_10_Name"	"John Patrick Lowrie"
"DOTA_ActorCredits_10_Heroes"	"ancient_apparition,dark_seer,doom_bringer,earthshaker,pudge,nevermore,storm_spirit"
"DOTA_ActorCredits_11_Name"	"Ellen McLain"
"DOTA_ActorCredits_11_Heroes"	"broodmother,death_prophet"
"DOTA_ActorCredits_12_Name"	"Bruce Miles"
"DOTA_ActorCredits_12_Heroes"	"alchemist,life_stealer,omniknight"
"DOTA_ActorCredits_13_Name"	"Linda K. Morris"
"DOTA_ActorCredits_13_Heroes"	"luna,naga_siren,queenofpain,templar_assassin"
"DOTA_ActorCredits_13_Extra"	"アナウンサー"
"DOTA_ActorCredits_14_Name"	"Sam A. Mowry"
"DOTA_ActorCredits_14_Heroes"	"antimage,beastmaster,rattletrap,necrolyte,slardar,warlock"
"DOTA_ActorCredits_14_Extra"	"秘密の店の店主"
"DOTA_ActorCredits_15_Name"	"Eric Newsome"
"DOTA_ActorCredits_15_Heroes"	"chen,leshrac,furion,razor,tidehunter,tiny,zuus"
"DOTA_ActorCredits_16_Name"	"Nolan North"
"DOTA_ActorCredits_16_Heroes"	"brewmaster,earth_spirit,gyrocopter,keeper_of_the_light,lone_druid,lycan,meepo,ogre_magi,shadow_demon,troll_warlord"
"DOTA_ActorCredits_17_Name"	"Dempsey Pappion"
"DOTA_ActorCredits_17_Heroes"	"magnataur,nyx_assassin,visage"
"DOTA_ActorCredits_18_Name"	"TJ Ramini"
"DOTA_ActorCredits_18_Heroes"	"abaddon,bristleback,skywrath_mage,shredder"
"DOTA_ActorCredits_19_Name"	"Harry S. Robins"
"DOTA_ActorCredits_19_Heroes"	"tinker"
"DOTA_ActorCredits_20_Name"	"Gary Schwartz"
"DOTA_ActorCredits_20_Heroes"	"lich,pugna"
"DOTA_ActorCredits_21_Name"	"David Scully"
"DOTA_ActorCredits_21_Heroes"	"bane,dazzle,juggernaut,morphling,sand_king,sven,weaver"
"DOTA_ActorCredits_22_Name"	"Mike Shapiro"
"DOTA_ActorCredits_22_Heroes"	"oracle"
"DOTA_ActorCredits_23_Name"	"David Sobolov"
"DOTA_ActorCredits_23_Heroes"	"terrorblade"
"DOTA_ActorCredits_24_Name"	"Jon St. John"
"DOTA_ActorCredits_24_Heroes"	"axe,bloodseeker,enigma,kunkka"
"DOTA_ActorCredits_25_Name"	"Fred Tatasciore"
"DOTA_ActorCredits_25_Heroes"	"disruptor,spirit_breaker,treant,undying,ursa"
"DOTA_ActorCredits_25_Extra"	"Warlock's Golem"
"DOTA_ActorCredits_26_Name"	"Jen Taylor"
"DOTA_ActorCredits_26_Heroes"	"lina,medusa,puck,windrunner"
"DOTA_ActorCredits_27_Name"	"Tony Todd"
"DOTA_ActorCredits_27_Heroes"	"dragon_knight,night_stalker,viper"
"DOTA_ActorCredits_28_Name"	""
"DOTA_ActorCredits_28_Heroes"	""
"DOTA_PlayerContextMenu_Trade"	"トレードに招待"
"DOTA_Custom_Game_Finished_Vote_Title"	"カスタムゲーム投票"
"DOTA_Custom_Game_Finished_Vote_Question"	"このカスタムゲームについてどう思いましたか？"
"DOTA_Custom_Game_Finished_Vote_Skip"	"スキップ"
"DOTA_TabName_ModsLobbyList"	"ロビーリスト"
"DOTA_WatchLive_Fullscreen"	"全画面"
"DOTA_JoinChatChannel_ChannelName"	"チャンネル名"
"DOTA_JoinChatChannel_ChannelMemberCount"	"メンバー"
"DOTA_Chat_ChannelMemberCount"	"{d:channel_member_count}"
"dota_settings_coop_fullscreen"	"デスクトップフレンドリー 全画面"
"DOTA_Trading_UI_Body_Outgoing"	"{s:player_name} があなたのリクエストに応えるのを待っています..."
"DOTA_GiftWrap_Item"	"{g:dota_item_name:gift_item_def}をギフト包装。"
"DOTA_GiftWrap_ConfirmDedication_Title"	"献呈の辞を確認"
"DOTA_GiftWrap_ConfirmDedication_Message"	"本当にこのギフトに '{s:gift_dedication}'と添えたいですか？"
"DOTA_GiftWrap_Success_Header"	"成功"
"DOTA_GiftWrap_Success"	"ギフトが送信されました。"
"DOTA_GiftWrap_Error_RateLimitedNormal"	"{d:gift_limit_hours} 時間でギフト送信出来るのは {d:gift_limit_count} 個までです。このギフトが送信できるようになるまでお待ちください。"
"DOTA_GiftWrap_Error_RateLimitedCharge"	"あなたのバトルポイントレベルでは、 {d:gift_limit_hours} 時間でギフト送信できるトレード不可アイテムの数は {d:gift_limit_count} 個です。このギフトは現在送信できません。"
"DOTA_GiftWrap_Error_RateLimitedChargeNone"	"あなたのバトルポイントレベルではトレード不可のアイテムをギフト送信できません。このギフトは現在送信できません。"
"DOTA_Custom_Game_Sort_Most_Played"	"最も人気(今週)"
"dota_settings_about"	"詳細"
"DOTA_EquippedItem_AddToShuffle"	"シャッフルに追加"
"DOTA_EquippedItem_RemoveFromShuffle"	"シャッフルから削除"
"DOTA_ClientVersion"	"バージョン: <span class=\"VersionNumber\">{d:client_version_number}</span>"
"DOTA_GameplayVersion"	"ゲームプレイバージョン: <span class=\"VersionNumber\">{s:gameplay_version_number}</span>"
"DOTA_Credits_DefaultAnnouncer_Extra"	"& ディフォルトアナウンサー"
"DOTA_Credits_SecretShopkeeper_Extra"	"& 秘密の店の店主"
"DOTA_Credits_WarlockGolem_Extra"	"& Warlock's Golem"
"DOTA_Recycling"	"リサイクル"
"DOTA_Recycling_Action"	"リサイクル"
"DOTA_Recycling_DragItems"	"不要なアイテムをここにドラック"
"DOTA_Recycling_Outputs"	"受け取る"
"DOTA_Recycling_Confirm"	"本当にこれらのアイテムをリサイクルしても良いですか？"
"DOTA_RecyclingCharm_Name"	"Charm of the Crucible Jewel II"
"DOTA_RecyclingCharm_Bonus"	"+25 Compendium コイン"
"DOTA_Previous"	"前へ"
"DOTA_PreviousShort"	"前へ"
"DOTA_Next"	"次へ"
"DOTA_Friends_Add_Friend_Tooltip"	"フレンドを追加"
"DOTA_Friends_Add_Friend_Your_ID"	"あなたのフレンド ID は:"
"DOTA_HeroLoadout_Shuffle_Count"	"シャッフル内のアイテム数 ({i:loadout_items_in_shuffle})"
"DOTA_HeroLoadout_Add_All_To_Shuffle"	"全てをシャッフルに追加"
"DOTA_HeroLoadout_Clear_Shuffle"	"シャッフルをクリア"
"DOTA_Armory_ActiveFilter"	"{s:filter_field} {s:filter_op} {s:filter_value}"
"DOTA_Treasure_Purchase"	"トレジャーを購入"
"DOTA_Treasure_CharmPurchase"	"チャームを購入"
"DOTA_Treasure_SearchPlaceholder"	"トレジャーを探す"
"DOTA_Treasure_ViewAll"	"全トレジャーを表示"
"DOTA_Treasure_QuantityOption"	"数量: {d:quantity}"
"DOTA_Treasure_Gift"	"ギフト"
"DOTA_Treasure_Open"	"開ける"
"DOTA_Treasure_OpenQuantity"	"{d:owned_quantity}"
"DOTA_Treasure_Owned"	"持っています"
"DOTA_Treasure_Received"	"受け取りました"
"DOTA_Treasure_AutographName"	"{s:treasure_autograph_name}"
"DOTA_OpenTreasureTooltip_NormalTitle"	"次のアイテムを含みます："
"DOTA_OpenTreasureTooltip_NoDupeDescription"	"アイテムをコンプリートするまでは、重複して受け取ることはありません。"
"DOTA_OpenTreasureTooltip_DupeDescription"	"全アイテムをコンプリートする前にダブりが出ることもあります。"
"DOTA_OpenTreasureTooltip_RareTitle"	"ボーナスアイテムを受け取る可能性あり"
"DOTA_OpenTreasureTooltip_UnitName"	"{g:dota_item_unit_name:item_def}"
"DOTA_OpenTreasureTooltip_ItemName"	" - {g:dota_item_name:item_def}"
"dota_profile_content_tab_official_info"	"プロ情報"
"dota_profile_oi_player_name"	"ディスプレイ名"
"dota_profile_oi_player_name_sub"	"世界中のプレイヤーが認識できる名前で、チーム或いはスポンサー等の所属情報を含むべきではありません。"
"dota_profile_oi_team"	"チーム"
"dota_profile_oi_sponsor"	"スポンサー"
"dota_profile_oi_sponsor_sub"	"スポンサー名はあなたの名前の後ろに置かれます。"
"dota_profile_oi_country"	"国"
"dota_profile_oi_role"	"役割"
"dota_profile_oi_role_sub"	"特定の役割をプレイする場合、選択してください。コアはキャリー、ミッド、オフレーンをプレイするプレイヤーを含みます。"
"dota_profile_oi_preview"	"あなたの名前はランキングとリーグゲームにおいてこのように表示されます:"
"dota_profile_oi_preview_warning"	"この情報の編集は2週間に一度しかできませんので、更新する前に正確性を確認してくださいね！"
"dota_profile_oi_submit_info"	"提出"
"dota_profile_oi_submit_pending"	"提出中..."
"dota_profile_oi_submit_success"	"成功！"
"dota_profile_oi_submit_failure"	"エラー - もう一度お試しください。"
"dota_role_core"	"コア"
"dota_role_support"	"サポート"
"Compendium_GenerateFail"	"リソースファイル '{s:s1}'の生成に失敗しました。"
"Compendium_PreparePublish"	"公開準備"
"Compendium_PublishError"	"'{s:s2}'の Compendium ディレクトリ '{s:s1}' にコピーできませんでした。"
"Compendium_PublishFinishedTitle"	"公開に成功"
"Compendium_PublishFinished"	"コンパイルされたファイルはデータファイルディレクトリにコピーされました。\n\nリーグのウェブページにあなたの Compendium を提出すると全ての .vxml_c, .vtex_c, 及び.vcss_c ファイルをアップロードします。"
"DOTA_Treasure"	"トレジャー"
"DOTA_Blog"	"Dota 2 新着情報"
"DOTA_SortBy"	"並び替え"
"DOTA_SortOption_Newest"	"新着"
"DOTA_SortOption_Owned"	"所有済み"
"DOTA_SortOption_Price"	"価格"
"DOTA_SortOption_Alphabetical"	"アルファベット"
"Action_Use"	"使用"
"DOTA_BadgeLevel"	"{d:badge_level}"
"DOTA_AHC_CurrentHero"	"現在のヒーロー"
"DOTA_AHC_CurrentHeroName"	"{s:current_hero_name}"
"DOTA_AHC_InProgress"	"進行中"
"DOTA_AHC_CurrentHeroAttempts"	"{s:current_hero_attempts} 回挑戦"
"DOTA_AHC_CurrentHeroAverage"	"世界平均"
"DOTA_AHC_CurrentHeroAverageAttempts"	"{s:current_hero_average_attempts} 回挑戦"
"DOTA_AHC_NextHero"	"次のヒーロー"
"DOTA_AHC_NextHeroName"	"{s:next_hero_name}"
"DOTA_AHC_ChallengeProgress"	"チャレンジ状況 ({d:challenge_progress_percent}%)"
"DOTA_AHC_HeroesCompleted"	"クリア済みヒーロー"
"DOTA_AHC_HeroesCompletedValue"	"{d:heroes_completed} / {d:heroes_total}"
"DOTA_AHC_TotalAttempts"	"合計挑戦回数"
"DOTA_AHC_TotalAttemptsValue"	"{d:challenge_total_attempts} ゲーム"
"DOTA_AHC_EquivalentWorldAverageValue"	"{d:challenge_average_total_attempts} ゲーム"
"DOTA_AHC_FullChallengesCompleted"	"すべてのチャレンジをクリア"
"DOTA_AHC_FullChallengesCompletedValue"	"{d:full_challenges_completed}"
"DOTA_AHC_BestFullChallengeValueNone"	"N/A"
"DOTA_AHC_BestFullChallengeValue"	"{d:best_full_challenge} ゲーム"
"DOTA_AHC_FullChallengeAverageValue"	"{s:full_challenge_average} ゲーム"
"DOTA_AHC_ChallengeReward"	"チャレンジ報酬"
"DOTA_AHC_ChallengeTrophyName"	"{s:challenge_trophy_name}"
"DOTA_AHC_ChallengeTrophyLevel"	"レベル {d:challenge_trophy_level}"
"DOTA_Party_Add_Friends"	"フレンドを追加してパーティーを作成"
"DOTA_ItemSet_Count_text"	"{d:item_current_group} / {d:item_group_count}"
"dota_settings_enable_console"	"コンソール有効"
"dota_settings_binding_options"	"バインドオプション"
"dota_settings_allow_gui_key_to_bind"	"ウィンドウ / コマンドキーのバインドを許可"
"DOTA_HeroLoadout_Loadout"	"装備"
"DOTA_HeroLoadout_About"	"詳細"
"DOTA_HeroLoadout_Guides"	"ガイド"
"DOTA_HeroLoadout_Roles"	"役割"
"DOTA_HeroLoadout_Biography"	"伝記"
"DOTA_Armory_ClearFilter"	"フィルタをクリア"
"DOTA_Armory_ContextMenu_Tags"	"タグ..."
"DOTA_Armory_ContextMenu_EffigyPose"	"ポーズ..."
"DOTA_Armory_ContextMenu_EffigyReforge"	"再鍛..."
"DOTA_EffigyEditor_ReforgeEffigy"	"彫像再鍛"
"DOTA_EffigyEditor_Model"	"ヒーロー"
"DOTA_EffigyEditor_Animation"	"アニメーション："
"dota_profile_content_tab_all_hero_challenge"	"全-ヒーローチャレンジ"
"DOTA_tooltip_econ_item_delete_restriction"	"削除できません"
"DOTA_tooltip_econ_item_modifier_animation"	"アニメーション"
"DOTA_tooltip_econ_item_modifier_announcer"	"アナウンサー"
"DOTA_tooltip_econ_item_modifier_HUD"	"HUD"
"DOTA_tooltip_econ_item_modifier_ability_name"	"アビリティ名"
"DOTA_tooltip_econ_item_modifier_loading_screen"	"ローディング画面"
"DOTA_tooltip_econ_item_modifier_cursor_pack"	"カーソルパック"
"DOTA_tooltip_econ_item_modifier_portrait"	"ポートレート"
"DOTA_tooltip_econ_item_modifier_courier"	"クーリエ"
"DOTA_tooltip_econ_item_modifier_pet"	"ペット"
"DOTA_tooltip_econ_item_modifier_voice"	"ボイス"
"DOTA_tooltip_econ_item_modifier_icon"	"アイコン"
"Compendium_Downloading"	"Compendium をダウンロードしています..."
"Compendium_DLFailed"	"ダウンロード失敗"
"Compendium_Error"	"Compendium エラー"
"Compendium_Retry"	"再試行"
"Compendium_preview_mode"	"プレビューモードのみ"
"Compendium_preview_click"	"詳細はここをクリック"
"Compendium_level"	"レベル"
"Compendium_to_next_level"	"次のレベルまで"
"Compendium_LevelupPts_Singular"	"1 ポイント"
"Compendium_LevelupPts_Plural"	"{d:next_comp_level} ポイント"
"DOTA_GlobalItems_MegaKill"	"メガキルパック"
"DOTA_Treasure_BonusReward"	"ボーナスリワード"
"DOTA_AntiAddiction_CompleteInfoNow"	"情報を入力"
"DOTA_AntiAddiction_Initial_DateFormat"	"%s1Y%s2M%s3D %s4:%s5:%s6"
"DOTA_AntiAddiction_Label_Yellow"	"ゲーム時間: {s:playtime} ( 不健康 )"
"DOTA_Workshop_TextureName_color"	"色"
"DOTA_Workshop_Animations"	"アニメーション"
"DOTA_Workshop_SubmissionType_Ward"	"ワード"
"DOTA_Workshop_ImportP4"	"インポート (P4)"
"DOTA_Workshop_NotRequired_Texture"	"(テクスチャは %s1 にリサイズされます)"
"DOTA_Workshop_ItemName"	"アイテム名"
"DOTA_Workshop_LOD0Title"	"ポートレートジオメトリ"
"DOTA_Workshop_Animation"	"アニメーション ヘルプ"
"DOTA_Workshop_Reimport"	"更新"
"DOTA_Workshop_AbilityIcons_Title"	"アビリティアイコン"
"DOTA_Workshop_CursorPack_Intro"	"カーソルパックは、ゲーム内で使用できる代替カーソルをまとめたイメージのセットです。"
"DOTA_Workshop_CursorPack_Help"	"カーソルパック ヘルプ"
"DOTA_Workshop_ImportLoadingScreen"	"ローディング画面をインポート"
"DOTA_Workshop_LoadingScreen_Intro"	"デフォルトの Dota 2 ローディング画面を置き換える画像"
"DOTA_UI_LoadScreen_16_9"	"アスペクト比 16:9"
"DOTA_UI_LoadScreen_16_10"	"アスペクト比 16:10"
"DOTA_UI_LoadScreen_4_3"	"アスペクト比 4:3"
"DOTA_Workshop_ChatEmoticon_Intro"	"動く絵文字"
"DOTA_Workshop_ChatEmoticon_Help"	"チャット絵文字ヘルプ"
"DOTA_Workshop_ChatEmoticon_AnimationSpeed"	"フレーム時間"
"DOTA_Workshop_ChatEmoticon_DefaultFrame"	"デフォルトフレーム"
"DOTA_Workshop_ImportChatEmoticon_Preview"	"プレビュー"
"DOTA_Workshop_File_ChatEmoticon"	"ソース画像 (.png ファイル)"
"DOTA_Workshop_Animation_Title"	"アニメーション"
"DOTA_Workshop_Animation_UIBlock"	"アニメーション %s1"
"DOTA_Workshop_Preview_Anim"	"アニメーション："
"DOTA_Workshop_Preview_Skin"	"テクスチャ:"
"DOTA_Workshop_Error_TextureNameB"	"次の接尾語と一致する .TGA ファイルが見つかりませんでした:\n %s1"
"DOTA_Workshop_RequiredFileError"	"必要なファイルが見つかりません！"
"DOTA_Workshop_Import"	"インポート"
"DOTA_Workshop_Import_Success"	"インポート成功"
"DOTA_Workshop_LOD0Title_Ward"	"ポートレートジオメトリ"
"DOTA_Workshop_Animation_Spawn"	"復活"
"DOTA_Workshop_Animation_Idle"	"待機"
"DOTA_Workshop_Animation_IdleAlt"	"待機（代替）"
"DOTA_Workshop_Animation_IdleRare"	"待機（レア）"
"DOTA_Workshop_Animation_Run"	"走る"
"DOTA_Workshop_Animation_RunAlt"	"走る（代替）"
"DOTA_Workshop_Animation_RunRare"	"走る（レア）"
"DOTA_Workshop_Animation_RunHaste"	"走る（ヘイスト）"
"DOTA_Workshop_Animation_RunInjured"	"走る（負傷）"
"DOTA_Workshop_Animation_Die"	"死亡"
"DOTA_Workshop_Animation_Die2"	"死亡（代替）"
"DOTA_Workshop_Animation_Attack"	"攻撃"
"DOTA_Workshop_Animation_AttackB"	"攻撃（代替）"
"DOTA_Workshop_Animation_Attack2"	"攻撃（逆腕）"
"DOTA_Workshop_Animation_Attack2B"	"逆腕攻撃（代替）"
"DOTA_Workshop_Animation_Disabled"	"無効化/スタンを受けた"
"DOTA_Workshop_Animation_Defeat"	"敗北"
"DOTA_Workshop_Animation_IdleOutOfRange"	"待機（範囲外）"
"DOTA_Workshop_Camera"	"カメラ"
"DOTA_Workshop_GameDay"	"日"
"DOTA_Workshop_GameNight"	"夜"
"DOTA_Workshop_Next"	"次へ"
"DOTA_Workshop_Portrait"	"ポートレート"
"DOTA_Workshop_Prev"	"前へ"
"DOTA_Workshop_Preview"	"プレビュー"
"DOTA_Workshop_PreviewInGame"	"ゲーム内プレビュー"
"DOTA_Workshop_Submit"	"送信"
"DOTA_Workshop_Texture"	"テクスチャ"
"DOTA_Workshop_BrowseForZipCaption"	"Zip を選択"
"DOTA_Workshop_LoadSession"	"セッションをロード"
"DOTA_Workshop_SaveSession"	"セッションをセーブ"
"DOTA_Filter_Field_Category"	"タグ"
"DOTA_Armory_Tags_Popup_Title"	"タグを設定"
"DOTA_Armory_Attributes"	"属性"
"DOTA_Event_Level"	"レベル"
"DOTA_Skip"	"スキップ"
"DOTA_Done"	"完了"
"DOTA_Treasure_OpenAnother"	"もう一つ開ける"
"DOTA_Treasure_OpenTreasure"	"トレジャーを開ける"
"DOTA_Treasure_OpenNoDupe"	"トレジャーを開ける毎に {d:items_per_treasure} 個のノーマルアイテムが見つかります。重複して受け取ることはありません。 運がよければ、レアなアイテムがもらえるかもしれません。"
"DOTA_Treasure_OpenDupe"	"トレジャーを開ける毎に {d:items_per_treasure} 個のノーマルアイテムが見つかります。重複して受け取ることはありません。 運がよければ、レアなアイテムがもらえるかもしれません。"
"DOTA_Treasure_OpenFailed_NoItem"	"インベントリ内に開けるトレジャーがありません。"
"DOTA_Treasure_OpenFailed_NoItemsReceived"	"トレジャーから受け取ったアイテムのリストを入手できません。"
"DOTA_Treasure_OpenSuccess"	"おめでとう！アイテムを受け取りました："
"DOTA_Custom_Game_Created_By"	"製作者： <b>{g:dota_persona:author}</b>"
"DOTA_Custom_Game_Dedicated_Servers_I"	"このカスタムゲームには専用サーバーサポートがあります。ゲームはValve が専用サーバー上でホストします。"
"DOTA_View_Details"	"詳細を表示"
"DOTA_TabName_Featured"	"一押し"
"DOTA_TabName_Heroes"	"ヒーロー"
"DOTA_Profile_Edit"	"プロフィールを編集"
"DOTA_TrophyXPProgress"	"{d:trophy_xp} / {d:total_trophy_xp}<span class=\"TrophyPointTextSmall\">TP</span>"
"DOTA_TrophyDetails_PointsPerLevel"	"レベルアップする度{d:trophy_points_per_level} トロフィーポイントを獲得。"
"DOTA_Trophy_Upgraded"	"トロフィーアップグレード"
"DOTA_TrophyPlusProfileXP"	"+{d:trophy_xp} トロフィーポイント"
"DOTA_Lobby_Settings_Tournament_None"	"なし"
"DOTA_Lobby_Settings_Tournament"	"リーグ"
"DOTA_WatchReplaysConextMenu_Watch"	"視聴"
"DOTA_WatchReplaysConextMenu_DownloadWatch"	"ダウンロードして今すぐ観戦しよう"
"DOTA_WatchReplaysConextMenu_DownloadWatchLater"	"ダウンロードして後で視聴"
"DOTA_WatchReplaysConextMenu_WatchLater"	"後で観戦"
"DOTA_WatchReplays_Game1"	"ゲーム 1"
"DOTA_WatchReplays_Game2"	"ゲーム 2"
"DOTA_WatchReplays_Game3"	"ゲーム 3"
"DOTA_WatchReplays_Game4"	"ゲーム 4"
"DOTA_WatchReplays_Game5"	"ゲーム 5"
"DOTA_WatchTournaments_PrizePoolLabel"	"賞金総額"
"DOTA_WatchTournaments_LiveGames"	"- 進行中のライブゲーム"
"DOTA_WatchTournaments_Region_NA"	"北アメリカ"
"DOTA_WatchTournaments_Region_SA"	"南アメリカ"
"DOTA_WatchTournaments_Region_EU"	"ヨーロッパ"
"DOTA_WatchTournaments_Region_RU"	"ロシア"
"DOTA_WatchTournaments_Region_CN"	"中国"
"DOTA_WatchTournaments_Region_SEA"	"東南アジア"
"DOTA_WatchTournament_BestOf3"	"3番勝負"
"DOTA_WatchTournament_BestOf5"	"5番勝負"
"DOTA_WatchTournament_Website"	"トーナメントのウェブサイトを表示"
"DOTA_WatchTournament_Page"	"ページ {i:page_cur} / {i:page_max}"
"DOTA_ShuffledItem_Label"	"シャッフル内"
"DOTA_EquippedItem_Button_SingleItemShuffle"	"装着"
"DOTA_Armory_Category_EffigyBlocks"	"彫像ブロック"
"DOTA_Armory_Category_EffigyReforgers"	"彫像たがね"
"DOTA_Armory_Category_Leagues"	"リーグアイテム"
"DOTA_Armory_Category_Charms"	"チャーム"
"DOTA_Armory_Category_CharmFragments"	"チャームの破片"
"DOTA_Armory_Category_MegaKills"	"メガキル"
"DOTA_Armory_Category_Treasures"	"トレジャー"
"DOTA_Armory_Category_Gifts"	"ギフト"
"DOTA_Armory_Category_Bundles"	"バンドル"
"DOTA_Armory_Category_Tools"	"ツール"
"DOTA_Armory_ActiveFilterLabel"	"フィルター:"
"DOTA_Armory_EditFilter"	"フィルタを編集"
"DOTA_Armory_ContextMenu_AddShuffle"	"シャッフルに追加"
"DOTA_Armory_ContextMenu_RemoveShuffle"	"シャッフルから除く"
"DOTA_Armory_Filter_Tradeable"	"トレード可能"
"DOTA_Armory_Filter_Equipped"	"装備中"
"DOTA_Armory_Filter_Duplicate"	"重複"
"DOTA_Armory_Filter_HasSockets"	"ソケットあり"
"DOTA_Armory_Filter_IsJunk"	"ジャンクとしてマーク"
"DOTA_Armory_Filter_WillExpire"	"期限間近"
"DOTA_Armory_Filter_IsBundle"	"バンドル"
"DOTA_Armory_Filter_IsGift"	"ギフトされた"
"DOTA_Armory_Filter_Rarity"	"希少性"
"DOTA_Armory_Filter_Quality"	"クオリティ"
"DOTA_Armory_Filter_Tags"	"タグ"
"DOTA_Armory_Filter_Delete"	"フィルタを削除"
"DOTA_Armory_Filter_CreateNew"	"新規フィルター..."
"DOTA_Armory_Filter_FilterName"	"名前でフィルタ"
"DOTA_Armory_Filter_Required"	"必須"
"DOTA_tooltip_econ_item_tags"	"タグ"
"Compendium_LeagueID"	"リーグ ID"
"Compendium_Unsupported"	"Compendium 未対応"
"DOTA_GlobalItems_CursorPacks"	"カーソルパック"
"DOTA_Popup_Item_Received_Header_Unknown"	"アイテムを一つ獲得しました！"
"DOTA_Popup_Item_Received_Header_Dropped"	"アイテムを一つ獲得しました！"
"DOTA_Popup_Item_Received_Header_Crafted"	"アイテムを一つクラフトしました！"
"DOTA_Popup_Item_Received_Header_Traded"	"アイテム一つと交換しました！"
"DOTA_Popup_Item_Received_Header_Purchased"	"アイテムを一つ購入しました！"
"DOTA_Popup_Item_Received_Header_FoundInCrate"	"アイテムを一つ獲得しました！"
"DOTA_Popup_Item_Received_Header_Gifted"	"ギフトを一つ受け取りました！"
"DOTA_Popup_Item_Received_Header_Support"	"カスタマーサポートからアイテムを一つ受け取りました！"
"DOTA_Popup_Item_Received_Header_Promotion"	"ストアプロモーションアイテムを一つ受け取りました！"
"DOTA_Popup_Item_Received_Header_Earned"	"アイテムを一つ獲得しました！"
"DOTA_Popup_Item_Received_Header_Refunded"	"アイテムが一つ返品されました！"
"DOTA_Popup_Item_Received_Header_GiftWrapped"	"アイテムを一つギフト包装しました！"
"DOTA_Popup_Item_Received_Header_Foreign"	"別のゲーム内でアイテムを一つ発見しました！"
"DOTA_Popup_Item_Received_Header_CollectionReward"	"コレクションリワードを有効化しました！"
"DOTA_Popup_Item_Received_Header_PreviewItem"	"新アイテムをテスト中です!"
"DOTA_Popup_Item_Received_Header_PreviewItemPurchased"	"アイテムを一つ購入しました！"
"DOTA_Popup_Item_Received_Header_PeriodicScoreReward"	"アイテムを一つ獲得しました！"
"DOTA_Popup_Item_Received_Header_Recycling"	"アイテムを一つクラフトしました！"
"DOTA_Popup_Item_Received_Header_TournamentDrop"	"トーナメントドロップを受け取りました！"
"DOTA_Popup_Item_Received_Header_RecipeOutput"	"アイテムを一つクラフトしました！"
"DOTA_Popup_Item_Received_Header_CommunityMarketPurchase"	"アイテムを一つ購入しました！"
"DOTA_Popup_Item_Received_Header_GemExtract"	"アイテムを一つ取り出しました！"
"DOTA_Popup_Item_Received_Label_IOfN"	"{d:item_i} / {d:item_n}"
"DOTA_Popup_Item_Received_Button_Accept"	"受け取る"
"DOTA_Popup_Item_Received_Button_AcceptAll"	"全て受け取る ({d:item_n})"
"DOTA_TrophyDetails_PointsPerInterval"	"{d:trophy_points_interval_size} レベル毎に {d:trophy_points_per_level} トロフィーポイントを獲得。"
"LobbySetting_League"	"リーグ"
"LoadingScreenCastersInfo"	"放送者: {i:casters_loaded}/{i:casters_total}"
"DOTA_Armory_ContextMenu_EquipSet"	"装備セット"
"DOTA_Armory_Tag1_Default"	"タグ 1"
"DOTA_Armory_Tag2_Default"	"タグ 2"
"DOTA_Armory_Tag3_Default"	"タグ 3"
"DOTA_Armory_Tag4_Default"	"タグ 4"
"DOTA_Armory_Tag5_Default"	"タグ 5"
"DOTA_Armory_Tag6_Default"	"タグ 6"
"DOTA_Armory_Tag7_Default"	"タグ 7"
"DOTA_Armory_Tag8_Default"	"タグ 8"
"DOTA_Workshop_TextureName_normal"	"ノーマル"
"DOTA_Tournament_Premium"	"プレミアム"
"DOTA_Tournament_Professional"	"プロフェッショナル"
"DOTA_Tournament_Amateur"	"アマチュア"
"DOTA_Treasure_MarketPurchase"	"マーケット内"
"DOTA_Treasure_HelpHeader"	"トレジャーを開ける毎に {d:items_per_treasure} 個のアイテムが見つかります。"
"DOTA_Treausre_HelpNoDupe"	"購入して開けるまで、受け取るアイテムはわかりません。一つ以上購入しても、全ての非レアアイテムを所有するまでは重複してアイテムを受け取ることはありません。"
"DOTA_Treasure_HelpDupe"	"購入して開けるまで、受け取るアイテムはわかりません。一つ以上購入すると重複するかもしれません。"
"DOTA_Treasure_HelpRares"	"運がよければ、通常受け取るアイテムに加えて、レアなボーナスアイテムを受け取るかもしれません。"
"DOTA_Treasure_FilterAvailable"	"入手可能"
"DOTA_Treasure_FilterOwned"	"未開封 ({d:treasures_owned_count})"
"DOTA_Treasure_FilterAll"	"すべて"
"DOTA_Workshop_ExtraMiscTags"	"その他のタグ"
"DOTA_Workshop_ExtraBrandingTags"	"ブランドタグ"
"DOTA_Workshop_Tags_SingleItem"	"1つのアイテム"
"DOTA_Trophies_Info"	"トロフィーポイントを獲得して Dota レベルを上げよう。<br><br>各トロフィーにはそれぞれトロフィーポイントがあり、Dota レベルを上げることができます。トロフィーポイントはトロフィー獲得時あるいは新しいティアーにアップグレードされる度に手に入れることが出来ます。 <br><br>100 トロフィーポイント = 1 Dota レベル"
"DOTA_Custom_Game_About"	"詳細"
"DOTA_Custom_Game_Updates"	"アップデート"
"DOTA_Workshop_Reset_To_Default"	"初期設定に戻す"
"DOTA_EventName_International2014"	"The International 2014"
"DOTA_EventName_International2015"	"The International 2015"
"DOTA_EventName_FallMajor2015"	"Fall 2015"
"dota_settings_shadowquality_off"	"オフ"
"dota_lobby_row_region"	"{s:region}"
"dota_lobby_browser_header_region"	"地域"
"dota_lobby_browser_all_regions"	"全地域"
"DOTA_Armory_Category_CompendiumLevels"	"レベル"
"DOTA_Armory_Category_CompendiumCoins"	"コイン"
"dota_profile_recent_games_option_show_custom_games"	"カスタムゲームを表示"
"dota_profile_recent_games_option_show_ranked_mmr_change"	"ランキング MMR 変化を表示"
"dota_profile_recent_game_result_uncalibrated_ranked"	"キャリブレーション中"
"dota_profile_recent_game_result_win_ranked"	"{i:ranked_mmr} (+{i:ranked_mmr_delta})"
"dota_profile_recent_game_result_loss_ranked"	"{i:ranked_mmr} ({i:ranked_mmr_delta})"
"DOTA_tooltip_econ_item_gift_dedication"	"{s:gift_dedication}"
"DOTA_econ_item_details_original_name_label"	"元々の名前:"
"DOTA_econ_item_details_add_socket"	"ソケットを追加"
"DOTA_econ_item_details_add_gem"	"ジェムを追加"
"DOTA_econ_item_details_extract_gem"	"ジェムを取り出す"
"DOTA_econ_item_details_extract_gem_short"	"取り出す"
"DOTA_econ_item_details_reset_gem"	"リセット"
"DOTA_econ_item_details_gift_header"	"ギフト"
"DOTA_econ_item_details_gift_clear_gifter"	"ギフト送信者の名前をクリア"
"DOTA_econ_item_details_sockets_header"	"コモンソケット"
"DOTA_econ_item_details_style_name"	"{s:style_name}"
"DOTA_econ_item_details_style_available"	"選択"
"DOTA_econ_item_details_tooltip_lock_reason"	"{s:style_lock_reason}"
"DOTA_econ_item_details_description_header"	"説明"
"DOTA_econ_item_details_description_reset"	"リセット"
"DOTA_econ_item_details_description_edit"	"編集"
"DOTA_Crafting"	"クラフト"
"DOTA_Crafting_Confirm"	"これらのアイテムを新アイテムにクラフトしてよろしいですか？"
"DOTA_CraftingResult_Success"	"成功！新アイテムをお楽しみください！"
"DOTA_CraftingResult_OfferingDisabled"	"このクラフトレシピは現在使用できません。後ほどお試しください。"
"DOTA_CraftingResult_InvalidItems"	"失敗：無効なアイテム。"
"DOTA_CraftingResult_InternalError"	"失敗：内部エラー。"
"DOTA_CraftingResult_MissingLeague"	"失敗：このレシピを使うには Compendium ガ必要です。"
"DOTA_Workshop_Animation_Spawn_Desc"	"ユニットの顔を少し上向きにすると、ゲームでの見下ろす視界における認識を高めます。"
"DOTA_Workshop_Animation_Run_Desc"	"ユニットの顔を少し上向きにすると、ゲームでの見下ろす視界における認識を高めます。"
"DOTA_Workshop_Animation_RunAlt_Desc"	"ユニットの顔を少し上向きにすると、ゲームでの見下ろす視界における認識を高めます。"
"DOTA_Workshop_Animation_RunRare_Desc"	"ユニットの顔を少し上向きにすると、ゲームでの見下ろす視界における認識を高めます。"
"DOTA_Workshop_Animation_RunInjured_Desc"	"ユニットの顔を少し上向きにすると、ゲームでの見下ろす視界における認識を高めます。"
"DOTA_Workshop_SelectHero"	"ヒーロー選択"
"DOTA_Workshop_SelectSlot"	"スロット選択"
"DOTA_Workshop_NoSlots"	"使用可能なスロット無し"
"DOTA_Workshop_SelectHeroWearable"	"装着可能なアイテム"
"DOTA_Workshop_SelectAbility"	"アビリティを選択"
"DOTA_Workshop_SubmissionTypeImagesTitle"	"どんな種類の画像を公開しようとしていますか？"
"DOTA_Workshop_SubmissionType_Wearable_Desc"	"特定のヒーローのベースモデルに接続するモデルジオメトリ。"
"DOTA_Workshop_SubmissionType_Courier"	"クーリエ"
"DOTA_Workshop_SubmissionType_Ward_Desc"	"ゲーム内で Observer 及び Sentry Ward として動作するにはアニメーションつきの１つのモデルが必要です。"
"DOTA_Workshop_SubmissionType_HudSkin"	"HUD スキン"
"DOTA_Workshop_SubmissionType_LoadingScreen"	"ローディング画面"
"DOTA_Workshop_SubmissionType_LoadingScreen_Desc"	"ローディング画面の代わりとなる画像。"
"DOTA_Workshop_SubmissionType_Animation"	"アニメーション"
"DOTA_Workshop_SubmissionType_Animation_Desc"	"一つ以上の既存のヒーローアニメーションを差し替えるアニメーション。"
"DOTA_Workshop_SubmissionType_Images"	"画像..."
"DOTA_Workshop_SubmissionType_AbilityIcons_Desc"	"ヒーローのアビリティアイコンに取って代わる画像のセット。"
"DOTA_Workshop_SubmissionType_ChatEmoticon"	"チャット絵文字"
"DOTA_Workshop_SubmissionType_ChatEmoticon_Desc"	"動く絵文字。"
"DOTA_Workshop_SubmissionType_CursorPack"	"カーソルパック"
"DOTA_Workshop_BrowseForImageFilter"	"画像"
"DOTA_Workshop_BrowseForPsdFilter"	"PSD"
"DOTA_Sale_24"	"24 時間セール"
"DOTA_Teams_WindowTitle"	"チーム"
"DOTA_TeamManagement_TeamTag"	"チームタグ"
"DOTA_TeamManagement_Country"	"国"
"DOTA_TeamManagement_URL"	"チーム URL"
"DOTA_TeamKickLabel"	"キック"
"DOTA_TeamsMyTeams"	"自分のチーム"
"DOTA_TeamsManageTeams"	"チームを管理"
"DOTA_TeamSponsorLogo"	"チームスポンサーロゴ"
"DOTA_TeamTeamID"	"チーム ID:"
"DOTA_TeamTeamAdmin"	"チーム管理者:"
"DOTA_TeamBasicInfo"	"基本情報"
"DOTA_TeamImages"	"画像"
"DOTA_TeamJoinTeam"	"チームに参加"
"DOTA_GameMode_1"	"オールピック"
"DOTA_GameMode_2"	"キャプテンズモード"
"DOTA_GameMode_3"	"ランダムドラフト"
"DOTA_GameMode_4"	"シングルドラフト"
"DOTA_GameMode_5"	"オールランダム"
"DOTA_GameMode_12"	"低使用度プレイ"
"DOTA_GameMode_13"	"限定ヒーロー"
"DOTA_GameMode_16"	"キャプテンズドラフト"
"DOTA_GameMode_18"	"アビリティドラフト"
"DOTA_GameMode_20"	"オールランダムデスマッチ"
"DOTA_JoinChatChannel_ChannelDistance"	"距離"
"DOTA_JoinChatChannel_Regional"	"地域"
"DOTA_JoinChatChannel_Custom"	"ユーザー"
"DOTA_JoinChatChannel_CustomGame"	"カスタムゲーム"
"DOTA_Chat_ChannelDistance"	"{s:channel_distance}km"
"DOTA_Chat_CustomGameChannelName"	"{g:dota_custom_game_name:channel_name}"
"DOTA_ChatTarget_Format_CustomGame"	"{g:dota_custom_game_name:custom_game_id}"
"DOTA_ChatCommand_FlipCoin"	"フリップ"
"DOTA_Frontpage_LastMatch_Mode"	"モード"
"DOTA_Frontpage_LastMatch_KDA"	"K / D / A"
"DOTA_Frontpage_LastMatch_Duration"	"試合時間"
"DOTA_Frontpage_LastMatch_Items"	"アイテム"
"DOTA_Frontpage_WatchLive_Title"	"注目の試合"
"DOTA_Frontpage_FriendCustom_Title"	"カスタムゲーム"
"dota_settings_chat_join_regional"	"起動時に地域チャットへ参加"
"DOTA_Teams_NoInfo"	"情報が入力されていません"
"DOTA_Armory_Category_ScratchPad"	"コレクション"
"DOTA_tooltip_econ_item_leaguename"	"{s:league_name}"
"DOTA_tooltip_econ_item_matchevent"	"{s:tournament_event}"
"DOTA_tooltip_econ_item_team1_name"	"{s:team1_name}"
"DOTA_tooltip_econ_item_team2_name"	"{s:team2_name}"
"DOTA_tooltip_econ_item_VS"	"対"
"DOTA_tooltip_econ_item_event_description"	"{s:event_description}"
"DOTA_Compendium_Coins_Increased"	"Compendium コインが増えました"
"DOTA_Compendium_Coin_Bank"	"{d:coin_bank}"
"DOTA_Compendium_Coin_Plus"	"+"
"DOTA_Compendium_Coins_Gained"	"{d:coins_gained}"
"DOTA_Workshop_Imported_S1NormalOverwrite_Title"	"ファイルを上書きしますか？"
"DOTA_Workshop_ItemImport_HeroName_Label"	"ヒーロー:"
"DOTA_Workshop_ItemImport_CreateItem_Name"	"アイテム名："
"DOTA_Workshop_ItemImport_CreateItem_Description"	"説明:"
"DOTA_Workshop_ItemSubmit_Update_UICheckBox_Portrait"	"ポートレート"
"DOTA_ItemPicker_Action"	"選択"
"DOTA_ItemRedemption_Action"	"交換する"
"DOTA_StyleUnlock_Title"	"{g:dota_item_name:header_item_def} スタイルアンロック"
"DOTA_StyleUnlock_Action"	"アンロック"
"DOTA_StyleUnlock_ConfirmTitle"	"スタイルアンロック"
"DOTA_StyleUnlock_ConfirmMessage"	"{g:dota_item_name:redeem_item_def} を消費して {g:dota_item_name:selected_item_def} のスタイルをアンロックしますか？"
"DOTA_StyleUnlock_Error"	"このアイテムでのスタイルアンロックに失敗しました。"
"DOTA_StyleUnlock_Text"	"このスタイルを適用するアイテムを選択してください："
"DOTA_StyleUnlock_NoValidItems"	"武器庫内にこのスタイルアンロックを使用できるアイテムがありません。"
"DOTA_Workshop_SubmissionType_League_Ticket"	"リーグチケット"
"DOTA_GameMode_AllDraft"	"オールピック"
"DOTA_GameMode_22"	"オールピック"
"DOTA_ProfileCard_Event_BuyCompendium"	"Fall シーズン 2015 Compendium を購入する"
"DOTA_ProfileCard_Event_Activate"	"Compendium を有効化"
"DOTA_ProfileCard_Event_BuyLevels"	"レベルを購入"
"DOTA_ProfileCard_Event_SpendCoins"	"コイン消費"
"DOTA_ProfileCard_CompendiumLevel"	"Compendium レベル"
"DOTA_About_Badges"	"トロフィーについて"
"LoadingScreenGameMode"	"{s:game_mode}"
"Compendium_TOC"	"目次"
"DOTA_Crafting_Fall_2015"	"Fall 2015"
"DOTA_Crafting_Compendium"	"Compendium"
"DOTA_Crafting_Title"	"Fall 2015 Compendium クラフト"
"DOTA_Crafting_Description"	"コインとレジャーを開くと、ブロンズ、シルバー、あるいはゴールドアイテムが一つもらえます。1つ下のティアーのアイテムを三つ使って、1つ上のティアーのアイテムに交換することが出来ます。ゴールドアイテムなら2つで別のアイテムに交換できます。"
"DOTA_Crafting_Chart_Link"	"Fall 2015 Compendiumの<br>ティアーチャートを表示"
"DOTA_Crafting_Treasure_Link"	"コイントレジャーを表示"
"DOTA_Compendium_Level_Number"	"{d:compendium_level}"
"DOTA_Compendium_Level_Points"	"{d:compendium_points}"
"DOTA_Workshop_Attachment_Reset"	"リセット"
"DOTA_Workshop_PreviewAspectRatio"	"アスペクト比"
"DOTA_StyleUnlock_Timeout"	"GCとの接続に失敗しました。後でもう一度お試しください。"
"UnlockStyle_Succeeded"	"スタイルはアンロックされ、アイテムへの適用が可能となりました。"
"DOTA_ReforgeItem_Title"	"{g:dota_item_name:header_item_def}"
"DOTA_ReforgeItem_Action"	"再鍛"
"DOTA_AddSocket_ConfirmTitle"	"ソケットを追加"
"DOTA_AddGemToSocket_NeedGems"	"このソケットに合うジェムを所持していません。"
"DOTA_AddGemToSocket_Text"	"アイテムのソケットにジェムを追加しています..."
"DOTA_AddGemToSocket_Succeeded"	"アイテムへジェムを追加することに成功しました。"
"DOTA_SelectGem_Title"	"ソケットに装着するジェムを選択"
"DOTA_SelectGem_Action"	"選択"
"DOTA_RemoveGemFromSocket_Confirm"	"本当にこのアイテムを破壊してジェムを取り出しますか？金槌の残り使用回数が 1 消費されます。"
"DOTA_RemoveGemFromSocket_Confirm_Immortal"	"本当にこのイモータルアイテムを破壊してジェムを取り出しますか？ 金槌の残り使用回数が 1 消費されます。<span class=\"CriticalText\">このアイテムは非常にレアですが、このアクションにより破壊されてしまいます。</span>"
"DOTA_RemoveGemFromSocket_Confirm_Arcana"	"本当にこのアルカナアイテムを破壊してジェムを取り出しますか？金槌の残り使用回数が 1 消費されます。<span class=\"CriticalText\">このアイテムは非常にレアですが、このアクションにより破壊されてしまいます。</span>"
"DOTA_RemoveGemFromSocket_Failed"	"ジェムをソケットから取り外すときにエラーが発生しました。"
"DOTA_GCRequest_Timeout"	"Valve サーバーへの接続がタイムアウトしました。後でもう一度お試しください。"
"DOTA_Armory_Coin_Treasure_Tier1"	"ゴールドティアー"
"DOTA_Armory_Coin_Treasure_Tier2"	"シルバーティアー"
"DOTA_Armory_Coin_Treasure_Tier3"	"ブロンズティアー"
"DOTA_Armory_DeleteItem_Header"	"アイテムを削除"
"DOTA_Armory_DeleteItem_Body"	"本当に{g:dota_item_name:selected_item_def}を削除してもよろしいですか？このアクションは取り消しできません。"
"DOTA_Workshop_LoadingScreen"	"ローディング画面"
"DOTA_Workshop_Select"	"選択"
"DOTA_StyleUnlock_UnpackBundle"	"このバンドルにはアンロックスタイルを持つアイテムが入っています。このバンドルを開封したいですか？"
"DOTA_StyleUnlock_UnpackBundleError"	"このバンドルにはアンロックスタイルを持つアイテムが入っています。これらのスタイルをアンロックするためにはまずこのバンドルを開封する必要があります。"
"DOTA_ShareParty_Available"	"パーティに参加"
"DOTA_ShareLobby_Available"	"ロビーに参加"
"dota_settings_application"	"アプリケーション"
"DOTA_EconItemSet_Tooltip_HasCommonGem"	"1つ以上のジェムあり"
"DOTA_EconItemSet_Tooltip_HasRareGem"	"1つ以上のレアジェムあり"
"DOTA_HeroLoadout_GlobalFilterName"	"グローバル"
"DOTA_Armory_Category_AllNew"	"全ての ({d:armory_new_items})"
"DOTA_Armory_Category_ScratchPad_Remove"	"クリア"
"DOTA_Armory_Collection_Info"	"コレクションを使ってお気に入りのアイテムを直ぐに見つけられるように表示方法をカスタマイズしよう。<br><br>この枠内にアイテムをドラッグすれば、コレクションに表示されるようにできます。自分のコレクションからアイテムをクリアするには、コレクション表示の外にアイテムをドラッグしてください。<br><br>コレクション内のアイテムは、保管庫とコレクション両方に表示されるようになります。"
"DOTA_Armory_Capacity_Info"	"あなたが保管庫の収容能力を超えて使用した場合、その保管庫はオーバーフロー状態になってしまいます。<br><br>保管庫がオーバーフロー状態になると、次の行為が制限されます：<br><br>- ドロップアイテムを受け取る<br>- バンドルを開ける<br>- 新しいアイテムを購入する<br><br>保管庫の空きを確保するためにアイテムのリサイクルや削除をしたり、いらなくなったアイテムをフレンドにギフトしたりしましょう。これらの機能にはアイテムのアイコンを右クリックするだけでアクセスできます。"
"DOTA_Armory_Capacity"	"保管庫の {d:armory_percent_capacity}% を使用中"
"DOTA_Armory_Filter_InScratchpad"	"コレクション"
"DOTA_Socketing_Tooltip"	"ソケットにジェムを埋め込んで、アイテムをカスタマイズすることができます。コモンソケットを追加するには熟練工の彫刻刀を使い、ソケットからコモンジェムを取り除くには熟練工の金槌を使います。"
"DOTA_Socketing_AddSocket_Tooltip"	"コモンソケットの取り付けには熟練工の彫刻刀ガ必要です。このアイテムを持っていない場合には、ソケットを追加をクリックすると、購入オプションが表示されます。"
"DOTA_Socketing_ExtractGem_Tooltip"	"コモンソケットの取り外しには熟練工の金槌が必要です。このアイテムを持っていない場合には、ジェムを取り外すをクリックすると、購入オプションが表示されます。"
"DOTA_Socketing_ExtractOrResetGem_Tooltip"	"ジェムをリセットするとジェムが追跡した統計カウンターが０になります。ジェムの取り外しには熟練工の金槌が必要です。このアイテムを持っていない場合には、取り外すをクリックすると、購入オプションが表示されます。"
"DOTA_Socketing_Replace_Tooltip"	"レアジェムを交換すると、ソケット内の既存のジェムが破壊されます。"
"DOTA_Socketing_HasHeroRestriction_Title"	"ジェムにヒーロー規制があります"
"DOTA_Socketing_HasRequiredSlot"	" ( 必要なスロット： {s:required_item_slot_name})"
"DOTA_Socketing_HasHeroRestriction_Body"	"このジェムは {g:dota_hero_name:socket_required_hero}{s:required_item_slot}のみに使用できます。本当に取り出しても良いですか？"
"DOTA_Profile_LeaguePassesPage"	"チケット"
"DOTA_TournamentBracket_MatchList_Timestamp"	"{T:l:timestamp}"
"DOTA_WatchLive_Game_ProInfo"	"{g:dota_persona:pro:account_id} {s:hero_name}"
"DOTA_WatchLive_Game_TeamInfo"	"<font color='#ffffff'>{s:team_1_name}</font> 対 <font color='#ffffff'>{s:team_2_name}</font>"
"DOTA_WatchLive_Game_AverageMMR"	"平均 MMR ： {i:avg_mmr}"
"DOTA_WatchLive_Game_TimeAndScore"	"{t:d:duration} / {i:radiant_score} - {i:dire_score}"
"DOTA_WatchLive_Game_Round"	""
"DOTA_WatchLive_Game_LoadMore"	"もっと見る"
"competitive_team_identity_checkbox"	"{s:team_identity_tag}としてプレイ"
"ranked_mmr_team_label"	"チーム"
"ranked_mmr_team_value"	"{d:team_identity_rank}"
"dota_matchmaking_region_ping_time_approx"	"Ping: ~{i:ping_ms}ms"
"dota_matchmaking_region_ping_time_min"	"Ping: >{i:ping_ms}ms"
"DOTA_tooltip_econ_item_gift_allowed"	"ギフト可能"
"DOTA_econ_item_details_toggle_equip_state"	"{s:item_toggle_equip_state}"
"DOTA_Treasure_EventPurchase"	"Compendium リワード"
"DOTA_RemoveGemFromSocket_NeedHammers_Title"	"金槌を購入しますか？"
"DOTA_RemoveGemFromSocket_HammerCannotRemoveGem"	"この金槌では、そのソケットから指定したジェムを取り出すことはできません。"
"DOTA_TributeTreasure_Title"	"Tribute アップグレード Infuser"
"DOTA_TributeTreasure_Description"	"Tribute アップグレード Infuser を使用すれば永久的に特製環境効果をトレジャー内のアイテムにアンロックできます。"
"DOTA_TributeTreasure_Button"	"Infuser を適用"
"DOTA_CoinTreasure_Title"	"Fall 2015 Compendium クラフト"
"DOTA_CoinTreasure_Description"	"コインとレジャーを開くと、ブロンズ、シルバー、あるいはゴールドアイテムが一つもらえます。1つ下のティアーのアイテムを三つ使って、1つ上のティアーのアイテムに交換することが出来ます。ゴールドアイテムなら2つで別のアイテムに交換できます。"
"DOTA_CoinTreasure_CraftingButton"	"クラフトする"
"DOTA_CoinTreasure_RewardsButton"	"リワードチャートを開く"
"DOTA_SoaringCacheTreasure_BonusButton"	"ボーナス Cache を表示"
"DOTA_CacheTreasure_MissingCompendiumOK"	"詳細"
"DOTA_SplashAd_FallMajorCompendium_Title"	"Fall Season Compendium をゲットしよう"
"DOTA_SplashAd_FallMajorSoaringCache_Title"	"Fall Compendium Soaring Cache"
"DOTA_SplashAd_FallMajorSoaringCache_Description"	"Compendium オーナーだけに特別！Soaring Cache を開いて、コミュニティ製の新セットを手に入れよう。更に5つ開けるたびにボーナス Cacheをゲット！"
"DOTA_View_Details_Arrow"	"詳細を表示 >>"
"DOTA_UI_Play"	"プレイ"
"DOTA_Custom_Game_Of_The_Day"	"今日のゲーム"
"DOTA_Custom_Game_Games_With_Lobbies"	"オープンロビー"
"DOTA_WatchTournament_BestOf1"	"シングルマッチ"
"DOTA_WatchTournament_MatchDetails"	"マッチ詳細"
"DOTAWatchDownloads_MatchID"	"マッチ ID {s:match_id}"
"DOTAWatchDownloads_Size"	"{i:disk_space}MB"
"DOTAWatchDownloads_Teams"	"{s:team_1} 対 {s:team_2}"
"DOTAWatchDownloads_DeleteTitle"	"リプレイを削除しますか？"
"DOTAWatchDownloads_DeleteBody"	"このリプレイを削除しますか？再ダウンロードはできません。"
"dota_settings_hide_tips_on_loading_screens"	"ローディング画面にヒントを表示しない"
"LoadingScreen_TipText"	"{s:tip}"
"DOTA_econ_item_details_original_item_name"	"{s:original_item_name}"
"DOTA_Purchase_Popup_Title"	"{s:purchase_item_title}"
"DOTA_Purchase_Popup_Body"	"{s:purchase_item_body}"
"DOTA_Purchase_Popup_Purchase_Button"	"購入"
"DOTA_Purchase_Popup_SaleAmount"	"-{i:item_sale_amount}%"
"DOTA_Purchase_Popup_RegularSetPrice"	"{m:item_regular_price}"
"DOTA_Purchase_Popup_SetPrice"	"{m:item_price}"
"DOTA_Generic_Popup_Title"	"{s:generic_popup_title}"
"DOTA_Generic_Popup_Body"	"{s:generic_popup_body}"
"DOTA_ItemNameChange_Tooltip"	"ネームタグを使用することでアイテム名をカスタムできます。元のアイテム名に戻すときにはネームタグを必要としません。"
"DOTA_ItemDescChange_Tooltip"	"説明タグを使ってこのアイテムにカスタムの説明をつけよう。説明をオリジナルに戻すのに、説明タグは必要ありません。"
"DOTA_ItemChangeAttribute_NeedTool_Title"	"{s:tool_name} を購入しますか？"
"DOTA_ItemChangeAttribute_NeedTool"	"アイテムの {s:l:item_attribute} を変更するには {s:tool_name} が必要です。購入しますか？"
"DOTA_ItemChangeAttribute_EnterAttribute_Title"	"新しいアイテムの {s:item_attribute} を入力"
"Customization_Name"	"ネーム"
"Customization_Name_Tool"	"ネームタグ"
"Customization_Description"	"説明"
"Customization_Description_Tool"	"説明タグ"
"Customization_Gifter_Attributes"	"ギフト情報"
"DOTA_ItemRemoveAttribute_Title"	"{s:item_attribute} を削除しますか？"
"DOTA_TributeTreasure_GuaranteedDescription"	"次の Infuser までのトレジャー： "
"DOTA_Leaf_Halloween2015_Title"	"ホーンテッドコロシアム"
"DOTA_Leaf_Halloween2015_SubTitle"	"Valve作の新たなカスタムゲーム"
"DOTA_Leaf_Halloween2015_Desc"	"1チーム5人の両チームで互いに領土支配を掛ける総力戦。"
"DOTA_Leaf_Halloween2015_Capture"	"キャプチャー"
"DOTA_Leaf_Halloween2015_Control"	"コントロール"
"DOTA_Leaf_Halloween2015_Tricks"	"トリック"
"DOTA_Leaf_Halloween2015_Win"	"勝利"
"DOTA_Leaf_Halloween2015_Capture_Desc"	"コントロールポイント (CP)の上に立って支配しよう。3つ以上のCPトを支配すればチームにポイントが入る。<br><br>CPの数が多いほどより早くポイントを稼げる。"
"DOTA_Leaf_Halloween2015_Control_Desc"	"CPを勝ち取るにはそこに立って相手がポイントをキャプチャーするのを妨害したり遅らせたりしよう。<br><br>Glyph of Fortification を使えば敵がキャプチャーするのを一時的にブロックできる。"
"DOTA_Leaf_Halloween2015_Tricks_Desc"	"罠を踏むと遠くからの敵との戦いを誘発する。<i>気をつけろ！</i> スパイクトラップと振り子トラップは自分自身とチームメイトにもダメージを与えてしまう。 <br><br>敵が 1000 ポイント稼ぐたび、味方のビヒモスが出現して加勢してくれる。"
"DOTA_Leaf_Halloween2015_Win_Desc"	"<font color='#DAFCD9'>最初に5000ポイントを集めたチームの勝利。</font><br><br>敵を倒して、追加ゴールドをもらたしたり、ヘルスやマナを回復したりするお菓子を集めよう。"
"DOTA_Leaf_Halloween2015_Play"	"ホーンテッドコロシアムへ行く"
"FrontPage_Halloween2015_Haunted_Colosseum_Header"	"新たなカスタムゲーム"
"FrontPage_Halloween2015_Haunted_Colosseum_Title"	"ホーンテッドコロシアム"
"FrontPage_Halloween2015_Haunted_Colosseum_Desc"	"Valve作の新たなカスタムゲーム"
"DOTA_OwnedItemDetails_DefaultSet"	"デフォルトセット"
"DOTA_Workshop_SMDWarning"	"注意： SMD ファイルのサポートは近いうちに終了します。"
"DOTA_TributeTreasure_PreviewInfuser"	"Infuser 付きのセットをプレビュー"
"DOTA_PartnerPurchase_ItemName"	"{s:item_name}"
"DOTA_PartnerPurchase_ItemCount"	"{d:item_count}"
"DOTA_PartnerPurchase_ItemPrice"	"{m:item_price}"
"DOTA_TournamentBracket_GrandFinals"	"決勝"
"DOTA_TournamentBracket_Group1"	"グループ A"
"DOTA_TournamentBracket_Group2"	"グループ B"
"DOTA_TournamentBracket_Group3"	"グループ C"
"DOTA_TournamentBracket_Group4"	"グループ D"
"DOTA_TournamentBracket_Group5"	"グループ E"
"DOTA_TournamentBracket_Group6"	"グループ F"
"DOTA_TournamentBracket_Group7"	"グループ G"
"DOTA_TournamentBracket_Group8"	"グループ H"
"DOTA_TournamentBracket_Match1"	"第 1 試合"
"DOTA_TournamentBracket_Match2"	"第 2 試合"
"DOTA_TournamentBracket_Match3"	"第 3 試合"
"DOTA_TournamentBracket_Match4"	"第 4 試合"
"DOTA_TournamentBracket_Match5"	"第 5 試合"
"DOTA_TournamentBracket_Match6"	"第 6 試合"
"DOTA_TournamentBracket_Match7"	"第 7 試合"
"DOTA_TournamentBracket_Match8"	"第 8 試合"
"DOTA_TournamentBracket_Match9"	"第 9 試合"
"DOTA_TournamentBracket_Match10"	"第 10 試合"
"DOTA_TournamentBracket_Sidebar_Watch"	"観戦"
"DOTA_TournamentBracket_MatchList_TBD"	"未定"
"DOTA_TournamentBracket_Sidebar_Stage"	"{s:stage} ({i:best_of} 番勝負 )"
"DOTA_TournamentBracket_Sidebar_Live"	"試合中"
"DOTA_TournamentBracket_Sidebar_TimeRemaining"	"開始まで {t:m:r:duration}"
"DOTA_TournamentBracket_Sidebar_WinnerGoes"	"勝者は {s:winner_goes} へ進出"
"DOTA_TournamentBracket_Sidebar_PreviousMatch"	"{s:name} の前回の試合： 対 {s:prevopponent} {s:prevscore}"
"DOTA_MatchDetailsGame_DownloadProgress"	"ダウンロード中...{i:download_pct}%"
"DOTA_MatchDetailsGame_DecompressProgress"	"展開中...{i:decompress_pct}%"
"DOTA_WatchTournamentBracket_PrizePoolLabel"	"賞金総額"
"DOTA_WatchTournamentBracket_StartDate"	"開始日"
"DOTA_WatchTournamentBracket_EndDate"	"終了日"
"DOTA_WatchTournamentBracket_Dates"	"開催期間"
"DOTA_WatchTournamentBracket_Location"	"開催地"
"DOTA_WatchTournamentBracket_Organizer"	"主催者"
"DOTA_WatchTournamentBracket_Tier"	"ティアー"
"DOTA_TournamentNewsDate"	"{t:r:m:date}"
"DOTATournamentBracket_MatchDate"	"{t:s:date}"
"DOTA_TournamentBracket_RowRank"	"{i:rank}"
"DOTA_TournamentBracket_RowTeamName"	"{s:team_name}"
"DOTA_TournamentBracket_RowGamesPlayed"	"{i:played}"
"DOTA_TournamentBracket_RowPoints"	"{i:won} - {i:tied} - {i:lost}"
"DOTA_TournamentBracket_Score"	"{i:score}"
"DOTA_TournamentMatchListTime"	"{t:s:time}"
"DOTA_TournamentMatchListTeam1"	"{s:team1}"
"DOTA_TournamentMatchListTeam2"	"{s:team2}"
"DOTA_TournamentMatchListScore"	"{i:score1} - {i:score2}"
"DOTA_TournamentButtonHide"	"非表示"
"DOTA_TournamentButtonWatch"	"観戦"
"DOTA_TournamentButtonDetails"	"詳細"
"DOTA_TournamentButtonMatchDetails"	"試合詳細"
"DOTATournamentBracketPlayoffs"	"プレイオフ"
"DOTATournamentBracketGroupPhase"	"グループステージ"
"DOTATournamentDetailsPhase"	"{s:phase}"
"DOTATournamentDetailsSchedule"	"日程"
"DOTATournamentBracketOverview"	"概要"
"DOTATournamentBracketTeams"	"チーム"
"DOTATournamentStage"	"{s:stage_name}"
"DOTATournamentTeamUnknown"	"未定"
"DOTA_WatchTournament_Live"	"試合を放送中"
"DOTA_ReplayDownload_Error"	"リプレイのダウンロードエラー： {s:download_error}"
"DOTA_econ_item_details_item_creation_date"	"リリース日： {t:l:creation_date}"
"DOTA_Workshop_SubmissionType_TeamLogo"	"チームロゴ"
"DOTA_Workshop_LogoMarketingImage"	"チームロゴ"
"DOTA_Workshop_SubmissionType_MusicPack"	"ミュージックパック"
"DOTA_Workshop_Music_ui_hero_select"	"ヒーロー選択"
"DOTA_Workshop_Music_countdown"	"カウントダウン"
"DOTA_Workshop_SubmissionType_Emoticon"	"チャット用絵文字"
"DOTA_Workshop_Error_ImageExactWidth"	"画像の横幅が不適切： %1 (%2px でなければいけません)"
"DOTA_Workshop_Error_ImageExactHeight"	"画像の縦幅が不適切： %1 (%2px でなければいけません)"
"DOTA_Workshop_Error_EmoticonHeight"	"画像の縦幅が不適切： %1 (絵文字の縦幅は %2px でなければいけません)"
"DOTA_Workshop_EntityShadowScale"	"シャドウスケール"
"DOTA_Workshop_Err_FileTooBig"	"ソースファイル「 %1 」が大きすぎます (%2 KB、最大 %3 KBまで)"
"DOTA_Workshop_BrowseForPngFilter"	"PNG"
"DOTA_Workshop_BrowseForWavFilter"	"WAV"
"DOTA_Workshop_Items_Err_Name_In_Use"	"アイテム名「 %1 」は既にアイテム %2 で使用されています"
"DOTA_Workshop_GenerateIconImages"	"デフォルトアイコン画像を生成"
"DOTA_Workshop_ItemSubmit_Create_Button"	"アイテムファイルを作成"
"DOTA_Workshop_ItemSubmit_Recreate_Button"	"アイテムファイルを再作成"
"DOTA_Workshop_ItemSubmit_Update_Button"	"アイテムファイルを更新"
"DOTA_SoaringCacheTreasure_Title"	"ボーナス Cache 獲得！"
"DOTA_SoaringCacheTreasure_Description"	"2016年1月1日までに、Soaring Cache を5つ開ける度に、ボーナスの Chache を1つ獲得します。中には、Compendium レベルあるいはレアアイテムが入っています。"
"DOTA_FlutteringCacheTreasure_Title"	"ボーナス Cache 獲得！"
"DOTA_FlutteringCacheTreasure_Description"	"2016年１月１日より前に、Fluttering Caches を５つ開ける毎に、Compendium レベルかレアアイテムが入ったボーナスCACHEを１つゲット。"
"DOTA_SoaringCacheTreasure_Bonus"	"ボーナス"
"DOTA_CacheTreasure_UntilReward"	"あと {d:action_score} 個を開けてボーナス Cache をゲット"
"DOTA_CacheTreasure_Open3"	"あと {d:action_score} 個を開けて Compendium レベルを獲得"
"DOTA_CacheTreasure_Open7"	"あと {d:action_score} 個を開けて 3 Compendium レベルを獲得"
"FrontPage_VideoStream_Live"	"ライブ"
"FrontPage_VideoStream_Teams"	"{s:team_1} 対 {s:team_2}"
"FrontPage_VideoStream_GameState"	"{s:stage_name}"
"FrontPage_VideoStream_Watch"	"ゲーム内で観戦"
"FrontPage_VideoStream_WatchLiveInGame"	"ゲーム内で試合を観戦"
"FrontPage_VideoStream_BroadcastUpcomingTime"	"{t:r:m:upcoming_broadcast_time}"
"FrontPage_VideoStream_BroadcastUpcomingSoon"	"まもなく開始"
"DOTA_SplashAd_FallMajorCompendium_Cache2_Owned"	"新セット登場、Bloodseeker クーリエをたった <font color='#FFFFFF'>{g:dota_item_price:treasure_itemdef}</font>で購入するチャンス！"
"DOTA_SplashAd_FallMajorCompendium_Cache2_NotOwned"	"Fall Compendium 所有者向けの新セットと Bloodseeker クーリエ！"
"DOTA_TournamentBracket_Sidebar_Soon"	"まもなく開始"
"DOTATournamentGameWinner"	"勝者"
"DOTATournamentMatch_BestOf2"	"二番勝負"
"DOTATournamentMatch_BestOf3"	"三番勝負"
"DOTATournamentMatch_BestOf4"	"四番勝負"
"DOTATournamentMatch_BestOf5"	"五番勝負"
"UI_month_0"	"1月"
"UI_month_1"	"2月"
"UI_month_2"	"3月"
"UI_month_3"	"4月"
"UI_month_4"	"5月"
"UI_month_5"	"6月"
"UI_month_6"	"7月"
"UI_month_7"	"8月"
"UI_month_8"	"9月"
"UI_month_9"	"10月"
"UI_month_10"	"11月"
"UI_month_11"	"12月"
"UI_month_short_0"	"1月"
"UI_month_short_1"	"2月"
"UI_month_short_2"	"3月"
"UI_month_short_3"	"4月"
"UI_month_short_4"	"5月"
"UI_month_short_5"	"6月"
"UI_month_short_6"	"7月"
"UI_month_short_7"	"8月"
"UI_month_short_8"	"9月"
"UI_month_short_9"	"10月"
"UI_month_short_10"	"11月"
"UI_month_short_11"	"12月"
"UI_day_1"	"日曜日"
"UI_day_2"	"月曜日"
"UI_day_3"	"火曜日"
"UI_day_4"	"水曜日"
"UI_day_5"	"木曜日"
"UI_day_6"	"金曜日"
"UI_day_7"	"土曜日"
"UI_day_short_1"	"日"
"UI_day_short_2"	"月"
"UI_day_short_3"	"火"
"UI_day_short_4"	"水"
"UI_day_short_5"	"木"
"UI_day_short_6"	"金"
"UI_day_short_7"	"土"
"UI_day_shorter_1"	"日"
"UI_day_shorter_2"	"月"
"UI_day_shorter_3"	"火"
"UI_day_shorter_4"	"水"
"UI_day_shorter_5"	"木"
"UI_day_shorter_6"	"金"
"UI_day_shorter_7"	"土"
"DOTATournamentDetailsDatesYearDiff"	"{s:end_year}s:start_month} {s:start_day}, {s:start_year} - {s:end_month} {s:end_day}"
"DOTATournamentDetailsDatesMonthDiff"	"{s:end_year}{s:start_month} {s:start_day} - {s:end_month} {s:end_day}"
"DOTATournamentDetailsDatesDayDiff"	"{s:end_year}{s:start_month} {s:start_day} - {s:end_day}"
"DOTATournamentDetailsDates"	"{s:end_year}{s:start_month} {s:start_day}"
"DOTA_TeamTransferAdmin_Confirm_Header"	"チーム管理者を変更"
"DOTA_TeamTransferAdmin_Confirm_Message"	"{s:player_name} をチーム管理人にしたいですか？ 続行すると、あなたはこのチームの管理ができなくなります。"
"DOTA_TeamTransferAdmin_Success_Header"	"成功"
"DOTA_TeamTransferAdmin_Success_Message"	"チーム管理権を譲渡することに成功しました。"
"DOTA_TeamTransferAdmin_Failure_Header"	"エラー"
"DOTA_TeamTransferAdmin_Failure_Message_NotAdmin"	"あなたはこのチームの現在の管理人ではありません。"
"DOTA_TeamTransferAdmin_Failure_Message_OnOtherTeam"	"{s:player_name} は別のチームの登録プレイヤーです。"
"DOTA_TeamTransferAdmin_Failure_Message_AdminOfOtherTeam"	"{s:player_name} は別のチームの管理人です"
"DOTA_TeamTransferAdmin_Failure_Message_Unspecified"	"チーム管理人の変更に失敗しました"
"DOTA_TeamTransferAdmin_Notification_Header"	"チーム管理"
"DOTA_TeamTransferAdmin_Notification_Message"	"チーム {s:team_name} の管理人になりました"
"DOTA_Lobby_Settings_Team1"	"{s:team1}"
"DOTA_Lobby_Settings_Team2"	"{s:team2}"
"DOTA_Lobby_Settings_Empty"	"-"
"DOTA_HeroDemo_Button_Hero"	"デモ ヒーロー"
"DOTA_HeroDemo_Button_Arcana"	"デモ アルカナ"
"DOTA_HeroLoadout_ArcanaFilterName"	"アルカナ"
"DOTA_HeroCustomize_SelectItemsInSet"	"アイテムセットを選択"
"DOTA_Armory_Category_Terrain"	"地形"
"DOTA_econ_item_details_owning_bundle_item_name"	"{s:item_owning_bundle_name}"
"DOTA_GlobalItems_Terrain"	"地形"
"FrontPage_Debut_Arc_Warden_Header"	"新たなヒーロー"
"DOTA_ViolatorNew"	"NEW"
"DOTA_RecentArmoryItems_EmptyMessage"	"保管庫を表示するときはこの剣と盾のアイコンをクリックしてください。"
"DOTA_Store_TopSellers"	"トップセラー"
"DOTA_Store_SpotlightTreasure"	"注目のトレジャー"
"DOTA_Store_SpotlightDuration"	"あと {t:r:s:m:spotlight_end_time} で終了"
"DOTA_SeasonPass_SecondaryTabHeader_Home"	"ホーム"
"DOTA_SeasonPass_SecondaryTabHeader_Rewards"	"リワード"
"DOTA_Hud_ManaRegen"	"{s:mana_regen}"
"DOTA_Hud_XP"	"{d:r:current_xp} / {d:r:xp_to_level}"
"DOTA_Hud_Level_Up"	"レベルアップ +{d:points_to_spend}"
"DOTA_Hud_AttackDamage"	"攻撃力: {s:attack_damage}"
"DOTA_Hud_PhysicalArmor"	"物理アーマー: {s:physical_armor}"
"DOTA_Hud_DamageResistance"	"物理ダメージ軽減率: {d:damage_resistance}%"
"DOTA_Hud_MagicResistance"	"魔法ダメージ軽減率: {d:magic_damage_resistance}%"
"DOTA_Hud_AttributeTooltip_Damage"	"- 1ポイントごとに攻撃力が1上昇"
"DOTA_Hud_StrTooltip_HPRegen"	"- 1 ポイントごとに HP の自然回復量が 0.03 上昇"
"DOTA_Hud_AgiTooltip_Armor"	"- 7 ポイントごとにアーマーが 1 上昇"
"DOTA_Hud_AgiTooltip_AttackSpeed"	"- 1 ポイントごとに攻撃速度が 1 上昇"
"DOTA_Hud_IntTooltip_ManaRegen"	"- 1 ポイントごとにマナの自然回復量が 0.04 上昇"
"DOTA_Hud_Attribute_PointsPerLevel"	"- ヒーローレベルごとの増加量: {s:points_gained}"
"DOTA_Hud_Attributes_Level"	"属性レベル: {d:attributes_level}"
"DOTA_HUD_ReliableGold"	"確実なゴールド： {d:reliable_gold}"
"DOTA_HUD_UnreliableGold"	"不確実なゴールド： {d:unreliable_gold}"
"DOTA_HUD_DeathCost"	"死のコスト: {d:death_cost}"
"DOTA_HUD_BuybackCost"	"バイバックに必要: {d:buyback_cost}"
"DOTA_HUD_BuybackCooldownReady"	"バイバッククールダウン: 購入可"
"DOTA_HUD_BuybackCooldownNotReady"	"バイバッククールダウン: {s:buyback_cooldown}"
"DOTA_HUD_BuybackCost_Needed"	"バイバックには {d:buyback_gold_needed} ゴールドが必要"
"DOTA_HeroStatColumn_Hero"	"ヒーロー"
"DOTA_HeroStatColumn_GamesPlayed"	"合計"
"DOTA_HeroStatColumn_Wins"	"勝利数"
"DOTA_HeroStatColumn_Losses"	"敗北数"
"DOTA_HeroStatColumn_WinRate"	"勝率"
"DOTA_HeroStatColumn_HeroMMR"	"ヒーロー MMR"
"DOTA_HeroStatColumn_BestWinStreak"	"最高"
"DOTA_HeroStatColumn_CurrentWinStreak"	"現在"
"DOTA_HeroStatColumn_AvgKills"	"K"
"DOTA_HeroStatColumn_AvgDeaths"	"D"
"DOTA_HeroStatColumn_AvgAssists"	"A"
"DOTA_HeroStatColumn_AvgGPM"	"GPM"
"DOTA_HeroStatColumn_AvgXPM"	"XPM"
"DOTA_HeroStatColumn_BestKills"	"K"
"DOTA_HeroStatColumn_BestAssists"	"A"
"DOTA_HeroStatColumn_BestGPM"	"GPM"
"DOTA_HeroStatColumn_BestXPM"	"XPM"
"DOTA_HeroStatColumn_Header_Hero"	" "
"DOTA_HeroStatColumn_Header_Games"	"ゲーム"
"DOTA_HeroStatColumn_Header_Ratings"	" "
"DOTA_HeroStatColumn_Header_WinStreaks"	"連続勝利数"
"DOTA_HeroStatColumn_Header_Averages"	"平均"
"DOTA_HeroStatColumn_Header_BestRecords"	"最高記録"
"DOTA_HeroStat_Games"	"ゲーム"
"DOTA_HeroStat_Wins"	"勝利数"
"DOTA_HeroStat_Losses"	"敗北数"
"DOTA_HeroStat_Streak"	"ストリーク"
"DOTA_HeroStat_StreakDesc"	"連続 (最高)"
"DOTA_HeroStat_WinRate"	"勝率"
"DOTA_HeroStat_Kills"	"キル数"
"DOTA_HeroStat_Deaths"	"死亡回数"
"DOTA_HeroStat_Assists"	"アシスト数"
"DOTA_HeroStat_GPM"	"GPM"
"DOTA_HeroStat_XPM"	"XPM"
"DOTA_HeroStat_WonMatch"	"勝利マッチ"
"DOTA_HeroStat_LastMatch"	"敗北マッチ"
"DOTA_HeroStat_GameType"	"{s:tooltip_game_mode}"
"DOTA_HeroDemo_Button_ToLoadout"	"装備を開く"
"DOTA_Workshop_Publish_WindowTitle"	"ワークショップ公開"
"DOTA_Workshop_Publish_Title"	"タイトル:"
"DOTA_Workshop_Publish_Description"	"説明:"
"DOTA_Workshop_Publish_PreviewImage"	"プレビュー画像:"
"DOTA_Workshop_Publish_UploadSize"	"アップロードサイズ:"
"DOTA_Workshop_Publish_ChangeLog"	"変更ログ:"
"DOTA_Workshop_Publish_AddonFolder"	"アドオンフォルダ:"
"DOTA_Workshop_Publish_Visibility"	"公開設定"
"DOTA_Workshop_Publish_Visibility_Public"	"公開"
"DOTA_Workshop_Publish_Visibility_FriendsOnly"	"フレンドのみ"
"DOTA_Workshop_Publish_Visibility_Hidden"	"非公開"
"DOTA_Workshop_Publish_AcceptAgreement"	"Steam Workshop Contribution Agreement の契約条項に同意します。"
"DOTA_Workshop_Publish_ViewAgreement"	"契約を表示"
"DOTA_Workshop_Publish_Cancel"	"キャンセル"
"DOTA_Workshop_Publish_CancelTitle"	"ファイルのアップロードをキャンセルしますか？"
"DOTA_Workshop_Publish_CancelQuestion"	"ファイルのアップロードをキャンセルしてもよろしいですか？"
"DOTA_Workshop_Publish_Submit"	"提出"
"DOTA_Workshop_Publish_PrimaryOwnerPreview"	"メインオーナーのみがプレビュー画像を変更できます"
"DOTA_Workshop_Publish_BrowseForImage"	"画像を閲覧"
"DOTA_Workshop_Publish_ImageInstruction"	"ここに画像をドラッグするか、閲覧ボタンをクリック\n画像のスケールは %1"
"DOTA_Workshop_Publish_UpdateNotesInstruction"	"この変更の備考をこちらに入力してください"
"DOTA_Workshop_Publish_ChooseImage"	"画像を選択"
"DOTA_Workshop_Publish_ImageFilter"	"画像ファイル"
"DOTA_Workshop_Publish_CancelUpload"	"ファイルアップロードをキャンセルしますか？"
"DOTA_Workshop_Publish_CancelUploadText"	"ファイルアップロードを本当にキャンセルしてよろしいですか？"
"DOTA_Workshop_Publish_RetrievingInfo"	"ファイル情報検索中..."
"DOTA_Workshop_Publish_Submitting"	"ワークショップに提出中"
"DOTA_Workshop_Publish_StatusWindowTitle_Addon"	"ワークショップ管理 [Dota アドオン]"
"DOTA_Workshop_Publish_StatusWindowTitle_Items"	"ワークショップ管理[Dota アイテム]"
"DOTA_Workshop_Publish_Success"	"成功"
"DOTA_Workshop_Publish_SuccessMessage"	"アイテムが Steam ワークショップにアップロードされました！"
"DOTA_Workshop_Publish_Updating"	"アップデート中、お待ちください..."
"DOTA_Workshop_Publish_SuccessTextNeedsToAccept"	"アイテムがワークショップにアップロードされましたが、他のユーザーに公開するには、ワークショップのウェブページ上の最新 ワークショップ法的契約 に同意する必要があります。"
"DOTA_Workshop_Publish_FolderChangeTitle"	"アップロードして続行しますか?"
"DOTA_Workshop_Publish_FolderChange"	"%1 用のアドオンソースフォルダの変更が検出されました！\n以前のソースフォルダは \"%2\"でした。\n新しいアドオンフォルダは \"%3\"です。\nアップロードして続行しますか？"
"DOTA_Workshop_Publish_UGCError"	"UGC サーバーからファイルをダウンロードしようとした際にエラーが発生しました。"
"DOTA_Workshop_Publish_NoAddonsFolder"	"アドオンフォルダを見つけられません！"
"DOTA_Workshop_Publish_VPKCreateFailure"	"カスタムゲームフォルダ %1 用の VPK ファイルを作成できません　"
"DOTA_Workshop_Publish_SuccessTitle"	"成功"
"DOTA_Workshop_Publish_SuccessText"	"アイテムが Steam ワークショップでアップデートされました！"
"DOTA_Workshop_Publish_PackagingSubmission"	"パッケージング提出データ"
"DOTA_Workshop_Publish_Err_NoAddonDir"	"新しいワークショップアイテム (%1) の作成に失敗しました。アドオンディレクトリを見つけられません。"
"DOTA_Workshop_Publish_Err_VPKAddFailed"	"新しいワークショップアイテム (%1) の作成に失敗しました。.vpk ローカルディレクトリを追加できませんでした。"
"DOTA_Workshop_Publish_Err_InvalidZip"	"無効な Zip ファイル。"
"DOTA_Workshop_Publish_Err_MoveZipFailure"	"新しいワークショップアイテム (%1) の作成に失敗しました。zip をアップロードディレクトリに移動できませんでした。('%2' から '%3'へ)"
"DOTA_Workshop_Publish_Err_Title"	"タイトルを入力してください"
"DOTA_Workshop_Publish_Err_NoDesc"	"説明を入力してください"
"DOTA_Workshop_Publish_Err_DescTooLong"	"説明が長すぎます。最長 %1 文字です。"
"DOTA_Workshop_Publish_Err_NoChange"	"変更への説明を入力してください"
"DOTA_Workshop_Publish_Err_ChangeTooLong"	"変更ノートが長すぎます。最長で %1 文字です。"
"DOTA_Workshop_Publish_Err_NoFile"	"ファイルを選択してください"
"DOTA_Workshop_Publish_Err_NoPreview"	"プレビュー画像を選択してください"
"DOTA_Workshop_Publish_Err_NoVisibility"	"アイテムの公開度オプションを選択してください。"
"DOTA_Workshop_PublishFailure_SteamAPI"	"公開失敗: アイテムの提出に失敗しました"
"DOTA_Workshop_PublishFailure_SteamAPIResult"	"公開失敗： 不明なエラー"
"DOTA_Workshop_PublishFailure_Password"	"公開失敗： 無効なパスワード"
"DOTA_Workshop_PublishFailure_LimitedAccount"	"公開失敗： 制限されたアカウント<br>(<a href='https://support.steampowered.com/kb_article.php?ref=3330-IAGK-7663'>https://support.steampowered.com/kb_article.php?ref=3330-IAGK-7663</a>を参照)"
"DOTA_Workshop_PublishFailure_Generic"	"公開失敗： エラーコード %1"
"DOTA_Workshop_PublishFailure_FailedToWritePreviewImage"	"プレビュー画像を'%1' へ書き込み失敗"
"DOTA_ConfirmOwnedItemUnbundleText"	"本当にこのアイテムのバンドルを開封してもいいですか？バンドル内のアイテムを使用するには、開封する必要があります。"
"DOTA_econ_item_details_item_uneditable_description"	"{s:item_uneditable_description}"
"DOTA_econ_item_details_bundle_header"	"バンドル内のアイテム"
"DOTA_econ_item_details_unbundle"	"バンドル開封"
"BattlePass_LevelUp_Header"	"おめでとう！"
"BattlePass_LevelUp_Body"	"バトルパスのレベルが上がりました："
"DOTA_SeasonPass_PreviousReward"	"{s:previous_reward}"
"DOTA_SeasonPass_NextReward"	"{s:next_reward}"
"DOTA_SeasonPassAchievement_Name"	"{s:achievement_name}"
"DOTA_Wheel_ItemCategory"	"{s:category}"
"DOTA_RewardPath_Level"	"{i:level}"
"DOTA_Compendium_Wagering_SuccessRate"	"成功率"
"DOTA_GameEnd_CompendiumLevel"	"レベル"
"DOTA_DB_SeasonPass_Level"	"レベル"
"DOTA_CompendiumRecap_Region1"	"中国"
"DOTA_SeasonPass_Friends_Leaderboard_BattleLevel"	"バトルレベル"
"DOTA_SeasonPass_Wagering_Desc4"	"レベルアップ"
"DOTA_econ_item_details_apply_tool"	"{s:tool_use_name}"
"DOTA_BattlePass_FirstTime_NotActivated"	"Winter バトルパスの数ある機能を有効に使うにはもう１ステップ！"
"DOTA_Credits_RussianVoices"	"ロシア語版声優"
"DOTA_SplashAd_WinterMajorBattlePass_AddedTreasure3Desc"	"Winter バトルパスのトレジャー第３弾が登場。本シーズンのバトルパスのオーナーだけ入手できます。用意された 7 セットの中には、ウルトラレアな Death Prophet 用 'Secrets of the Merqueen'が新登場。"
"DOTA_SplashAd_WinterMajorBattlePass_AddedTreasure3Desc_Owns"	"Winter バトルパスのトレジャー第３弾が登場。本シーズンのバトルパスのオーナーだけ入手できます。用意された 7 セットの中には、ウルトラレアな Death Prophet 用 'Secrets of the Merqueen'が新登場。このトレジャーを既に獲得済みの場合には、保管庫内でアンロックされています。"
"DOTA_SplashAd_WinterMajorBattlePass_AddedTreasure4Desc"	"Winter バトルパスの最後のトレジャーが登場。本シーズンのバトルパスのオーナーだけ入手できます。用意された 7 セットの中には、ウルトラレアな Dazzle 用 'Darkclaw Emissary'セットが新登場。さらに、Shanghai Major Compendium のチーム情報と予測機能がアップデート。Shanghai Major を正しく予測して、バトルポイントを獲得しよう。"
"DOTA_SplashAd_WinterMajorBattlePass_AddedTreasure4Desc_Owns"	"Winter バトルパスの最後のトレジャーが登場。用意された 7 セットの中には、ウルトラレアな Dazzle 用 'Darkclaw Emissary'セットが新登場。既に持っている場合には、保管庫内でアンロックされています。さらに、Shanghai Major Compendium のチーム情報と予測機能がアップデート。Shanghai Major を正しく予測して、バトルポイントを獲得しよう。"
"DOTA_Compendium_PredictionsLockIn"	"予想締め切りまで"
"DOTA_Compendium_PredictionsLocked"	"予想は締め切られました"
"DOTA_Compendium_Predictions_Games_In_Tournament_a1"	"77 から 81"
"DOTA_Compendium_Predictions_Games_In_Tournament_a2"	"82 から 87"
"DOTA_Compendium_Predictions_Games_In_Tournament_a3"	"88 から 92"
"DOTA_Compendium_Predictions_Games_In_Tournament_a4"	"93 から 97"
"DOTA_Compendium_Predictions_Games_In_Tournament_a5"	"98 から 102"
"DOTA_Compendium_Predictions_Games_In_Tournament_a6"	"103 から 107"
"DOTA_Compendium_Predictions_Games_In_Tournament_a7"	"108 から 112"
"DOTA_Compendium_Predictions_Heroes_Picked_a1"	"0 から 60"
"DOTA_Compendium_Predictions_Heroes_Picked_a2"	"61 から 70"
"DOTA_Compendium_Predictions_Heroes_Picked_a3"	"71 から 80"
"DOTA_Compendium_Predictions_Heroes_Picked_a4"	"81 から 90"
"DOTA_Compendium_Predictions_Heroes_Picked_a5"	"91 から 100"
"DOTA_Compendium_Predictions_Heroes_Picked_a6"	"101+"
"DOTA_Compendium_Predictions_Heroes_Banned_a1"	"0 から 60"
"DOTA_Compendium_Predictions_Heroes_Banned_a2"	"61 から 70"
"DOTA_Compendium_Predictions_Heroes_Banned_a3"	"71 から 80"
"DOTA_Compendium_Predictions_Heroes_Banned_a4"	"81 から 90"
"DOTA_Compendium_Predictions_Heroes_Banned_a5"	"91 から 100"
"DOTA_Compendium_Predictions_Heroes_Banned_a6"	"101+"
"DOTA_Compendium_Predictions_Most_Kills_In_Game_a1"	"0 から 50"
"DOTA_Compendium_Predictions_Most_Kills_In_Game_a2"	"51 から 60"
"DOTA_Compendium_Predictions_Most_Kills_In_Game_a3"	"61 から 70"
"DOTA_Compendium_Predictions_Most_Kills_In_Game_a4"	"71 から 80"
"DOTA_Compendium_Predictions_Most_Kills_In_Game_a5"	"81 から 90"
"DOTA_Compendium_Predictions_Most_Kills_In_Game_a6"	"91 から 100"
"DOTA_Compendium_Predictions_Most_Kills_In_Game_a7"	"101 から 110"
"DOTA_Compendium_Predictions_Most_Kills_In_Game_a8"	"111 から 120"
"DOTA_Compendium_Predictions_Most_Kills_In_Game_a9"	"121+"
"DOTA_Compendium_Predictions_Longest_Game_a1"	"00:00 から 39:59"
"DOTA_Compendium_Predictions_Longest_Game_a2"	"40:00 から 49:59"
"DOTA_Compendium_Predictions_Longest_Game_a3"	"50:00 から 59:59"
"DOTA_Compendium_Predictions_Longest_Game_a4"	"60:00 から 69:59"
"DOTA_Compendium_Predictions_Longest_Game_a5"	"70:00 から 79:59"
"DOTA_Compendium_Predictions_Longest_Game_a6"	"80:00 から 89:59"
"DOTA_Compendium_Predictions_Longest_Game_a7"	"90:00 から 99:59"
"DOTA_Compendium_Predictions_Longest_Game_a8"	"100:00+"
"DOTA_Compendium_Predictions_Shortest_Game_a1"	"00:00 から 9:59"
"DOTA_Compendium_Predictions_Shortest_Game_a2"	"10:00 から 14:59"
"DOTA_Compendium_Predictions_Shortest_Game_a3"	"15:00 から 19:59"
"DOTA_Compendium_Predictions_Shortest_Game_a4"	"20:00 から 24:59"
"DOTA_Compendium_Predictions_Shortest_Game_a5"	"25:00 から 29:59"
"DOTA_Compendium_Predictions_Shortest_Game_a6"	"30:00+"
"DOTA_Compendium_Predictions_Most_Kills_Game_Hero_a1"	"0 から 10"
"DOTA_Compendium_Predictions_Most_Kills_Game_Hero_a2"	"11 から 13"
"DOTA_Compendium_Predictions_Most_Kills_Game_Hero_a3"	"14 から 16"
"DOTA_Compendium_Predictions_Most_Kills_Game_Hero_a4"	"17 から 19"
"DOTA_Compendium_Predictions_Most_Kills_Game_Hero_a5"	"20 から 22"
"DOTA_Compendium_Predictions_Most_Kills_Game_Hero_a6"	"23 から 25"
"DOTA_Compendium_Predictions_Most_Kills_Game_Hero_a7"	"26+"
"DOTA_Compendium_Predictions_Most_Deaths_Game_Hero_a1"	"0 から 5"
"DOTA_Compendium_Predictions_Most_Deaths_Game_Hero_a2"	"6 から 8"
"DOTA_Compendium_Predictions_Most_Deaths_Game_Hero_a3"	"9 から 11"
"DOTA_Compendium_Predictions_Most_Deaths_Game_Hero_a4"	"12 から 14"
"DOTA_Compendium_Predictions_Most_Deaths_Game_Hero_a5"	"15 から 17"
"DOTA_Compendium_Predictions_Most_Deaths_Game_Hero_a6"	"18 から 20"
"DOTA_Compendium_Predictions_Most_Deaths_Game_Hero_a7"	"21+"
"DOTA_Compendium_Predictions_Most_Assists_Game_Hero_a1"	"0 から 15"
"DOTA_Compendium_Predictions_Most_Assists_Game_Hero_a2"	"16 から 19"
"DOTA_Compendium_Predictions_Most_Assists_Game_Hero_a3"	"20 から 23"
"DOTA_Compendium_Predictions_Most_Assists_Game_Hero_a4"	"24 から 27"
"DOTA_Compendium_Predictions_Most_Assists_Game_Hero_a5"	"28 から 31"
"DOTA_Compendium_Predictions_Most_Assists_Game_Hero_a6"	"32 から 35"
"DOTA_Compendium_Predictions_Most_Assists_Game_Hero_a7"	"36+"
"DOTA_Compendium_Predictions_Most_GPM_Game_Hero_a1"	"0 から 499"
"DOTA_Compendium_Predictions_Most_GPM_Game_Hero_a2"	"500 から 599"
"DOTA_Compendium_Predictions_Most_GPM_Game_Hero_a3"	"600 から 699"
"DOTA_Compendium_Predictions_Most_GPM_Game_Hero_a4"	"700 から 799"
"DOTA_Compendium_Predictions_Most_GPM_Game_Hero_a5"	"800 から 899"
"DOTA_Compendium_Predictions_Most_GPM_Game_Hero_a6"	"900 から 999"
"DOTA_Compendium_Predictions_Most_GPM_Game_Hero_a7"	"1000+"
"DOTA_Compendium_Predictions_Most_Picked_Hero"	"最も<b>ピックされた</b>ヒーロー"
"DOTA_Compendium_Predictions_Most_Banned_Hero"	"最も<b>禁止された</b>ヒーロー"
"dota_post_game_chat_header"	"チャット"
"dota_game_end_victory_title_dire"	"Dire の勝利"
"DOTA_ReturnToWeekendTourney"	"<< バトルカップ"
"dota_popup_report_player_comment_default"	"コメントを残す..."
"dota_settings_interface"	"インターフェース"
"DOTA_Armory_ContextMenu_PreviewBundle"	"バンドルをプレビュー"
"DOTA_Armory_ContextMenu_AddToCollection"	"コレクションに追加"
"DOTA_Armory_ContextMenu_RemoveFromCollection"	"コレクションから取り除く"
"dota_page_match_details_legend_mmr"	"MMR"
"DOTA_Workshop_BannerMarketingImage"	"チームバナー"
"DOTA_Workshop_SubmissionType_HeroItem"	"ヒーローアイテム..."
"DOTA_Workshop_SubmissionType_HeroItem_Desc"	"装着可能あるいはアビリティモデル - ヒーローのベースモデルに装着、あるいはスペルやアビリティ関連のモデルを置き換える。"
"DOTA_RecentArmoryItems_Title_RecentlyUnbundled"	"最近バンドルを開封"
"DOTA_EconItemSearchPrefix_Name"	"名前"
"DOTA_EconItemSearchPrefix_Description"	"説明"
"DOTA_EconItemSearchPrefix_HeroName"	"ヒーロー"
"DOTA_EconItemSearchPrefix_Rarity"	"希少性"
"DOTA_EconItemSearchPrefix_Keyword"	"キーワード"
"DOTA_EconItemSearchPrefix_Tool"	"ツール"
"DOTA_EconItemSearchPrefix_Event"	"イベント"
"DOTA_StoreItem_InTreasure"	"トレジャー内"
"DOTAArcanaVote_TooltipRoundName"	"{s:arcana_vote_round_name}"
"DOTAArcanaVote_TooltipHeroName0"	"{s:hero_0_name}"
"DOTAArcanaVote_TooltipHeroName1"	"{s:hero_1_name}"
"DOTAArcanaVote_RoundName"	"{s:arcana_vote_round_name}"
"DOTAArcanaVoteMatch_HeroName0"	"{s:hero_0_name}"
"DOTAArcanaVoteMatch_HeroName1"	"{s:hero_1_name}"
"DOTA_BattlePassLog_TitleBar_BattleLevel"	"レベル"
"FrontPage_TI6_Header"	"The International 2016 バトルパスが登場"
"FrontPage_TI6_Title"	"The International 2016 Compendium込み"
"FrontPage_TI6_Desc"	""
"DOTA_Compendium_SecondaryTabHeader_TI6ComingSoon"	"The International 2016"
"DOTA_Compendium_Predictions_Winning_Team"	"勝利するチームは？"
"DOTA_Compendium_Predictions_Final_Prize_Pool_a1"	"$15M 未満"
"DOTA_Compendium_Predictions_Final_Prize_Pool_a2"	"$15M - $16M"
"DOTA_Compendium_Predictions_Final_Prize_Pool_a3"	"$16M - $17M"
"DOTA_Compendium_Predictions_Final_Prize_Pool_a4"	"$17M - $18M"
"DOTA_Compendium_Predictions_Final_Prize_Pool_a5"	"$18M - $19M"
"DOTA_Compendium_Predictions_Final_Prize_Pool_a6"	"$19M - $20M"
"DOTA_Compendium_Predictions_Final_Prize_Pool_a7"	"$20M - $21M"
"DOTA_Compendium_Predictions_Final_Prize_Pool_a8"	"$21M - $22M"
"DOTA_Compendium_Predictions_Final_Prize_Pool_a9"	"$22M - $23M"
"DOTA_Compendium_Predictions_Final_Prize_Pool_a10"	"$23M - $24M"
"DOTA_Compendium_Predictions_Final_Prize_Pool_a11"	"$24M - $25M"
"DOTA_Compendium_Predictions_Final_Prize_Pool_a12"	"$26M - $27M"
"DOTA_Compendium_Predictions_Final_Prize_Pool_a13"	"$27M - $28M"
"DOTA_Compendium_Predictions_Final_Prize_Pool_a14"	"$29M - $30M"
"DOTA_Compendium_Predictions_Final_Prize_Pool_a15"	"$30M - $32M"
"DOTA_Compendium_Predictions_Final_Prize_Pool_a16"	"$32M - $36M"
"DOTA_Compendium_Predictions_Final_Prize_Pool_a17"	"$36M - $40M"
"DOTA_Compendium_Predictions_Final_Prize_Pool_a18"	"$40M 以上"
"DOTA_TI6_BattlePass_EndDate"	"The International 2016 バトルパスイベントは2016年8月31日に終了します"
"DOTA_TI6_BattlePass_Level1Rewards"	"レベル１リワード"
"DOTA_TI6_BattlePass_Level225Rewards"	"新しいクエストパスを解除"
"DOTA_TI6_BattlePass_BattlePointLog"	"バトルポイントログ"
"DOTA_TI6_BattlePass_PurchaseLevels"	"レベルを購入"
"DOTA_TI6_BattlePass_Gift"	"バトルパスをギフトする"
"DOTA_TI6_BattlePass_MyQuests"	"クエスト"
"DOTA_TI6_BattlePass_CommunityChallenges"	"コミュニティチャレンジ"
"DOTA_TI6_BattlePass_Friends"	"フレンド"
"DOTA_TI6_BattlePass_ArcanaVote"	"アルカナ投票"
"DOTA_TI6_BattlePass_ArcanaVoteNow"	"今すぐ投票"
"DOTA_TI6_BattlePass_ArcanaVoteStandings"	"現状を表示"
"DOTA_TI6_BattlePass_ArcanaVoteMostContested"	"最激戦"
"DOTA_TI6_BattlePass_QuestUpsell"	"クエストを選択するにはバトルパスが必要です"
"DOTA_TI6_BattlePass_QuestActivate"	"クエストのプレイにはバトルパスを有効化してください"
"DOTA_TI6_BattlePass_ArcanaUpsell"	"投票にはバトルパスが必要です"
"DOTA_TI6_BattlePass_ArcanaActivate"	"投票にはバトルパスの有効化が必要です"
"DOTA_TI6_BattlePass_RepeatingRewards_Title"	"繰り返しのリワード"
"DOTA_TI6_BattlePass_RepeatingRewards_Description"	"バトルパスのレベルを上げ続けると、10レベル上げる毎にイモータルとレジャーをひとつもらえます。"
"DOTA_BattlePassRewards_Prestige_TI6_Text"	"特別な利ワードは直接購入することはできません—手に入れる唯一の方法はバトルレベルを上げることです。"
"DOTA_HeroLoadout_BaseSet"	"デフォルト"
"DOTA_ActivateBattlePassLevels"	"バトルパスレベルの有効化"
"DOTA_ActivateLevels"	"レベルの有効化"
"DOTA_SaveForLater"	"とって置く"
"DOTA_CurrentLevel"	"現在のレベル"
"DOTA_AfterPurchase"	"購入後"
"DOTA_ActivateLevelsImmediately_Title"	"今すぐ自分のアカウント上で有効化する。"
"DOTA_ActivateLevelsImmediately_Description"	"レベルが有効化されて適用されると、バトルパススクリーンのメインページからリワードを入手できるようになります。"
"DOTA_SaveForLater_Title"	"とって置く。"
"DOTA_SaveForLater_Description"	"レベルは、保管庫内にアイテムとして保存されます。ここから、フレンドにギフトしたり後で自分のアカウントに適用したりすることができます。"
"DOTA_TotalLevels"	"合計レベル"
"DOTA_ApplyLevelsFailedMessage"	"レベルをアカウントに適用することができません。\n\nDota ゲームコーディネーターへの接続が失われたことが考えられます。レベルは保管庫にアイテムをして保存されますので、そこから手動で適用することもできますし、後ほど接続が元通りになると自動で適用されます。"
"dota_spring2016_purchase_basic_includes3"	"ベーシックバンドル内のアイテム全て"
"dota_spring2016_basic_bundle"	"ベーシックバンドル"
"dota_spring2016_mega_bundle"	"メガバンドル"
"dota_spring2016_purchase_basic_reward_treasure_1"	"イモータル トレジャー I"
"dota_spring2016_purchase_basic_reward_treasure_2"	"イモータル トレジャー II *"
"dota_spring2016_purchase_basic_reward_treasure_3"	"イモータル トレジャー III *"
"dota_spring2016_purchase_basic_reward_spring_terrain"	"季節の地形 - 春"
"dota_spring2016_purchase_bundle_reward_fountain"	"噴水の効果 I"
"dota_spring2016_purchase_bundle_reward_immortal_treasure_1_x5"	"イモータル トレジャー I x 4"
"DOTA_Compendium_Predictions_Final_Prize_Pool_a11a"	"$25M - $26M"
"DOTA_TI6_BattlePass_SilverTier"	"シルバーティアー"
"DOTA_TI6_BattlePass_GoldTier"	"ゴールドティアー"
"DOTA_Compendium_Predictions_Final_Prize_Pool_a13a"	"$28M - $29M"
"DOTA_TI6_BattlePass_ArcanaVoteCalibrating"	"十分な投票数があってから総投票数が表示されます。"
"DOTA_SplashAd_TI6_CollectorsCache_Exclusive_Header"	"エクスクルーシブ"
"DOTA_SplashAd_TI6_CollectorsCache_Community_Header"	"ヒーローデビュー"
"DOTA_TI6_CollectorsCache_FooterText"	"Cache アイテムはエクスクルーシブで、The International 後に購入することは出来ません。"
"DOTA_SplashAd_Immortal_Gardens_Level_Label"	"レベル"
"dota_page_post_game_player_level"	"プレイヤー レベル"
"DOTA_Popup_CardPack_ErrorUnknown"	"プレイヤーカードパック開封時に不明なエラーが発生しました。\n\n後でお試しください。"
"DOTA_Popup_CardPack_ErrorFailedToFindPack"	"開封しようとしているプレイヤーカードパックを見つけられませんでした。"
"DOTA_Popup_CardPack_ErrorNotCardPack"	"プレイヤーカードパックではないアイテムを開こうとしています。"
"DOTA_PlayerCardsBuyPackResultErrorTitle"	"プレイヤーカードパック購入時のエラー"
"DOTA_PlayerCardsBuyPackResultErrorUnknown"	"カードダストでプレイヤーカードを購入する際の不明なエラー。もう一度お試しください。"
"DOTA_PlayerCardsBuyPackResultErrorInsufficientDust"	"プレイヤーカードパックを購入するのに十分なカードダストがありません。"
"DOTA_PlayerCardsBuyPackResultErrorPackCreate"	"プレイヤーカードパックの作成に失敗しました。カードダストの消費はありません。"
"DOTA_Compendium_SecondaryTabHeader_TI6Predictions"	"予想"
"DOTA_Compendium_CN"	"中国"
"DOTA_Predictions_NA"	"アメリカ 地域予選通過"
"DOTA_Predictions_EU"	"ヨーロッパ 地域予選通過"
"DOTA_Predictions_CN"	"中国 地域予選通過"
"DOTA_Predictions_SEA"	"東南アジア 地域予選通過"
"DOTA_Compendium_Predictions_First_NA_Team"	"優勝"
"DOTA_Compendium_Predictions_First_EU_Team"	"優勝"
"DOTA_Compendium_Predictions_First_CN_Team"	"優勝"
"DOTA_Compendium_Predictions_First_SEA_Team"	"優勝"
"DOTA_Compendium_Predictions_Second_NA_Team"	"準優勝"
"DOTA_Compendium_Predictions_Second_EU_Team"	"準優勝"
"DOTA_Compendium_Predictions_Second_CN_Team"	"準優勝"
"DOTA_Compendium_Predictions_Second_SEA_Team"	"準優勝"
"DOTA_Compendium_Predictions_Third_NA_Team"	"ワイルドカード"
"DOTA_Compendium_Predictions_Third_EU_Team"	"ワイルドカード"
"DOTA_Compendium_Predictions_Third_CN_Team"	"ワイルドカード"
"DOTA_Compendium_Predictions_Third_SEA_Team"	"ワイルドカード"
"DOTA_Compendium_Predictions_Second_Qualifier"	"予選通過チーム #2"
"DOTA_Compendium_Predictions_Denies_First_Player_To_Reach"	"最初のプレイヤーが15ディナイ獲得。"
"DOTA_Compendium_Predictions_Least_Deaths_Player"	"最も死亡回数が少ないプレイヤー。"
"DOTA_Compendium_Predictions_Total_Kill_Count_a1"	"0 から 25"
"DOTA_Compendium_Predictions_Total_Kill_Count_a2"	"26 から 40"
"DOTA_Compendium_Predictions_Total_Kill_Count_a3"	"41 から 55"
"DOTA_Compendium_Predictions_Total_Kill_Count_a4"	"56+"
"DOTA_Compendium_Predictions_TotalKillsByTimeEarly_a1"	"0-5"
"DOTA_Compendium_Predictions_TotalKillsByTimeEarly_a2"	"6-10"
"DOTA_Compendium_Predictions_TotalKillsByTimeEarly_a3"	"11-15"
"DOTA_Compendium_Predictions_TotalKillsByTimeEarly_a4"	"16+"
"DOTA_Compendium_Predictions_TotalKillsByTimeMid_a1"	"0-15"
"DOTA_Compendium_Predictions_TotalKillsByTimeMid_a2"	"16-25"
"DOTA_Compendium_Predictions_TotalKillsByTimeMid_a3"	"26-35"
"DOTA_Compendium_Predictions_TotalKillsByTimeMid_a4"	"36+"
"DOTA_Compendium_Predictions_TotalSmokeGankKillsByTimeEarly_a1"	"0"
"DOTA_Compendium_Predictions_TotalSmokeGankKillsByTimeEarly_a2"	"1"
"DOTA_Compendium_Predictions_TotalSmokeGankKillsByTimeEarly_a3"	"2"
"DOTA_Compendium_Predictions_TotalSmokeGankKillsByTimeEarly_a4"	"3+"
"DOTA_Compendium_Predictions_TotalSmokeGankKillsByTimeMid_a1"	"0-2"
"DOTA_Compendium_Predictions_TotalSmokeGankKillsByTimeMid_a2"	"3-5"
"DOTA_Compendium_Predictions_TotalSmokeGankKillsByTimeMid_a3"	"6-8"
"DOTA_Compendium_Predictions_TotalSmokeGankKillsByTimeMid_a4"	"9+"
"DOTA_Compendium_Predictions_TotalSmokeGankKillsByTimeEnd_a1"	"0-4"
"DOTA_Compendium_Predictions_TotalSmokeGankKillsByTimeEnd_a2"	"5-8"
"DOTA_Compendium_Predictions_TotalSmokeGankKillsByTimeEnd_a3"	"9-12"
"DOTA_Compendium_Predictions_TotalSmokeGankKillsByTimeEnd_a4"	"13+"
"DOTA_Compendium_Predictions_Tiny_Combo_Count_a1"	"0 から 6"
"DOTA_Compendium_Predictions_Tiny_Combo_Count_a2"	"7 から 12"
"DOTA_Compendium_Predictions_Tiny_Combo_Count_a3"	"13 から 18"
"DOTA_Compendium_Predictions_Tiny_Combo_Count_a4"	"19+"
"DOTA_Compendium_Predictions_CourierSnipe"	"クーリエスナイプは起こる？"
"DOTA_Compendium_Predictions_RoshanKillCount"	"Roshan キルの合計回数"
"DOTA_Compendium_Predictions_RoshanKillCount_a1"	"0 から 2"
"DOTA_Compendium_Predictions_RoshanKillCount_a2"	"3"
"DOTA_Compendium_Predictions_RoshanKillCount_a3"	"4"
"DOTA_Compendium_Predictions_RoshanKillCount_a4"	"5+"
"DOTA_Compendium_Predictions_TowerDeny"	"タワーはディナイされるか？"
"DOTA_Compendium_Predictions_TowersKilledAtTime_a1"	"0-5"
"DOTA_Compendium_Predictions_TowersKilledAtTime_a2"	"6-10"
"DOTA_Compendium_Predictions_TowersKilledAtTime_a3"	"11-15"
"DOTA_Compendium_Predictions_TowersKilledAtTime_a4"	"16+"
"DOTA_Compendium_Predictions_Last_Death_Player"	"最後のプレイやーが倒されるまで。"
"DOTA_Compendium_Predictions_AegisSnatch"	"Aegis スナッチは起こる？"
"DOTA_Compendium_Predictions_FirstBloodBeforeTime"	"ファーストブラッドはいつ？"
"DOTA_Compendium_Predictions_FirstBloodBeforeTime_a1"	"0-3 分"
"DOTA_Compendium_Predictions_FirstBloodBeforeTime_a2"	"3-6 分"
"DOTA_Compendium_Predictions_FirstBloodBeforeTime_a3"	"6-9 分"
"DOTA_Compendium_Predictions_FirstBloodBeforeTime_a4"	"9+ 分"
"DOTA_Compendium_Predictions_HighestTotalDamageByATeam_a1"	"0-50,000 dmg"
"DOTA_Compendium_Predictions_HighestTotalDamageByATeam_a2"	"50,001-100,000 dmg"
"DOTA_Compendium_Predictions_HighestTotalDamageByATeam_a3"	"100,001+ dmg"
"DOTA_Compendium_Predictions_TotalWardsPlaced_a1"	"0-20"
"DOTA_Compendium_Predictions_TotalWardsPlaced_a2"	"21-27"
"DOTA_Compendium_Predictions_TotalWardsPlaced_a3"	"28-34"
"DOTA_Compendium_Predictions_TotalWardsPlaced_a4"	"35+"
"DOTA_Compendium_Predictions_HighestPhysicalAttack_a1"	"0-500"
"DOTA_Compendium_Predictions_HighestPhysicalAttack_a2"	"501-750"
"DOTA_Compendium_Predictions_HighestPhysicalAttack_a3"	"751-1,000"
"DOTA_Compendium_Predictions_HighestPhysicalAttack_a4"	"1,001+"
"DOTA_Compendium_Predictions_FirstTowerKillTime_a1"	"5:00 より前"
"DOTA_Compendium_Predictions_FirstTowerKillTime_a2"	"5:01-8:00"
"DOTA_Compendium_Predictions_FirstTowerKillTime_a3"	"8:01-11:00"
"DOTA_Compendium_Predictions_FirstTowerKillTime_a4"	"11:01-14:00"
"DOTA_Compendium_Predictions_FirstTowerKillTime_a5"	"14:00+"
"DOTA_Compendium_Predictions_FirstBarracksKillTime_a1"	"20:00 より前"
"DOTA_Compendium_Predictions_FirstBarracksKillTime_a2"	"20:01-30:00"
"DOTA_Compendium_Predictions_FirstBarracksKillTime_a3"	"30:01-40:00"
"DOTA_Compendium_Predictions_FirstBarracksKillTime_a4"	"40:01+"
"DOTA_Compendium_Predictions_GameDuration"	"試合時間はどれくらい？"
"DOTA_Compendium_Predictions_GameDuration_a1"	"30:00 より短い"
"DOTA_Compendium_Predictions_GameDuration_a2"	"30:01-37:00"
"DOTA_Compendium_Predictions_GameDuration_a3"	"37:01-44:00"
"DOTA_Compendium_Predictions_GameDuration_a4"	"44:01-60:00"
"DOTA_Compendium_Predictions_GameDuration_a5"	"60:01+"
"DOTA_Compendium_Predictions_AncientCampsStackedByTime_a1"	"0-5"
"DOTA_Compendium_Predictions_AncientCampsStackedByTime_a2"	"6-10"
"DOTA_Compendium_Predictions_AncientCampsStackedByTime_a3"	"11-15"
"DOTA_Compendium_Predictions_AncientCampsStackedByTime_a4"	"16-20"
"DOTA_Compendium_Predictions_AncientCampsStackedByTime_a5"	"21+"
"DOTA_Compendium_Predictions_TPCancelledByTimeMid_a1"	"0"
"DOTA_Compendium_Predictions_TPCancelledByTimeMid_a2"	"1"
"DOTA_Compendium_Predictions_TPCancelledByTimeMid_a3"	"2"
"DOTA_Compendium_Predictions_TPCancelledByTimeMid_a4"	"3+"
"DOTA_Compendium_Predictions_BlinkDaggersByTimeMid_a1"	"0-2"
"DOTA_Compendium_Predictions_BlinkDaggersByTimeMid_a2"	"3-4"
"DOTA_Compendium_Predictions_BlinkDaggersByTimeMid_a3"	"5+"
"DOTA_SplashAd_TI6_Immortals_2_Title"	"イモータル トレジャー II"
"DOTA_SplashAd_TI6_Immortals_2_Available"	"登場"
"DOTA_SplashAd_TI6_Immortals_2_Escalating"	"このトレジャーは確率アップを採用"
"DOTA_PlayerCardsOpenPack"	"プレイヤーカードパックを開封"
"DOTA_FantasyHelpTitle1"	"プレイヤーカードパックを開封"
"DOTA_FantasyHelpDetailsSub2Text1"	"プレイヤーカードパックには5枚のカードが入っています。（シルバーあるいはゴールドカードが一枚含まれます）"
"DOTA_Compendium_SecondaryTabHeader_TI6Bracket"	"組み合わせ"
"DOTA_Compendium_PredictionsStartIn"	"予想開始まで"
"DOTA_Compendium_Predictions_TreeCutCountByTimeMid_a1"	"0-50"
"DOTA_Compendium_Predictions_TreeCutCountByTimeMid_a2"	"51-175"
"DOTA_Compendium_Predictions_TreeCutCountByTimeMid_a3"	"176-300"
"DOTA_Compendium_Predictions_TreeCutCountByTimeMid_a4"	"301+"
"DOTA_SplashAd_LegionCommander_Level_Label"	"レベル"
"DOTA_Compendium_SecondaryTabHeader_TI6Casters"	"キャスター"
"DOTA_SplashAd_TI6_Immortals_3_Title"	"イモータル トレジャー III"
"DOTA_SplashAd_TI6_Immortals_3_Available"	"登場"
"DOTA_SplashAd_TI6_Immortals_3_Escalating"	"このトレジャーは確率アップを採用"
"DOTA_FantasyHelpDetailsSub4"	"プレイヤーカードパック"
"DOTA_Compendium_Predictions_Games_In_Tournament_b1"	"41 から 47"
"DOTA_Compendium_Predictions_Games_In_Tournament_b2"	"48 から 50"
"DOTA_Compendium_Predictions_Games_In_Tournament_b3"	"51 から 53"
"DOTA_Compendium_Predictions_Games_In_Tournament_b4"	"54 から 60"
"DOTA_TI6_BattlePass_EndDate_Purchase"	"バトルパスレベルの購入可能最終日は2016年8月13日です"
"dota_post_game_radiant_victory"	"Radiant の勝利"
"dota_post_game_dire_victory"	"Dire の勝利"
"dota_post_game_radiant_team_name_victory"	"{s:radiant_team_name} の勝利"
"dota_post_game_radiant_team_name"	"{s:radiant_team_name}"
"dota_post_game_dire_team_name_victory"	"{s:dire_team_name} の勝利"
"dota_post_game_dire_team_name"	"{s:dire_team_name}"
"dota_post_game_stats_kills"	"キル数:"
"dota_post_game_stats_xpm"	"XPM:"
"dota_post_game_stats_gpm"	"GPM:"
"dota_post_game_stats_deaths"	"死亡数:"
"dota_post_game_stats_assists"	"アシスト数:"
"dota_post_game_bot"	"ボット"
"dota_post_game_stats_bot_difficulty_passive"	"ボット難易度: パッシブ"
"dota_post_game_stats_bot_difficulty_easy"	"ボット難易度: イージー"
"dota_post_game_stats_bot_difficulty_medium"	"ボット難易度: ミディアム"
"dota_post_game_stats_bot_difficulty_hard"	"ボット難易度: ハード"
"dota_post_game_stats_bot_difficulty_unfair"	"ボット難易度: アンフェア"
"DOTA_RecentGame_Replay"	"リプレイ"
"DOTA_HeroSelector_ClearFilters_Button"	"クリア"
"DOTA_HeroComplexity"	"複雑性"
"DOTA_Home_Fall_BattlePass_NotOwned"	"Fall 2016 バトルパス登場"
"FrontPage_Fall_2016_BattlePass_Desc"	"クエスト、トレジャー、そしてリワードが満載の Fall 2016 バトルパスを Dota 2016 秋のお供に。"
"DOTA_DB_SeasonPass_fall2016_Prestige_Rewards_Colleseum"	"季節の地形: 秋<br><font color='#888888'>レベル </font><font color='#96C68C'>1</font>"
"DOTA_GameItems_AvailableAtMainShop"	"ホームショップで購入可能"
"DOTA_GameItems_AvailableAtSideShop"	"サイドショップで購入可能"
"DOTA_GameItems_AvailableAtSecretShop"	"シークレットショップで購入可能"
"DOTA_Compendium_SecondaryTabHeader_RegionalPredictions"	"地域予選 予想"
"DOTA_Treasure_ViewTreasure"	"トレジャーを見る"
"FrontPage_Fall_2016_Treasure2_Desc"	"バトルパス所有者は、バトルレベルリワードで獲得あるいはDota 2 ストアで購入可能になりました。中には、Lion, Silencer, Storm Spirit, Dark Seer, Treant Protector のセットが入っています。Spirit Breaker 用のベリーレアアイテムセットと、クリティカルアタックアニメーションを含んだエクストリームリーレアな Juggernaut アイテムセットをアンロックする確率アップも。"
"DOTA_XboxDVR_Fix"	"おつかいのコンピュータでは Xbox Game DVR が有効化されています。これらの機能は、ゲーム内で FPS 低下や、クラッシュ、フリーズなどの問題の原因となることが報告されています。\n\nこれらの機能を無効化したいですか？"
"DOTA_DVRDisabled_Title"	"変更が適用されました"
"DOTA_DVRDisabled_Msg"	"次のシステム再起動の後に有効化されます。"
"DOTA_HeroLoadout_AvailableItems"	"使用可能"
"DOTA_HeroLoadout_ViewOnStore"	"(ストアで表示)"
"DOTA_HeroCard_Suggested"	"おすすめ"
"DOTA_HeroCard_AllHeroChallenge"	"全ヒーローチャレンジ"
"DOTA_HeroCard_DailyQuest"	"デイリークエスト"
"DOTA_Hud_Paused"	"ゲーム  一時停止中"
"DOTA_Compendium_RegionalQualifiers"	"地域予選通過"
"DOTA_HeroLoadout_UnknownSet"	"セットをカスタマイズ"
"DOTA_HeroLoadout_FullSets"	"フルセット"
"DOTA_HUD_UpgradeCourier"	"クーリエをアップグレード"
"DOTA_HeroInspect_PickDescription"	"ヒーローを選択"
"DOTA_StatBranch_TooltipTitle"	"タレントツリー"
"DOTA_HUD_QuickStats_K"	"K:"
"DOTA_HUD_QuickStats_D"	"D:"
"DOTA_HUD_QuickStats_A"	"A:"
"DOTA_HUD_QuickStats_KDA"	"K / D / A "
"DOTA_HUD_QuickStats_CS"	"CS"
"DOTA_HUD_QuickStats_LastHitAbbr"	"LH:"
"DOTA_HUD_QuickStats_DenyAbbr"	"D:"
"DOTA_HUD_Attack"	"攻撃"
"DOTA_HUD_Damage"	"ダメージ:"
"DOTA_HUD_SpellAmp"	"魔法増幅:"
"DOTA_HUD_Defense"	"ディフェンス"
"DOTA_HUD_Armor"	"アーマー:"
"DOTA_HUD_PhysicalResist"	"物理的耐性:"
"DOTA_HUD_MagicResist"	"魔法耐性:"
"DOTA_HUD_Evasion"	"回避:"
"DOTA_HUD_StrengthGain"	" (レベル毎に {s:strength_per_level} 獲得)"
"DOTA_HUD_AgilityGain"	" (レベル毎に {s:agility_per_level} 獲得)"
"DOTA_HUD_IntelligenceGain"	" (レベル毎に {s:intelligence_per_level} 獲得)"
"DOTA_HUD_PrimaryAttributeDamage"	"= {d:primary_attribute_damage} ダメージ (基本属性)"
"DOTA_HUD_StrengthDetails"	"= {d:strength_hp} HP と {s:strength_hp_regen} HP 自然回復"
"DOTA_HUD_AgilityDetails"	"= {s:agility_armor} アーマー と {d:agility_attack_speed} 攻撃速度"
"DOTA_HUD_IntelligenceDetails"	"= {d:intelligence_mana} マナ、 {s:intelligence_mana_regen} マナ自然回復 と {s:intelligence_spell_amp}% 魔法増幅"
"DOTA_HUD_AttackSpeed"	"攻撃速度:"
"DOTA_HUD_AttackRange"	"攻撃範囲:"
"DOTA_HUD_DeathTime"	"死亡時間: {d:death_time}"
"dota_post_game_dark_moon_legend_kills"	"キル数"
"dota_post_game_dark_moon_legend_deaths"	"死亡数"
"dota_post_game_dark_moon_legend_saves"	"セーブ"
"dota_post_game_dark_moon_legend_bags"	"バッグ"
"dota_post_game_dark_moon_legend_heals"	"治癒"
"DOTA_SeasonPass_Winter_Treasure1"	"Winter 2017 トレジャー I"
"DOTA_SeasonPass_Winter_Treasure2"	"Winter 2017 トレジャー II"
"DOTA_SeasonPass_Winter_Treasure3"	"Winter 2017 トレジャー III"
"FrontPage_Winter_2017_Treasure2_Name"	"Winter 2017 トレジャー 2"
"FrontPage_Winter_2017_Treasure2_Desc"	"バトルパス所有者は、バトルレベルリワードで獲得あるいはDota 2 ストアで購入可能になりました。中には、Silencer, Lifestealer, Underlord, Lina, Death Prophet, Broodmother, Batrider, Keeper of the Light のセットが入っています。Sniper 用のベリーレアアイテムセットと、エクストリームリーレアな Disruptor アイテムセットをアンロックする確率アップも。"
"FrontPage_Winter_2017_Treasure2_Title"	"Winter 2017 トレジャー II"
}
