"lang"
{
"Language"	"portuguese"
"Tokens"
{
"addon_game_name"	"Underhollow"
"[english]addon_game_name"	"The Underhollow"
"cavern_game_info_header_how_to_play"	"COMO JOGAR:"
"[english]cavern_game_info_header_how_to_play"	"HOW TO PLAY:"
"cavern_game_info_brief_description"	"A tua equipa tem de lutar para ser a última sobrevivente! Explora salas para encontrares tesouros e ficares forte o suficiente para derrotares inimigos. Vence a partida, encontra queijos ou elimina a oposição para ganhares Pontos de Batalha."
"[english]cavern_game_info_brief_description"	"Battle to be the last team standing! Clear rooms to find treasures and build up your power—then use that power to destroy your opponents. Win the game, find rare and valuable cheeses, or eliminate opposing players to earn Battle Points."
"cavern_game_info_encounters_header"	"Dificuldade"
"[english]cavern_game_info_encounters_header"	"Room Difficulty"
"cavern_game_info_encounters"	"As salas mais próximas do centro do labirinto são mais difíceis."
"[english]cavern_game_info_encounters"	"Rooms closer to the center of the Underhollow are more challenging."
"cavern_game_info_roshan_header"	"Roshan"
"[english]cavern_game_info_roshan_header"	"Roshan"
"cavern_game_info_roshan"	"O Roshan destrói um anel de salas de 5 em 5 minutos, começando pelo anel exterior."
"[english]cavern_game_info_roshan"	"Roshan destroys a ring of rooms every six minutes, starting with the easier outer ring."
"cavern_game_info_tombstone_header"	"Lápides"
"[english]cavern_game_info_tombstone_header"	"Tombstones"
"cavern_game_info_tombstone"	"Interage com as lápides para ressuscitares aliados ou eliminares inimigos."
"[english]cavern_game_info_tombstone"	"Tombstones can be used to revive teammates or eliminate enemies."
"cavern_game_info_special_items"	"Itens especiais"
"[english]cavern_game_info_special_items"	"Special Items"
"cavern_game_info_roshefort_header"	"Itens especiais"
"[english]cavern_game_info_roshefort_header"	"Special Items"
"cavern_game_info_roshefort"	"Usa Dinamite para rebentares com obstáculos (ou inimigos), ou usa a Poção de Fuga para te escapares sem ser visto."
"[english]cavern_game_info_roshefort"	"Blast through obstacles—or enemies—with Dynamite, or slip away unseen with the Escape Potion."
"DOTA_Underhollow_Defeated"	"A tua equipa foi eliminada!"
"[english]DOTA_Underhollow_Defeated"	"Your team was eliminated!"
"DOTA_Underhollow_FinishPosition"	"A equipa ficou em {s:finish_position}"
"[english]DOTA_Underhollow_FinishPosition"	"You finished in {s:finish_position}"
"DOTA_Underhollow_PlayAgain"	"JOGAR DE NOVO"
"[english]DOTA_Underhollow_PlayAgain"	"PLAY AGAIN"
"DOTA_Underhollow_Disconnect"	"SAIR"
"[english]DOTA_Underhollow_Disconnect"	"DISCONNECT"
"DOTA_Underhollow_TotalEarnedPoints"	"TOTAL DE PONTOS:"
"[english]DOTA_Underhollow_TotalEarnedPoints"	"TOTAL POINTS EARNED:"
"DOTA_Underhollow_PointsAvaiable"	"OS PONTOS SÃO DADOS APÓS A PARTIDA ACABAR"
"[english]DOTA_Underhollow_PointsAvaiable"	"POINTS WILL BE AWARDED WHEN GAME FINISHES"
"DOTA_Underhollow_Elimination_RewardAmount"	"30 PB"
"[english]DOTA_Underhollow_Elimination_RewardAmount"	"30 BP"
"DOTA_Underhollow_SmallCheeses_RewardAmount"	"20 PB"
"[english]DOTA_Underhollow_SmallCheeses_RewardAmount"	"20 BP"
"DOTA_Underhollow_BigCheeses_RewardAmount"	"300 PB"
"[english]DOTA_Underhollow_BigCheeses_RewardAmount"	"300 BP"
"DOTA_Underhollow_Points_X"	"{d:num_earned} x "
"[english]DOTA_Underhollow_Points_X"	"{d:num_earned} X "
"DOTA_Tooltip_Ability_item_cavern_bag_of_gold"	"Saco de Ouro"
"[english]DOTA_Tooltip_Ability_item_cavern_bag_of_gold"	"Bag of Gold"
"DOTA_Tooltip_Ability_item_big_cheese_cavern"	"Queijo Roshefort"
"[english]DOTA_Tooltip_Ability_item_big_cheese_cavern"	"Roshefort Cheese"
"DOTA_Tooltip_modifier_item_big_cheese_cavern_effect"	"Queijo Roshefort"
"[english]DOTA_Tooltip_modifier_item_big_cheese_cavern_effect"	"Roshefort Cheese"
"DOTA_Tooltip_Ability_item_health_potion"	"Poção de Vida"
"[english]DOTA_Tooltip_Ability_item_health_potion"	"Health Potion"
"DOTA_Tooltip_Ability_item_mana_potion"	"Poção de Mana"
"[english]DOTA_Tooltip_Ability_item_mana_potion"	"Mana Potion"
"DOTA_Tooltip_ability_item_book_of_strength"	"Livro da Força"
"[english]DOTA_Tooltip_ability_item_book_of_strength"	"Book of Strength"
"DOTA_Tooltip_ability_item_book_of_strength_Description"	"Ao ser consumido, este item concede um bónus permanente de 3 pontos de Força."
"[english]DOTA_Tooltip_ability_item_book_of_strength_Description"	"Consume to gain 3 Strength permanently."
"DOTA_Tooltip_ability_item_book_of_agility"	"Livro da Agilidade"
"[english]DOTA_Tooltip_ability_item_book_of_agility"	"Book of Agility"
"DOTA_Tooltip_ability_item_book_of_agility_Description"	"Ao ser consumido, este item concede um bónus permanente de 3 pontos de Agilidade."
"[english]DOTA_Tooltip_ability_item_book_of_agility_Description"	"Consume to gain 3 Agility permanently."
"DOTA_Tooltip_ability_item_book_of_intelligence"	"Livro da Inteligência"
"[english]DOTA_Tooltip_ability_item_book_of_intelligence"	"Book of Intelligence"
"DOTA_Tooltip_ability_item_book_of_intelligence_Description"	"Ao ser consumido, este item concede um bónus permanente de 3 pontos de Inteligência."
"[english]DOTA_Tooltip_ability_item_book_of_intelligence_Description"	"Consume to gain 3 Intelligence permanently."
"DOTA_Tooltip_modifier_book_of_strength"	"Livro da Força"
"[english]DOTA_Tooltip_modifier_book_of_strength"	"Book of Strength"
"DOTA_Tooltip_modifier_book_of_strength_Description"	"Força obtida com o consumo de livros."
"[english]DOTA_Tooltip_modifier_book_of_strength_Description"	"Strength gained from consumed Books."
"DOTA_Tooltip_modifier_book_of_agility"	"Livro da Agilidade"
"[english]DOTA_Tooltip_modifier_book_of_agility"	"Book of Agility"
"DOTA_Tooltip_modifier_book_of_agility_Description"	"Agilidade obtida com o consumo de livros."
"[english]DOTA_Tooltip_modifier_book_of_agility_Description"	"Agility gained from consumed Books."
"DOTA_Tooltip_modifier_book_of_intelligence"	"Livro da Inteligência"
"[english]DOTA_Tooltip_modifier_book_of_intelligence"	"Book of Intelligence"
"DOTA_Tooltip_modifier_book_of_intelligence_Description"	"Inteligência obtida com o consumo de livros."
"[english]DOTA_Tooltip_modifier_book_of_intelligence_Description"	"Intelligence gained from consumed Books."
"npc_dota_crate"	"Caixote"
"[english]npc_dota_crate"	"Crate"
"npc_treasure_chest"	"Arca de Tesouro"
"[english]npc_treasure_chest"	"Treasure Chest"
"npc_dota_pendulum_trap"	"Lâmina de pêndulo"
"[english]npc_dota_pendulum_trap"	"Pendulum Blade"
"npc_dota_cavern_gate_destructible_tier1"	"Portão tipo 1"
"[english]npc_dota_cavern_gate_destructible_tier1"	"Tier 1 Gate"
"npc_dota_cavern_gate_destructible_tier1_anim"	"Portão tipo 1 (Animação)"
"[english]npc_dota_cavern_gate_destructible_tier1_anim"	"Tier 1 Gate Animating"
"npc_dota_cavern_gate_destructible_tier2"	"Portão tipo 2"
"[english]npc_dota_cavern_gate_destructible_tier2"	"Tier 2 Gate"
"npc_dota_cavern_gate_destructible_tier2_anim"	"Portão tipo 2 (Animação)"
"[english]npc_dota_cavern_gate_destructible_tier2_anim"	"Tier 2 Gate Animating"
"npc_dota_cavern_gate_destructible_tier3"	"Portão tipo 3"
"[english]npc_dota_cavern_gate_destructible_tier3"	"Tier 3 Gate"
"npc_dota_cavern_gate_destructible_tier3_anim"	"Portão tipo 3 (Animação)"
"[english]npc_dota_cavern_gate_destructible_tier3_anim"	"Tier 3 Gate Animating"
"npc_dota_splitter_1"	"Rachador Grande"
"[english]npc_dota_splitter_1"	"Large Splitter"
"npc_dota_splitter_2"	"Rachador Médio"
"[english]npc_dota_splitter_2"	"Medium Splitter"
"npc_dota_splitter_3"	"Rachador Pequeno"
"[english]npc_dota_splitter_3"	"Small Splitter"
"npc_dota_cavern_roshan"	"Roshan"
"[english]npc_dota_cavern_roshan"	"Roshan"
"npc_dota_cavern_life_stealer"	"Ameaça Aprisionada"
"[english]npc_dota_cavern_life_stealer"	"Caged Menace"
"npc_dota_ranged_creep_linear"	"Feiticeiro Deformado"
"[english]npc_dota_ranged_creep_linear"	"Deformed Wizard"
"npc_dota_creature_techies_land_mine"	"Mina Terrestre"
"[english]npc_dota_creature_techies_land_mine"	"Land Mine"
"npc_dota_minimage"	"Mini-Mago"
"[english]npc_dota_minimage"	"Mini-Mage"
"trap_sun_strike"	"Raio Solar"
"[english]trap_sun_strike"	"Sun Strike"
"npc_dota_creature_pugna"	"Mestre do Oblívio"
"[english]npc_dota_creature_pugna"	"Lord Of Oblivion"
"npc_dota_creature_earthshaker"	"Protetor da Montanha Vermelha"
"[english]npc_dota_creature_earthshaker"	"Protector of the Red Mountain"
"npc_dota_creature_pudge"	"Pudge"
"[english]npc_dota_creature_pudge"	"Pudge"
"npc_dota_creature_juggernaut"	"Juggernaut"
"[english]npc_dota_creature_juggernaut"	"Juggernaut"
"npc_dota_creature_basic_zombie"	"Zombie"
"[english]npc_dota_creature_basic_zombie"	"Zombie"
"npc_dota_creature_troll_berserker"	"Troll"
"[english]npc_dota_creature_troll_berserker"	"Troll"
"npc_dota_creature_troll_camp1"	"Acampamento de Trolls"
"[english]npc_dota_creature_troll_camp1"	"Troll Camp"
"npc_dota_creature_ghost"	"Fantasma"
"[english]npc_dota_creature_ghost"	"Ghost"
"npc_dota_statue_bounty_hunter"	"Estátua de Gondar"
"[english]npc_dota_statue_bounty_hunter"	"Statue of Gondar"
"npc_dota_statue_beastmaster"	"Estátua de Karroch"
"[english]npc_dota_statue_beastmaster"	"Statue of Karroch"
"npc_dota_creature_armed_dynamite"	"Dinamite"
"[english]npc_dota_creature_armed_dynamite"	"Stick o' Dynamite"
"npc_dota_creature_shadow_shaman_ward"	"Serpente Invocada"
"[english]npc_dota_creature_shadow_shaman_ward"	"Summoned Serpent"
"npc_dota_friendly_hawk"	"Falcão"
"[english]npc_dota_friendly_hawk"	"Hawk Companion"
"npc_dota_friendly_boar"	"Javali"
"[english]npc_dota_friendly_boar"	"Boar Companion"
"npc_dota_creature_small_pangoballer"	"Pangolinho"
"[english]npc_dota_creature_small_pangoballer"	"Little Pango"
"npc_dota_creature_large_pangoballer"	"Pangobola"
"[english]npc_dota_creature_large_pangoballer"	"Pangoballer"
"npc_dota_neutral_forest_troll_berserker_cavern"	"Troll"
"[english]npc_dota_neutral_forest_troll_berserker_cavern"	"Troll"
"npc_dota_creature_ogre_tank"	"Ogre Esmagador"
"[english]npc_dota_creature_ogre_tank"	"Ogre Smasher"
"npc_dota_creature_sniper"	"Sniper Maluco"
"[english]npc_dota_creature_sniper"	"Crazed Sniper"
"npc_dota_creature_enigma"	"O Vazio"
"[english]npc_dota_creature_enigma"	"The Void"
"npc_dota_creature_viper"	"Viperzinho"
"[english]npc_dota_creature_viper"	"Viperling"
"npc_dota_creature_big_viper"	"Netherdrake"
"[english]npc_dota_creature_big_viper"	"Netherdrake"
"npc_dota_creature_invoker"	"Carlinhos"
"[english]npc_dota_creature_invoker"	"A Tiny Carl"
"npc_dota_creature_wraith_king"	"Cavaleiro de Ostarion"
"[english]npc_dota_creature_wraith_king"	"Knight of Ostarion"
"npc_dota_creature_lycan"	"Licantropo"
"[english]npc_dota_creature_lycan"	"Lycanthrope"
"npc_dota_creature_small_omni"	"Omniminiknight"
"[english]npc_dota_creature_small_omni"	"Omniminiknight"
"npc_dota_creature_small_eimermole"	"Toupeira Trabalhadora"
"[english]npc_dota_creature_small_eimermole"	"Eimermole Worker"
"npc_dota_creature_large_eimermole"	"Mestre de Obras das Toupeiras"
"[english]npc_dota_creature_large_eimermole"	"Eimermole Taskmaster"
"npc_dota_creature_dark_willow"	"Fada Anciã"
"[english]npc_dota_creature_dark_willow"	"Elder Fae"
"npc_dota_creature_night_stalker"	"Stalker"
"[english]npc_dota_creature_night_stalker"	"Stalker"
"npc_dota_creature_lich"	"Ancião do Gelo"
"[english]npc_dota_creature_lich"	"Ol' Frosty One"
"DOTA_TEAM_CUSTOM_1"	"Rosa"
"[english]DOTA_TEAM_CUSTOM_1"	"Pink"
"DOTA_TEAM_CUSTOM_2"	"Laranja"
"[english]DOTA_TEAM_CUSTOM_2"	"Orange"
"DOTA_TEAM_CUSTOM_3"	"Azul"
"[english]DOTA_TEAM_CUSTOM_3"	"Blue"
"DOTA_TEAM_CUSTOM_4"	"Verde"
"[english]DOTA_TEAM_CUSTOM_4"	"Green"
"DOTA_TEAM_CUSTOM_5"	"Castanho"
"[english]DOTA_TEAM_CUSTOM_5"	"Brown"
"DOTA_TEAM_CUSTOM_6"	"Ciano"
"[english]DOTA_TEAM_CUSTOM_6"	"Cyan"
"DOTA_TEAM_CUSTOM_7"	"Azeitona"
"[english]DOTA_TEAM_CUSTOM_7"	"Olive"
"DOTA_TEAM_CUSTOM_8"	"Roxo"
"[english]DOTA_TEAM_CUSTOM_8"	"Purple"
"DOTA_Tooltip_ability_item_tombstone"	"Ressuscitar aliado"
"[english]DOTA_Tooltip_ability_item_tombstone"	"Resurrect Teammate"
"DOTA_Tooltip_ForEnemy_ability_item_tombstone"	"Eliminar jogador"
"[english]DOTA_Tooltip_ForEnemy_ability_item_tombstone"	"Eliminate Player"
"DOTA_Tooltip_Ability_item_tome_of_knowledge_cavern"	"Livro da Experiência"
"[english]DOTA_Tooltip_Ability_item_tome_of_knowledge_cavern"	"Experience Tome"
"DOTA_Chat_Tombstone_Pinged"	"Aliado morto aqui."
"[english]DOTA_Chat_Tombstone_Pinged"	"Fallen teammate here."
"DOTA_Tooltip_Ability_item_cavern_dynamite"	"Dinamite"
"[english]DOTA_Tooltip_Ability_item_cavern_dynamite"	"Stick o' Dynamite"
"DOTA_Tooltip_Ability_item_cavern_dynamite_Description"	"Este item detona-se após 4 segundos, causando 1000 de dano físico. Pode ser usado para remover paredes de pedra destrutíveis."
"[english]DOTA_Tooltip_Ability_item_cavern_dynamite_Description"	"Detonates after 4 seconds, dealing 1000 physical damage. Can be used to remove destructible walls and rock walls."
"DOTA_Tooltip_Ability_item_deployable_shop"	"Loja de Bolso"
"[english]DOTA_Tooltip_Ability_item_deployable_shop"	"Pocket Shop"
"DOTA_Tooltip_Ability_item_deployable_shop_Description"	"Cria uma loja no local selecionado."
"[english]DOTA_Tooltip_Ability_item_deployable_shop_Description"	"Deploys a shop at the target location."
"DOTA_Tooltip_ability_beastmaster_statue_boar_poison"	"Veneno"
"[english]DOTA_Tooltip_ability_beastmaster_statue_boar_poison"	"Poison"
"DOTA_Tooltip_ability_beastmaster_statue_boar_poison_Description"	"Inflige um veneno que reduz a rapidez de ataque e de movimento."
"[english]DOTA_Tooltip_ability_beastmaster_statue_boar_poison_Description"	"Inflicts a poison that slows attack and movement speeds."
"DOTA_Tooltip_ability_beastmaster_statue_boar_poison_attack_speed"	"ABRANDAMENTO (ATAQUE):"
"[english]DOTA_Tooltip_ability_beastmaster_statue_boar_poison_attack_speed"	"ATTACK SLOW:"
"DOTA_Tooltip_ability_beastmaster_statue_boar_poison_movement_speed"	"%ABRANDAMENTO (MOVIMENTO):"
"[english]DOTA_Tooltip_ability_beastmaster_statue_boar_poison_movement_speed"	"%MOVEMENT SLOW:"
"DOTA_Tooltip_ability_beastmaster_statue_boar_poison_duration"	"DURAÇÃO:"
"[english]DOTA_Tooltip_ability_beastmaster_statue_boar_poison_duration"	"DURATION:"
"DOTA_Tooltip_Ability_item_cavern_treasure_tier1"	"Pedacinho de Queijo"
"[english]DOTA_Tooltip_Ability_item_cavern_treasure_tier1"	"Small Cheese Wedge"
"DOTA_Tooltip_Ability_item_cavern_treasure_tier1_Description"	"Que fragrância."
"[english]DOTA_Tooltip_Ability_item_cavern_treasure_tier1_Description"	"It's fragrant."
"DOTA_Tooltip_Ability_item_cavern_treasure_tier2"	"Pedaço Médio de Queijo"
"[english]DOTA_Tooltip_Ability_item_cavern_treasure_tier2"	"Medium Cheese Wedge"
"DOTA_Tooltip_Ability_item_cavern_treasure_tier2_Description"	"Que aroma."
"[english]DOTA_Tooltip_Ability_item_cavern_treasure_tier2_Description"	"It's aromatic."
"DOTA_Tooltip_Ability_item_cavern_treasure_tier3"	"Pedação de Queijo"
"[english]DOTA_Tooltip_Ability_item_cavern_treasure_tier3"	"Large Cheese Wedge"
"DOTA_Tooltip_Ability_item_cavern_treasure_tier3_Description"	"Tem um cheiro agradavelmente pungente."
"[english]DOTA_Tooltip_Ability_item_cavern_treasure_tier3_Description"	"It's delightfully pungent."
"DOTA_Tooltip_Ability_item_potion_of_cowardice"	"Poção de Fuga"
"[english]DOTA_Tooltip_Ability_item_potion_of_cowardice"	"Escape Potion"
"DOTA_Tooltip_Ability_item_potion_of_cowardice_Description"	"Concede 15 segundos de invisibilidade e %dMODIFIER_PROPERTY_MOVESPEED_BONUS_PERCENTAGE%%% de rapidez de movimento adicional. O utilizador permanece silenciado, emudecido e desarmado durante o efeito. Atacar ou usar uma habilidade irá interromper o efeito."
"[english]DOTA_Tooltip_Ability_item_potion_of_cowardice_Description"	"Grants 15 seconds of invisibility and %dMODIFIER_PROPERTY_MOVESPEED_BONUS_PERCENTAGE%%% bonus movement speed. Silenced, muted, and disarmed for the duration. Attacking or casting a spell will break the effect."
"DOTA_Tooltip_modifier_potion_of_cowardice_buff"	"Poção de Fuga"
"[english]DOTA_Tooltip_modifier_potion_of_cowardice_buff"	"Escape Potion"
"DOTA_Tooltip_modifier_potion_of_cowardice_buff_Description"	"Invisível e com rapidez de movimento adicional. Silenciado, emudecido e desarmado durante o efeito."
"[english]DOTA_Tooltip_modifier_potion_of_cowardice_buff_Description"	"Deep Invisibility and bonus movement speed. Silenced, muted, and disarmed for the duration."
"DOTA_Tooltip_modifier_potion_of_cowardice_debuff"	"Debuff de Poção de Fuga"
"[english]DOTA_Tooltip_modifier_potion_of_cowardice_debuff"	"Escape Potion Debuff"
"DOTA_Tooltip_modifier_potion_of_cowardice_debuff_Description"	"Abrandado, desarmado, silenciado e emudecido."
"[english]DOTA_Tooltip_modifier_potion_of_cowardice_debuff_Description"	"Slowed, disarmed, silenced, and muted."
"DOTA_Tooltip_modifier_beastmaster_statue_boar_poison"	"Veneno de Javali"
"[english]DOTA_Tooltip_modifier_beastmaster_statue_boar_poison"	"Boar Poison"
"DOTA_Tooltip_modifier_beastmaster_statue_boar_poison_effect_Description"	"Rapidez de movimento reduzida em %dMODIFIER_PROPERTY_MOVESPEED_BONUS_PERCENTAGE%%%, rapidez de ataque reduzida em %dMODIFIER_PROPERTY_ATTACKSPEED_BONUS_CONSTANT%."
"[english]DOTA_Tooltip_modifier_beastmaster_statue_boar_poison_effect_Description"	"Movement speed reduced by %dMODIFIER_PROPERTY_MOVESPEED_BONUS_PERCENTAGE%%%, attack speed reduced by %dMODIFIER_PROPERTY_ATTACKSPEED_BONUS_CONSTANT%."
"DOTA_Tooltip_ability_creature_viper_nethertoxin"	"Nethertoxin"
"[english]DOTA_Tooltip_ability_creature_viper_nethertoxin"	"Nethertoxin"
"DOTA_Tooltip_ability_creature_viper_nethertoxin_Description"	"Lança toxinas na área selecionada. As unidades nessa área sofrem dano ao longo do tempo, passam a ter menos resistência e as suas habilidades passivas deixam de funcionar."
"[english]DOTA_Tooltip_ability_creature_viper_nethertoxin_Description"	"Viperling releases a Nethertoxin at the targeted area. Units in that area take damage over time, have lower resistance and their passives do not work."
"DOTA_Tooltip_ability_creature_viper_nethertoxin_Lore"	"O veneno dos confins das profundezas transforma feridas em fatalidades, e fadiga em morte."
"[english]DOTA_Tooltip_ability_creature_viper_nethertoxin_Lore"	"Poison from the Nether Reaches turns wounds into fatalities, and fatigue into death."
"DOTA_Tooltip_ability_creature_viper_nethertoxin_damage"	"DANO POR SEGUNDO:"
"[english]DOTA_Tooltip_ability_creature_viper_nethertoxin_damage"	"DAMAGE PER SECOND:"
"DOTA_Tooltip_ability_creature_viper_nethertoxin_magic_resistance"	"REDUÇÃO DE RESISTÊNCIA A MAGIA:"
"[english]DOTA_Tooltip_ability_creature_viper_nethertoxin_magic_resistance"	"MAGIC RESISTANCE REDUCTION:"
"DOTA_Tooltip_ability_creature_viper_nethertoxin_radius"	"RAIO:"
"[english]DOTA_Tooltip_ability_creature_viper_nethertoxin_radius"	"RADIUS:"
"DOTA_Tooltip_ability_creature_viper_nethertoxin_duration"	"DURAÇÃO:"
"[english]DOTA_Tooltip_ability_creature_viper_nethertoxin_duration"	"DURATION:"
"DOTA_Tooltip_modifier_antechamber_start"	"Pré-partida"
"[english]DOTA_Tooltip_modifier_antechamber_start"	"Pre-game"
"DOTA_Tooltip_modifier_antechamber_start_Description"	"Silenciado até que a partida comece."
"[english]DOTA_Tooltip_modifier_antechamber_start_Description"	"Silenced and muted until the game begins."
"DOTA_Tooltip_modifier_room_destruction"	"Sala destruída"
"[english]DOTA_Tooltip_modifier_room_destruction"	"Destroyed Room"
"DOTA_Tooltip_modifier_room_destruction_Description"	"Esta unidade está a sofrer uma grande quantidade de dano."
"[english]DOTA_Tooltip_modifier_room_destruction_Description"	"This unit is taking heavy damage."
"Cavern_RoshanSpawned"	"<panel class='CavernRoshanIcon'/>O Roshan chegou!"
"[english]Cavern_RoshanSpawned"	"<panel class='CavernRoshanIcon'/>Roshan has arrived!"
"Cavern_RoshanMoving"	"<panel class='CavernRoshanIcon'/>O Roshan vai desmoronar as salas do anel exterior daqui a {d:int_value} segundos!"
"[english]Cavern_RoshanMoving"	"<panel class='CavernRoshanIcon'/>Roshan will collapse the outer rooms in {d:int_value} seconds!"
"Cavern_RoshanMoveBegin"	"<panel class='CavernRoshanIcon'/>O labirinto está a desmoronar-se!"
"[english]Cavern_RoshanMoveBegin"	"<panel class='CavernRoshanIcon'/>The Underhollow is collapsing!"
"Cavern_FoundChestChickens"	"{s:player_name} encontrou um tesouro cheio de galinhas!"
"[english]Cavern_FoundChestChickens"	"{s:player_name} found a treasure containing chickens!"
"Cavern_FoundChestItem"	"{s:player_name} encontrou: {s:locstring_value}"
"[english]Cavern_FoundChestItem"	"{s:player_name} found {s:locstring_value}"
"Cavern_FoundChestCheese"	"{s:player_name} encontrou {d:int_value} pedaço(s) de queijo! <panel class='BattlePoints2018Icon'/>"
"[english]Cavern_FoundChestCheese"	"{s:player_name} found {d:int_value} wedges of cheese! <panel class='BattlePoints2018Icon'/>"
"Cavern_FoundChestGold"	"{s:player_name} encontrou <font color='#ffd825'>{d:int_value}</font><panel class='CombatEventGoldIcon'/>"
"[english]Cavern_FoundChestGold"	"{s:player_name} found <font color='#ffd825'>{d:int_value}</font><panel class='CombatEventGoldIcon'/>"
"Cavern_FoundChestTrap"	"{s:player_name} encontrou um tesouro com: <font color='#ffd825'>{s:locstring_value}</font>!"
"[english]Cavern_FoundChestTrap"	"{s:player_name} found a treasure containing: <font color='#ffd825'>{s:locstring_value}</font>!"
"Cavern_FoundRareChestItem"	"{s:player_name} encontrou um tesouro raro com: {s:locstring_value}"
"[english]Cavern_FoundRareChestItem"	"{s:player_name} found a rare treasure containing: {s:locstring_value}"
"Cavern_KilledByCreature"	"{s:locstring_value} <panel class='CombatEventKillIcon'/> {s:player_name}"
"[english]Cavern_KilledByCreature"	"{s:locstring_value} <panel class='CombatEventKillIcon'/> {s:player_name}"
"Cavern_KilledByPlayer"	"{s:player_name2} <panel class='CombatEventKillIcon'/> {s:player_name}"
"[english]Cavern_KilledByPlayer"	"{s:player_name2} <panel class='CombatEventKillIcon'/> {s:player_name}"
"Cavern_PlayerEliminated"	"{s:player_name2} eliminou {s:player_name} <font color='#ffd825'>{d:int_value}</font><panel class='BattlePoints2018Icon'/>"
"[english]Cavern_PlayerEliminated"	"{s:player_name2} eliminated {s:player_name} <font color='#ffd825'>{d:int_value}</font><panel class='BattlePoints2018Icon'/>"
"Cavern_PlayerEliminatedUnderhollow"	"{s:player_name} foi eliminado pelos perigos do labirinto!"
"[english]Cavern_PlayerEliminatedUnderhollow"	"{s:player_name} has been eliminated by The Underhollow!"
"Cavern_TheCheeseHasSpawned"	"<panel class='CheeseIcon'/>O Queijo foi encontrado!"
"[english]Cavern_TheCheeseHasSpawned"	"<panel class='CheeseIcon'/>The Cheese has been located!"
"Cavern_SomeoneTookTheCheese"	"<panel class='CheeseIcon'/>Alguém apanhou o Queijo!"
"[english]Cavern_SomeoneTookTheCheese"	"<panel class='CheeseIcon'/>Someone took the Cheese!"
"encounter_combat_dark_willow"	"Reino da Fada Anciã"
"[english]encounter_combat_dark_willow"	"Realm of the Elder Fae"
"encounter_combat_dark_willow_description"	"Travessuras e diabruras esperam-te."
"[english]encounter_combat_dark_willow_description"	"Mischief and trickery await."
"encounter_combat_earthshaker"	"Protetor da Montanha Vermelha"
"[english]encounter_combat_earthshaker"	"Protector of the Red Mountain"
"encounter_combat_earthshaker_description"	"Ninguém nunca está à espera de um terramoto."
"[english]encounter_combat_earthshaker_description"	"No one sees an earthquake coming."
"encounter_combat_enigma"	"O Vazio"
"[english]encounter_combat_enigma"	"The Void"
"encounter_combat_enigma_description"	"Se nem a luz me escapa, achas que tens alguma chance?"
"[english]encounter_combat_enigma_description"	"If light cannot escape me, what hope have you?"
"encounter_combat_ghosts"	"Os Aposentos dos Lamentos"
"[english]encounter_combat_ghosts"	"The Wailing Chamber"
"encounter_combat_ghosts_description"	"Não há mais ninguém aqui! Deves estar a imaginar coisas."
"[english]encounter_combat_ghosts_description"	"There's nobody here! Stop imagining things."
"encounter_combat_lycan"	"Líder da Alcateia"
"[english]encounter_combat_lycan"	"Leader of the Pack"
"encounter_combat_lycan_description"	"Os lobos precisam de armadura, vou usar a tua."
"[english]encounter_combat_lycan_description"	"Wolves need a bit of armor - I'll take yours."
"encounter_combat_minimages"	"Os Pequenos Inquisidores"
"[english]encounter_combat_minimages"	"Little Inquisitors"
"encounter_combat_minimages_description"	"Bruxas e feiticeiros não são bem-vindos!"
"[english]encounter_combat_minimages_description"	"Wizard-people not welcome here!"
"encounter_combat_moles"	"Linchamento Subterrâneo"
"[english]encounter_combat_moles"	"The Mucktown Mob"
"encounter_combat_moles_description"	"Toca a cavar daqui para fora!"
"[english]encounter_combat_moles_description"	"We dig everything!"
"encounter_combat_ogres"	"Ogre Esmaga!"
"[english]encounter_combat_ogres"	"Ogre Smashers"
"encounter_combat_ogres_description"	"Nós gostamos de esmagar. Coisinhas como tu!"
"[english]encounter_combat_ogres_description"	"Us like smash. And sit on tinies!"
"encounter_combat_pangoballer"	"Pangolins Rolantes"
"[english]encounter_combat_pangoballer"	"Rollin' Pangos"
"encounter_combat_pangoballer_description"	"É tipo bowling, mas vocês são os pinos."
"[english]encounter_combat_pangoballer_description"	"Bowling, with you as the pins."
"encounter_combat_pugna"	"Mestre do Oblívio"
"[english]encounter_combat_pugna"	"Lord of Oblivion"
"encounter_combat_pugna_description"	"Quem ousa meter-se no meu caminho?"
"[english]encounter_combat_pugna_description"	"Who dares cross my path?"
"encounter_combat_ranged_creeps_linear"	"Arsenal Arcano"
"[english]encounter_combat_ranged_creeps_linear"	"Arcane Arsenal"
"encounter_combat_ranged_creeps_linear_description"	"Fica quietinho para podermos praticar os nossos feitiços."
"[english]encounter_combat_ranged_creeps_linear_description"	"Stand still so we can practice our spells."
"encounter_combat_sniper"	"Sniper Maluco"
"[english]encounter_combat_sniper"	"Crazed Sniper"
"encounter_combat_sniper_description"	"Diz adeus à tua cabeça!"
"[english]encounter_combat_sniper_description"	"Say goodbye to your head!"
"encounter_combat_spirit_breaker"	"Spirit Breakers"
"[english]encounter_combat_spirit_breaker"	"Spirit Breakers"
"encounter_combat_spirit_breaker_description"	"Agora Bashta."
"[english]encounter_combat_spirit_breaker_description"	"We're feeling bashful."
"encounter_combat_splitter"	"Hora de Partir Pedra"
"[english]encounter_combat_splitter"	"Take Your Mud Lumps"
"encounter_combat_splitter_description"	"Ou vai ou racha."
"[english]encounter_combat_splitter_description"	"Make like a banana and split."
"encounter_combat_trollcamp"	"Revolta dos Trolls"
"[english]encounter_combat_trollcamp"	"Troll Uprising"
"encounter_combat_trollcamp_description"	"Por favor, não destruam o nosso belo acampamento."
"[english]encounter_combat_trollcamp_description"	"Please don't destroy our lovely camp."
"encounter_combat_vipers"	"Ninho de Víboras"
"[english]encounter_combat_vipers"	"Viper Pit"
"encounter_combat_vipers_description"	"Estás em ácido?"
"[english]encounter_combat_vipers_description"	"Will you fail the acid test?"
"encounter_combat_wraith_king"	"Cavaleiros de Ostarion"
"[english]encounter_combat_wraith_king"	"Knights of Ostarion"
"encounter_combat_wraith_king_description"	"CAMPÓNIOS COMO VOCÊS SÃO BEM-VINDOS."
"[english]encounter_combat_wraith_king_description"	"YOU PUNY PEASANTS ARE WELCOME HERE."
"encounter_combat_zombies"	"Zombies à Solta"
"[english]encounter_combat_zombies"	"A Mess of Zombies"
"encounter_combat_zombies_description"	"Até te comíamos o cérebro, se tivesses um."
"[english]encounter_combat_zombies_description"	"We'd eat yer brains if you had any."
"encounter_trap_pendulum"	"Foste ao Corte?"
"[english]encounter_trap_pendulum"	"Slice of Your Life"
"encounter_trap_pendulum_description"	"0 dias desde a última decapitação."
"[english]encounter_trap_pendulum_description"	"0 days since the last decapitation."
"encounter_trap_pudge"	"Corrente da Crueldade"
"[english]encounter_trap_pudge"	"Such Cruel Lengths"
"encounter_trap_pudge_description"	"Hora da carnificina!"
"[english]encounter_trap_pudge_description"	"Time for a little butchery!"
"encounter_trap_mines"	"Escuta Atentamente"
"[english]encounter_trap_mines"	"Now Listen Carefully"
"encounter_trap_mines_description"	"Vais adorar as minhas armadilhas."
"[english]encounter_trap_mines_description"	"You'll love these traps of mine."
"encounter_trap_invoker"	"Exort Trionis!"
"[english]encounter_trap_invoker"	"Exort Trionis!"
"encounter_trap_invoker_description"	"Os imbecis morrem... tu sabes como é."
"[english]encounter_trap_invoker_description"	"Fools die... as you well know."
"encounter_trap_lich"	"Um Frio de Morrer"
"[english]encounter_trap_lich"	"A Killing Frost"
"encounter_trap_lich_description"	"Primeiro bates os dentes e depois bates a bota."
"[english]encounter_trap_lich_description"	"To the cold grave with you!"
"encounter_treasure_chest"	"Arca do Tesouro"
"[english]encounter_treasure_chest"	"Treasure Chest"
"encounter_treasure_chest_description"	"Mereces umas bugigangas valiosas."
"[english]encounter_treasure_chest_description"	"Grab some shiny trinkets."
"encounter_special_bonus_chickens"	"Sem Misericórdia"
"[english]encounter_special_bonus_chickens"	"Show No Mercy"
"encounter_special_bonus_chickens_description"	"Mas então o que é se passa aqui?"
"[english]encounter_special_bonus_chickens_description"	"What's going on in here?"
"encounter_special_shop"	"Loja"
"[english]encounter_special_shop"	"Shop"
"encounter_special_shop_description"	"Gasta à vontade o teu ouro suado."
"[english]encounter_special_shop_description"	"Spend your hard-earned gold nuggets."
"encounter_special_breakable_containers"	"Despensa Esquecida"
"[english]encounter_special_breakable_containers"	"Extra Long Shelf Life"
"encounter_special_breakable_containers_description"	"É tipo o jogo da mala mas com caixotes."
"[english]encounter_special_breakable_containers_description"	"It's barrels of fun... with crates."
"DOTA_Tooltip_ability_ghost_invis"	"Fantasmagórico"
"[english]DOTA_Tooltip_ability_ghost_invis"	"Ghostly"
"DOTA_Tooltip_ability_ghost_invis_Description"	"
"
"[english]DOTA_Tooltip_ability_ghost_invis_Description"	""
"DOTA_Tooltip_modifier_ghost_slow"	"Letargia Assombrada"
"[english]DOTA_Tooltip_modifier_ghost_slow"	"Haunting Lethargy"
"DOTA_Tooltip_modifier_ghost_slow_Description"	"Um fantasma está a abrandar esta unidade."
"[english]DOTA_Tooltip_modifier_ghost_slow_Description"	"A ghost is slowing this unit."
"DOTA_Tooltip_modifier_creature_wraith_king_reincarnation"	"Destino Coletivo"
"[english]DOTA_Tooltip_modifier_creature_wraith_king_reincarnation"	"Linked Fate"
"DOTA_Tooltip_modifier_creature_wraith_king_reincarnation_description"	"Os Reis Fragmentados só poderão descansar quando todos forem mandados juntos para o além."
"[english]DOTA_Tooltip_modifier_creature_wraith_king_reincarnation_description"	"These Sundered Kings can only rest when all are sent to the other side together."
"DOTA_ColorName_GoodGuys"	"Vermelho"
"[english]DOTA_ColorName_GoodGuys"	"Red"
"DOTA_ColorName_BadGuys"	"Verde"
"[english]DOTA_ColorName_BadGuys"	"Green"
"DOTA_ColorName_Custom1"	"Amarelo"
"[english]DOTA_ColorName_Custom1"	"Yellow"
"DOTA_ColorName_Custom2"	"Laranja"
"[english]DOTA_ColorName_Custom2"	"Orange"
"DOTA_ColorName_Custom3"	"Azul"
"[english]DOTA_ColorName_Custom3"	"Blue"
"DOTA_ColorName_Custom4"	"Verde"
"[english]DOTA_ColorName_Custom4"	"Green"
"DOTA_ColorName_Custom5"	"Castanho"
"[english]DOTA_ColorName_Custom5"	"Brown"
"DOTA_ColorName_Custom6"	"Ciano"
"[english]DOTA_ColorName_Custom6"	"Cyan"
"DOTA_ColorName_Custom7"	"Azeitona"
"[english]DOTA_ColorName_Custom7"	"Olive"
"DOTA_ColorName_Custom8"	"Roxo"
"[english]DOTA_ColorName_Custom8"	"Purple"
"DOTA_Custom1"	"Amarelo"
"[english]DOTA_Custom1"	"Yellow"
"DOTA_Custom2"	"Laranja"
"[english]DOTA_Custom2"	"Orange"
"DOTA_Custom3"	"Azul"
"[english]DOTA_Custom3"	"Blue"
"DOTA_Custom4"	"Verde"
"[english]DOTA_Custom4"	"Green"
"DOTA_Custom5"	"Castanho"
"[english]DOTA_Custom5"	"Brown"
"DOTA_Custom6"	"Ciano"
"[english]DOTA_Custom6"	"Cyan"
"DOTA_Custom7"	"Azeitona"
"[english]DOTA_Custom7"	"Olive"
"DOTA_Custom8"	"Roxo"
"[english]DOTA_Custom8"	"Purple"
"VictoryMessage_GoodGuys"	"A Equipa Vermelha ganhou!"
"[english]VictoryMessage_GoodGuys"	"Red Team Wins!"
"VictoryMessage_BadGuys"	"A Equipa Verde ganhou!"
"[english]VictoryMessage_BadGuys"	"Green Team Wins!"
"VictoryMessage_Custom1"	"A Equipa Amarela ganhou!"
"[english]VictoryMessage_Custom1"	"Yellow Team Wins!"
"VictoryMessage_Custom2"	"A Equipa Laranja ganhou!"
"[english]VictoryMessage_Custom2"	"Orange Team Wins!"
"VictoryMessage_Custom3"	"A Equipa Azul ganhou!"
"[english]VictoryMessage_Custom3"	"Blue Team Wins!"
"VictoryMessage_Custom4"	"A Equipa Verde ganhou!"
"[english]VictoryMessage_Custom4"	"Green Team Wins!"
"VictoryMessage_Custom5"	"A Equipa Castanha ganhou!"
"[english]VictoryMessage_Custom5"	"Brown Team Wins!"
"VictoryMessage_Custom6"	"A Equipa Ciano ganhou!"
"[english]VictoryMessage_Custom6"	"Cyan Team Wins!"
"VictoryMessage_Custom7"	"A Equipa Azeitona ganhou!"
"[english]VictoryMessage_Custom7"	"Olive Team Wins!"
"VictoryMessage_Custom8"	"A Equipa Roxa ganhou!"
"[english]VictoryMessage_Custom8"	"Purple Team Wins!"
"DOTA_EventUI_Player"	"Jogador"
"[english]DOTA_EventUI_Player"	"Player"
"DOTA_EventUI_Kills"	"V"
"[english]DOTA_EventUI_Kills"	"K"
"DOTA_EventUI_Eliminations"	"E"
"[english]DOTA_EventUI_Eliminations"	"E"
"DOTA_EventUI_Mute"	"Voz"
"[english]DOTA_EventUI_Mute"	"Mute"
"DOTA_EventUI_OK"	"OK"
"[english]DOTA_EventUI_OK"	"OK"
"DOTA_EventUI_BP"	"PB:"
"[english]DOTA_EventUI_BP"	"BP:"
}
}
