"lang"
{
"Language"	"norwegian"
"Tokens"
{
"DOTA_WearableType_Daggers"	"Dolker"
"DOTA_WearableType_Glaives"	"Glaver"
"DOTA_WearableType_Weapon"	"Våpen"
"DOTA_WearableType_Armor"	"rustning"
"DOTA_WearableType_Hair"	"Hår"
"DOTA_WearableType_Belt"	"belte"
"DOTA_WearableType_Mask"	"Maske"
"DOTA_WearableType_Cape"	"Kappe"
"DOTA_WearableType_Bracer"	"armbeskytter"
"DOTA_WearableType_Boots"	"Støvler"
"DOTA_WearableType_Hands"	"Hender"
"DOTA_WearableType_Head"	"hode"
"DOTA_WearableType_Mace"	"Stav"
"DOTA_WearableType_Gauntlet"	"Stridshanske"
"DOTA_WearableType_Shoulder"	"skulder"
"DOTA_WearableType_Bow"	"Bue"
"DOTA_WearableType_ShoulderPads"	"Skulderputer"
"DOTA_WearableType_Quiver"	"Kogger"
"DOTA_WearableType_Shield"	"skjold"
"DOTA_WearableType_Horns"	"Horn"
"DOTA_WearableType_Beard"	"Skjegg"
"DOTA_WearableType_Necklace"	"Halskjede"
"DOTA_WearableType_Fish_Treat"	"Fiskegodbit"
"DOTA_WearableType_Meathook"	"Kjøttkrok"
"DOTA_WearableType_Offhand_weapon"	"Sekundærhånd våpen"
"DOTA_WearableType_Back"	"rygg"
"DOTA_WearableType_Gloves"	"hansker"
"DOTA_WearableType_Legs"	"bein"
"DOTA_WearableType_offhand"	"sekundærhånd"
"DOTA_WearableType_arms"	"Armer"
"DOTA_WearableType_Unnamed_New_Item"	"Pakke"
"DOTA_WearableType_New_Item"	"Ny gjenstand"
"DOTA_WearableType_body"	"Kropp"
"DOTA_WearableType_Tail"	"hale"
"DOTA_WearableType_Pauldrons"	"Skulderputer"
"DOTA_WearableType_Chain_Weapon"	"Kjedevåpen"
"DOTA_WearableType_Pegleg"	"Provisorisk protese"
"DOTA_WearableType_Sword"	"Sverd"
"DOTA_WearableType_Hat"	"hatt"
"DOTA_WearableType_Ability_Modifier"	"Verktøy"
"DOTA_WearableType_Toga"	"Toga"
"DOTA_WearableType_Hand"	"Hånd"
"DOTA_WearableType_Taunt"	"Hån"
"DOTA_WearableType_Skin"	"Hud"
"DOTA_WearableType_Alternate_Ultimate"	"Alternativ ultimate"
"DOTA_WearableType_Alternate_Attack"	"Alternativt angrep"
"DOTA_WearableType_Pauldron"	"Skulderpute"
"DOTA_WearableType_Spaulder"	"Skulderplate"
"DOTA_WearableType_Squishy_Hat"	"Bløt hatt"
"DOTA_WearableType_Bracers"	"Armbeskyttere"
"DOTA_WearableType_Robe"	"Kjortel"
"DOTA_WearableType_Headdress"	"Hodeplagg"
"DOTA_WearableType_Mailed_Skirt"	"Ringbrynje"
"DOTA_WearableType_Hat_and_Hair"	"Hatt og hår"
"DOTA_WearableType_Shoes"	"Sko"
"DOTA_WearableType_Spikes"	"Pigger"
"DOTA_WearableType_Bone_Helm"	"Beinhjelm"
"DOTA_WearableType_Mine"	"Mine"
"DOTA_WearableType_Fins"	"Finner"
"DOTA_WearableType_Axe"	"Øks"
"DOTA_WearableType_Shoulder_Guard"	"Skulderbeskyttere"
"DOTA_WearableType_Cloak_and_Tunic"	"Kappe og kjortel"
"DOTA_WearableType_Hammer"	"Hammer"
"DOTA_WearableType_Dead_Shark"	"Død hai"
"DOTA_WearableType_Finished_Lunch"	"Ferdig lunsj"
"DOTA_WearableType_Bone_Club"	"Beinklubbe"
"DOTA_WearableType_Makeshift_Weapon"	"Improvisert våpen"
"DOTA_WearableType_Shoulderguard"	"Skulderbeskyttelse"
"DOTA_WearableType_Fancy_Pantaloons"	"Stilige pantalonger"
"DOTA_WearableType_Cloth_Bracer"	"Armbeskyttere av stoff"
"DOTA_WearableType_Stuffed_Toy"	"Kosedyr"
"DOTA_WearableType_Staff"	"Stav"
"DOTA_WearableType_Gruesome_Trophies"	"Grusomme trofeer"
"DOTA_WearableType_Hood"	"Hette"
"DOTA_WearableType_Shuriken"	"Shuriken"
"DOTA_WearableType_Mancatcher"	"Menneskefanger"
"DOTA_WearableType_Apron"	"Forkle"
"DOTA_WearableType_Armlet"	"Armbånd"
"DOTA_WearableType_Scepter"	"Septer"
"DOTA_WearableType_Abomination"	"Abominasjon"
"DOTA_WearableType_Greaves"	"Grakser"
"DOTA_WearableType_Saw"	"Sag"
"DOTA_WearableType_Hook"	"Krok"
"DOTA_WearableType_Abdomen"	"Abdomen"
"DOTA_WearableType_Sect_Pauldron"	"Sektskulderpute"
"DOTA_WearableType_Sect_Helm"	"Sekthjelm"
"DOTA_WearableType_Sect_Sword"	"Sektsverd"
"DOTA_WearableType_Flag"	"Flagg"
"DOTA_WearableType_Blade_RightHand"	"Sverd, høyrehånd"
"DOTA_WearableType_Blade_LeftHand"	"Sverd, venstrehånd"
"DOTA_WearableType_Sect_Cape"	"Sektkappe"
"DOTA_WearableType_Sect_Skirt"	"Sektskjørt"
"DOTA_WearableType_Sect_Gauntlet"	"Sektstridshanske"
"DOTA_WearableType_Scarf"	"Skjerf"
"DOTA_WearableType_Leather_Pants"	"Lærbukser"
"DOTA_WearableType_Blade_RightHanded"	"Sverd, høyrehånd"
"DOTA_WearableType_Talisman"	"Talisman"
"DOTA_WearableType_Garland"	"Krans"
"DOTA_WearableType_Exort_Cape"	"Exort-kappe"
"DOTA_WearableType_Exort_Bracer"	"Exort-armbeskytter"
"DOTA_WearableType_Exort_Crest"	"Exort-emblem"
"DOTA_Item"	"Brukbar"
"DOTA_Custom_Courier"	"Budbringer"
"DOTA_Custom_HexModel"	"Tilpasset hex-dyr"
"DOTA_WearableType_Announcer"	"Kommentator"
"DOTA_WearableType_Custom_Courier"	"Budbringer"
"DOTA_WearableType_MegaKills"	" 
"
"DOTA_WearableType_Treasure_Chest"	"Skattekiste"
"DOTA_TreasureChest_Type"	"Skatt"
"DOTA_WearableType_Tool"	"Redskap"
"DOTA_WearableType_Battle_Bonus"	"Kamp-bonus"
"DOTA_Item_Gift"	"Gave"
"DOTA_WearableType_Gift"	"Gave"
"DOTA_WearableType_Strange_Essence"	"Merkelig essens"
"DOTA_WearableType_LeagueViewPass"	" 
"
"DOTA_WearableType_Bundle"	"Pakke"
"DOTA_Wearable_Riki_DefaultWeapon"	"Rikis dolker"
"DOTA_Item_AntiMages_Glaives"	"Anti-Mage's Glaives"
"DOTA_Item_Desc_AntiMages_Glaives"	" 
"
"DOTA_Item_Axes_Axe"	"Axe's Axe"
"DOTA_Wearable_Axe_DefaultArmor"	"Axes skulderputer"
"DOTA_Wearable_Axe_DefaultHair"	"Axes hestehale"
"DOTA_Item_Axes_Belt"	"Axe's Belt"
"DOTA_Wearable_Jugg_DefaultMask"	"Juggernauts maske"
"DOTA_Wearable_Jugg_DefaultWeapon"	"Juggernauts våpen"
"DOTA_Wearable_Jugg_DefaultCape"	"Juggernauts kappe"
"DOTA_Wearable_Jugg_DefaultBracers"	"Juggernaut's Bracers"
"DOTA_Item_Kunkkas_Boots"	"Kunkka's Boots"
"DOTA_Item_Kunkkas_Hands"	"Kunkka's Hands"
"DOTA_Item_Kunkkas_Sword"	"Kunkka's Sword"
"DOTA_Item_Omniknights_Bracers"	"Omniknight's Bracers"
"DOTA_Item_Desc_Bracers"	"Omniknights gamle armbeskyttere"
"DOTA_Item_Kunkkas_Head"	"Kunkka's Head"
"DOTA_FacelessVoid_Default_Weapon"	"Faceless Voids våpen"
"DOTA_Wearable_Sven_DefaultHead"	"Svens maske"
"DOTA_Wearable_Sven_DefaultSword"	"Svens sverd"
"DOTA_Wearable_Sven_DefaultBelt"	"Svens belte"
"DOTA_Wearable_Sven_DefaultGauntlet"	"Svens stridshanske"
"DOTA_Wearable_Sven_DefaultShoulder"	"Svens skulder"
"DOTA_Wearable_Windrunner_DefaultHead"	"Windrangers hode"
"DOTA_Wearable_Windrunner_DefaultBow"	"Windrangers bue"
"DOTA_Wearable_Windrunner_ShoulderPads"	"Windrangers skulderputer"
"DOTA_Wearable_Windrunner_Cape"	"Windrangers kappe"
"DOTA_Wearable_Windrunner_DefaultQuiver"	"Windrangers kogger"
"DOTA_Item_Queen_of_Pains_Weapon"	"Queen of Pains våpen"
"DOTA_Wearable_Silencer_DefaultWeapon"	"Silencers våpen"
"DOTA_Wearable_Silencer_DefaultShield"	"Silencers skjold"
"DOTA_Wearable_Furion_DefaultWeapon"	"Prophets stav"
"DOTA_Wearable_Furion_DefaultHorns"	"Prophets horn"
"DOTA_Wearable_Furion_DefaultBeard"	"Prophets skjegg"
"DOTA_Wearable_Furion_DefaultCape"	"Prophets kappe"
"DOTA_Wearable_Furion_DefaultNecklace"	"Prophets halskjede"
"DOTA_Item_Tidehunters_Bracer"	"Tidehunter's Bracer"
"DOTA_Item_Tidehunters_Belt"	"Tidehunter's Belt"
"DOTA_Item_Tidehunters_Anchor"	"Tidehunter's Anchor"
"DOTA_Item_Tidehunters_Lunch"	"Tidehunter's Lunch"
"DOTA_Wearable_CrystalMaiden_Default_Cape"	"Crystal Maidens kappe"
"DOTA_Wearable_CrystalMaiden_Default_Shoulder_Pads"	"Crystal Maidens skulderputer"
"DOTA_Wearable_CrystalMaiden_Default_Weapon"	"Crystal Maidens våpen"
"DOTA_Wearable_CrystalMaiden_Default_Boots_and_Cuffs"	"Crystal Maidens støvler & mansjett"
"DOTA_Item_Omniknights_Shoulders"	"Omniknight's Shoulders"
"DOTA_Item_Omniknights_Cape"	"Omniknight's Cape"
"DOTA_Item_Omniknights_Weapon"	"Omniknight's Weapon"
"DOTA_Item_Desc_Omniknights_Hammer"	"Omniknights gamle hammer"
"DOTA_Item_Omniknights_Head"	"Omniknight's Head"
"DOTA_Item_Omniknights_Hair"	"Omniknight's Hair"
"DOTA_Item_Pudges_Rusty_Meathook"	"Pudge's Rusty Meathook"
"DOTA_Item_Desc_Rusty_Meathook"	"En rusten og grusom kjøttkrok."
"DOTA_Item_Invokers_Cape"	"Invoker's Cape"
"DOTA_Item_Prophets_Bracers"	"Prophet's Bracers"
"DOTA_Item_Desc_Copy_of_Prophets_Horns"	" 

"
"DOTA_Item_Bounty_Hunters_Weapon"	"Bounty Hunter's Weapon"
"DOTA_Item_Desc_Unnamed_New_Item"	"Denne nye gjenstanden har ingen beskrivelse."
"DOTA_Item_Bounty_Hunters_Offhand_Weapon"	"Bounty Hunter's Offhand Weapon"
"DOTA_Item_Desc_Copy_of_RWeapon"	"Denne nye gjenstanden har ingen beskrivelse."
"DOTA_Item_Bounty_Hunters_Back"	"Bounty Hunter's Back"
"DOTA_Item_Desc_Copy_of_LWeapon"	"Denne nye gjenstanden har ingen beskrivelse."
"DOTA_Item_Armor"	"Bounty Hunter's Armor"
"DOTA_Item_Desc_Copy_of_Backpack"	"Denne nye gjenstanden har ingen beskrivelse."
"DOTA_Item_Bounty_Hunters_Shoulder"	"Bounty Hunter's Shoulder"
"DOTA_Item_Desc_Copy_of_Armor"	"Denne nye gjenstanden har ingen beskrivelse."
"DOTA_Item_Bounty_Hunters_Bandana"	"Bounty Hunter's Bandana"
"DOTA_Item_Desc_Copy_of_BWeapon"	"Denne nye gjenstanden har ingen beskrivelse."
"DOTA_Item_Clinkz_Skull"	"Clinkz Skull"
"DOTA_Item_Desc_Clinkz_Skull"	"Clinkz standardskalle"
"DOTA_Item_Clinkz_Bow"	"Clinkz Bow"
"DOTA_Item_Desc_Clinkz_Bow"	"Clinkz standardbue"
"DOTA_Item_Clinkz_Shoulder_Pads"	"Clinkz Shoulder Pads"
"DOTA_Item_Desc_Clinkz_Shoulder_Pads"	"Clinkz standardskulderputer"
"DOTA_Item_Clinkz_Quiver"	"Clinkz Quiver"
"DOTA_Item_Desc_Clinkz_Quiver"	"Clinkz standardpilkogger"
"DOTA_Item_Clinkz_Horns"	"Clinkz Horns"
"DOTA_Item_Desc_Clinkz_Horns"	"Clinkz standardhorn"
"DOTA_Item_Clinkz_Gloves"	"Clinkz Gloves"
"DOTA_Item_Desc_Copy_of_Clinkz_Skull"	"Clinkz standardskalle"
"DOTA_Wearable_Jugg_DefaultLegs"	"Juggernauts bein"
"DOTA_Item_Dragon_Knights_Helmet"	"Dragon Knight's Helmet"
"DOTA_Item_Desc_Copy_of_Juggernauts_Legs"	" 
"
"DOTA_Item_Dragon_Knights_Shoulder_Armor"	"Dragon Knight's Shoulder Armor"
"DOTA_Item_Dragon_Knights_Bracers"	"Dragon Knight's Bracers"
"DOTA_Item_Desc_Copy_of_Dragon_Knights_Shoulder_Armor"	" 

"
"DOTA_Item_Dragon_Knights_Weapon"	"Dragon Knight's Weapon"
"DOTA_Item_Dragon_Knights_Offhand"	"Dragon Knight's Offhand"
"DOTA_Item_Dragon_Knights_Skirt"	"Dragon Knight's Skirt"
"DOTA_Item_Desc_Copy_of_Dragon_Knights_Offhand"	" 

"
"DOTA_Item_Blood_Seekers_Weapon"	"Blood Seeker's Weapon"
"DOTA_Item_Desc_Copy_of_Dragon_Knights_Skirt"	" 

"
"DOTA_Item_Blood_Seekers_Headdress"	"Blood Seeker's Headdress"
"DOTA_Item_Blood_Seekers_Offhand_Weapon"	"Blood Seeker's Offhand Weapon"
"DOTA_Item_Desc_Copy_of_Blood_Seekers_Headdress"	" 

"
"DOTA_Item_Blood_Seekers_Necklace"	"Blood Seeker's Necklace"
"DOTA_Item_Desc_Copy_of_Blood_Seekers_Offhand_Weapon"	" 

"
"DOTA_Item_Blood_Seekers_Cape"	"Blood Seeker's Cape"
"DOTA_Item_Desc_Copy_of_Blood_Seekers_Necklace"	" 

"
"DOTA_Item_Blood_Seekers_Bracers"	"Blood Seeker's Bracers"
"DOTA_Item_Desc_Copy_of_Blood_Seekers_Cape"	" 
"
"DOTA_Item_Drows_Bracers"	"Drow's Bracers"
"DOTA_Item_Desc_Copy_of_Blood_Seekers_Bracers"	" 
"
"DOTA_Item_Drows_Cape"	"Drows kappe"
"DOTA_Item_Desc_Copy_of_Drows_Bracers"	" 
"
"DOTA_Item_Drows_Bow"	"Drow's Bow"
"DOTA_Item_Desc_Copy_of_Drows_Cape"	" 
"
"DOTA_Item_Drows_Leg_Armor"	"Drow's Leg Armor"
"DOTA_Item_Drows_Quiver"	"Drow's Quiver"
"DOTA_Item_Desc_Copy_of_Drows_Leg_Armor"	" 
"
"DOTA_Item_Drows_Shoulder_Armor"	"Drow's Shoulder Armor"
"DOTA_Item_Desc_Copy_of_Drows_Quiver"	" 

"
"DOTA_Item_Kunkkas_Spyglass"	"Kunkka's Spyglass"
"DOTA_Item_Desc_Copy_of_Kunkkas_Head"	" 
"
"DOTA_Item_Queen_of_Pains_Wings"	"Queen of Pains vinger"
"DOTA_Item_Desc_Copy_of_Queen_of_Pains_Weapon"	" 
"
"DOTA_Item_Queen_of_Pains_Armor"	"Queen of Pain's Armor"
"DOTA_Item_Desc_Copy_of_Queen_of_Pains_Wings"	" 
"
"DOTA_Item_Queen_of_Pains_Hair"	"Queen of Pains hår"
"DOTA_Item_Desc_Copy_of_Queen_of_Pains_Armor"	" 

"
"DOTA_Item_Ursas_Helmet"	"Ursa's Helmet"
"DOTA_Item_Desc_Copy_of_Queen_of_Pains_Hair"	" 
"
"DOTA_Item_Ursas_Fur"	"Ursa's Fur"
"DOTA_Item_Desc_Copy_of_Ursas_Helmet"	" 
"
"DOTA_Item_Ursas_Bracers"	"Ursa's Bracers"
"DOTA_Item_Desc_Copy_of_Ursas_Fur"	" 
"
"DOTA_Item_Ursas_Skirt"	"Ursa's Skirt"
"DOTA_Item_Desc_Copy_of_Ursas_Bracers"	" 

"
"DOTA_Item_Invokers_Shoulder"	"Invoker's Shoulder"
"DOTA_Item_Facelesss_Head"	"Faceless's Head"
"DOTA_Item_Facelesss_Shoulder"	"Faceless's Shoulder"
"DOTA_Item_Facelesss_Bracer"	"Faceless's Bracer"
"DOTA_Item_Facelesss_Belt"	"Faceless's Belt"
"DOTA_Item_Witch_Doctors_Head"	"Witch Doctor's Head"
"DOTA_Item_Witch_Doctors_Bag"	"Witch Doctor's Bag"
"DOTA_Item_Witch_Doctors_Belt"	"Witch Doctor's Belt"
"DOTA_Item_Witch_Doctors_Staff"	"Witch Doctor's Staff"
"DOTA_Item_Invokers_Head"	"Invoker's Head"
"DOTA_Item_Invokers_Hair"	"Invoker's Hair"
"DOTA_Item_Invokers_Bracer"	"Invoker's Bracer"
"DOTA_Item_Broodmothers_Hair"	"Broodmother's Hair"
"DOTA_Item_Broodmothers_Legs"	"Broodmother's Legs"
"DOTA_Item_Broodmothers_Abdomen"	"Broodmother's Abdomen"
"DOTA_Item_Meepos_Weapon"	"Meepo's Weapon"
"DOTA_Item_Ogremagis_Weapon"	"Ogremagi's Weapon"
"DOTA_Item_Desc_Copy_of_weapon"	"Denne nye gjenstanden har ingen beskrivelse."
"DOTA_Item_Spirit_Breakers_Head"	"Spirit Breaker's Head"
"DOTA_Item_Lone_Druids_Hair"	"Lone Druid's Hair"
"DOTA_Item_Desc_head"	"standardhår"
"DOTA_Item_Lone_Druids_Shoulder_Armor"	"Lone Druid's Shoulder Armor"
"DOTA_Item_Desc_Lone_Druids_Shoulder_Armor"	"standardskulderbeskytter"
"DOTA_Item_Lone_Druids_Bracers"	"Lone Druid's Bracers"
"DOTA_Item_Desc_Lone_Druids_Bracers"	"standardarmgjenstand"
"DOTA_Item_Lone_Druids_Poncho"	"Lone Druid's Poncho"
"DOTA_Item_Desc_Lone_Druids_Poncho"	"standardkroppsgjenstand"
"DOTA_Item_Spirit_Breakers_Horns"	"Spirit Breaker's Horns"
"DOTA_Item_Desc_Copy_of_Spirit_Breakers_Head"	"Denne nye gjenstanden har ingen beskrivelse."
"DOTA_Item_Spirit_Breakers_Shoulder_Armor"	"Spirit Breaker's Shoulder Armor"
"DOTA_Item_Desc_Copy_of_Spirit_Breakers_Horns"	"Denne nye gjenstanden har ingen beskrivelse."
"DOTA_Item_Spirit_Breakers_Mace"	"Spirit Breaker's Mace"
"DOTA_Item_Desc_Copy_of_Spirit_Breakers_Shoulder_Armor"	"Denne nye gjenstanden har ingen beskrivelse."
"DOTA_Item_Spirit_Breakers_Tail"	"Spirit Breaker's Tail"
"DOTA_Item_Desc_Copy_of_Spirit_Breakers_Mace"	"Denne nye gjenstanden har ingen beskrivelse."
"DOTA_Item_Spirit_Breakers_Bracers"	"Spirit Breaker's Bracers"
"DOTA_Item_Desc_Copy_of_Spirit_Breakers_Tail"	"Denne nye gjenstanden har ingen beskrivelse."
"DOTA_Item_Spirit_Breakers_Lower_Armor"	"Spirit Breaker's Lower Armor"
"DOTA_Item_Desc_Copy_of_Spirit_Breakers_Bracers"	"Denne nye gjenstanden har ingen beskrivelse."
"DOTA_Item_Alchemists_Goblin_Body"	"Alchemist's Goblin Body"
"DOTA_Item_Alchemists_Weapon"	"Alchemist's Weapon"
"DOTA_Item_Alchemists_Saddle"	"Alchemist's Saddle"
"DOTA_Item_Alchemists_Gauntlet"	"Alchemist's Gauntlet"
"DOTA_Item_Alchemists_Goblin_Hat"	"Alchemist's Goblin Hat"
"DOTA_Item_Alchemists_Left_Bottle"	"Alchemist's Left Bottle"
"DOTA_Item_Alchemists_Goblin_Head"	"Alchemist's Goblin Head"
"DOTA_Item_Alchemists_Ogre_Head"	"Alchemist's Ogre Head"
"DOTA_Item_Alchemists_Shoulder_Bottle"	"Alchemist's Shoulder Bottle"
"DOTA_Item_Phantom_Lancers_Legs"	"Phantom Lancer's Legs"
"DOTA_Item_Desc_Phantom_Lancers_Legs"	"Disse støvlene ble skapt for å gå med."
"DOTA_Item_Phantom_Lancers_Head"	"Phantom Lancer's Head"
"DOTA_Item_Desc_Phantom_Lancers_Head"	"For å se og snakke. Det er et skjegg på det også.<br><br>standardgjenstand"
"DOTA_Item_Phantom_Lancers_Belt"	"Phantom Lancer's Belt"
"DOTA_Item_Desc_Phantom_Lancers_Belt"	"Han er den regjerende tungvektsmesteren.<br><br>standardgjenstand"
"DOTA_Item_Phantom_Lancers_Gauntlet"	"Phantom Lancer's Gauntlet"
"DOTA_Item_Desc_Phantom_Lancers_Gauntlet"	"Bare de tapreste krigerne har på seg kun én hanske i kamp.<br><br>standardgjenstand"
"DOTA_Item_Phantom_Lancers_Shoulderpad"	"Phantom Lancer's Shoulderpad"
"DOTA_Item_Desc_Phantom_Lancers_Shoulderpad"	"Denne armbeskytteren gir beskyttelse mot alvorlige skader fra katteslagsmål.<br><br>standardgjenstand"
"DOTA_Item_Phantom_Lancers_Necklace"	"Phantom Lancer's Necklace"
"DOTA_Item_Desc_Phantom_Lancers_Necklace"	"Selv krigere liker å føle seg stilige."
"DOTA_Item_Phantom_Lancers_Weapon"	"Phantom Lancer's Weapon"
"DOTA_Item_Desc_Phantom_Lancers_Weapon"	"Til å dolke med.<br><br>standardgjenstand"
"DOTA_Item_Ogremagis_Cape"	"Ogremagi's Cape"
"DOTA_Item_Desc_Copy_of_Ogremagis_Weapon"	"Denne nye gjenstanden har ingen beskrivelse."
"DOTA_Item_Ogremagis_Bracers"	"Ogremagi's Bracers"
"DOTA_Item_Desc_Copy_of_Ogremagis_Cape"	"Denne nye gjenstanden har ingen beskrivelse."
"DOTA_Item_Ogremagis_Hats"	"Ogremagi's Hats"
"DOTA_Item_Desc_Copy_of_Ogremagis_Bracers"	"Denne nye gjenstanden har ingen beskrivelse."
"DOTA_Item_Ogremagis_Belt"	"Ogremagi's Belt"
"DOTA_Item_Desc_Copy_of_Ogremagis_Hats"	"Denne nye gjenstanden har ingen beskrivelse."
"DOTA_Item_Wich_Doctors_Horn_Mask"	"Witch Doctor's Horn Mask"
"DOTA_Item_Pangolin_Shoulder_Armor"	"Pangolin Shoulder Armor"
"DOTA_Item_Desc_Pangolin_Shoulder_Armor"	"Mesterlig utformede skulderputer fra Pangolin-klanen. De tilbyr styrken til panserrustninger til en brøkdel av vekten."
"DOTA_Item_Witch_Doctors_Ribcage_Backpack"	"Witch Doctor's Ribcage Backpack"
"DOTA_Item_The_Blood_Chaser"	"The Blood Chaser"
"DOTA_Item_Desc_The_Blood_Chaser"	"Et tredelt sammenlenket skaft med dobbeltbladet øksehode på toppen. Nesten like farlig for den som bærer den som for fienden."
"DOTA_Item_Timestopper"	"Timestopper"
"DOTA_Wearable_FacelessVoid_Timestopper_Desc"	"Dersom dine uutsigelige transdimensjonale makt over kronologi skulle feile i å stoppe fienden, forsøk å slå dem i hodet med denne solide klubben."
"DOTA_Wearable_Dazzle_TrolltoothNecklace"	"Trolltooth Necklace"
"DOTA_Wearable_Dazzle_TrolltoothNecklace_Desc"	"En nøye sammensatt samling av trolltenner. Hver tann inneholder den fangede sjelen til dens tidligere eier."
"DOTA_Item_Dragonclaw_Hook"	"Dragonclaw Hook"
"DOTA_Item_Desc_Dragonclaw_Hook"	"Kloen fra en svartdrages venstre tå. Den eneste delen av beistet som overlevde et møte med Pudges glupske apetitt."
"DOTA_Item_Demon_Blood_Helm"	"Demon Blood Helm"
"DOTA_Item_Desc_Demon_Blood_Helm"	"En hjelm som bærer det kyklopiske ansiktet til Tjernmennenes demoniske krigsgud. Det sies at den Røde Tåke utslettet guden og tok dens symboler som sine egne."
"DOTA_Wearable_Axe_Demon_Blood_Armor"	"Demon Blood Armor"
"DOTA_Item_Desc_Demon_Blood_Armor"	"Tung platerustning smidd i blodet til Tarnsmen-stammens døde guder."
"DOTA_Item_Demon_Blood_Guard"	"Demon Blood Guard"
"DOTA_Item_Desc_Demon_Blood_Guard"	"Når den Røde Tåke slukte de Tusen Tjern, ble innsjøene farget røde av blodet til de drepte. Mange demoner forkledd som lovmakere og prester i den fordømte sivilisasjonen ble også utslettet, og blodet deres blandet seg med blodet til de dødelige de en gang hersket over."
"DOTA_Wearable_Kunkka_Pegleg"	"Pegleg of the Cursed Pirate"
"DOTA_Item_Desc_Pegleg_of_the_Cursed_Pirate"	"Et tapt ben er ingen hindring for Kunkkas hevntørst."
"DOTA_Item_ThreeFold_Mien_of_the_Boar_God"	"Three-Fold Mien of the Boar God"
"DOTA_Item_Desc_ThreeFold_Mien_of_the_Boar_God"	"Villsvinets aspekt bringer helse, virilitet og iver. Det primitive tegnet til fire-syv-tolv."
"DOTA_Item_SevenSealed_the_Fur_Bracer"	"Seven-Sealed the Fur Bracer"
"DOTA_Item_Desc_SevenSealed_the_Fur_Bracer"	"Dette er kun en armbeskytter i pels. Den har ingen interessante aspekter og tilbyr ingen magisk beskyttelse. Allikevel bærer den et stort navn og illustrerer således hulheten i grunnløs stolthet."
"DOTA_Item_TwelveTusks_the_Cape_of_Boars"	"Twelve-Tusks the Cape of Boars"
"DOTA_Item_Desc_TwelveTusks_the_Cape_of_Boars"	"Her har vi ære ganger tolv. Som man ville prydet en verdig krigerkonge, hver tann et triumfsymbol."
"DOTA_Item_FourFangs_the_Swordbreaker"	"Four-Fangs the Swordbreaker"
"DOTA_Item_Desc_FourFangs_the_Swordbreaker"	"Hoggtennene på dette hissige sverdet vil bite seg dypt inn i din fiendes utsatte våpen!"
"DOTA_Wearable_Kunkka_Bandana"	"Pride of the Crew"
"DOTA_Item_Desc_Pride_of_the_Crew"	"Selv kapteinen må fra tid til annen hjelpe mannskapet med skipets daglige gjøremål."
"DOTA_Wearable_Kunkka_Bicorne_Hat"	"Royal Admiral's Bicorne"
"DOTA_Item_Desc_Royal_Admirals_Bicorne"	"En skipsmesters fine båthatt."
"DOTA_Wearable_Kunkka_Tricorne_Hat"	"Tricorne of the Drowned"
"DOTA_Item_Desc_Tricorne_of_the_Drowned"	"En vellaget trekanthatt kantet med gull."
"DOTA_Wearable_Kunkka_Wavecrester"	"Wavecrester"
"DOTA_Item_Pact_of_GorThramak"	"Pact of Gor-Thramak"
"DOTA_Wearable_Axe_Berserkers_Pauldron"	"Berserker's Pauldron"
"DOTA_Wearable_Axe_Berserkers_Helm"	"Berserker's Helm"
"DOTA_Wearable_Axe_Berserkers_Belt"	"Berserker's Belt"
"DOTA_Item_Coat_of_the_Elder_Grove"	"Coat of the Elder Grove"
"DOTA_Item_Horns_of_the_Forest_Lord"	"Horns of the Forest Lord"
"DOTA_Item_Toga_of_the_PeaceBringer"	"Toga of the Peace-Bringer"
"DOTA_Item_Desc_Toga_of_the_PeaceBringer"	"Ganske avslappende."
"DOTA_Item_Luxuriant_ChinFoliage"	"Luxuriant Chin-Foliage"
"DOTA_Item_Horns_of_Noblesse"	"Horns of Noblesse"
"DOTA_Item_Desc_Horns_of_Noblesse"	"Et sett med horn verdige for en konge."
"DOTA_Item_Cape_of_Verdant_Dreaming"	"Cape of Verdant Dreaming"
"DOTA_Item_Runestaff_of_Verodicia"	"Runestaff of Verodicia"
"DOTA_Item_Runed_Ailettes"	"Runed Ailettes"
"DOTA_Item_Lucky_Tooth_Necklace"	"Lucky Tooth Necklace"
"DOTA_Item_Desc_Lucky_Tooth_Necklace"	"Et halskjede av tennene til et sjeldent sjøuhyre."
"DOTA_Item_Captains_Hook"	"Captain's Hook"
"DOTA_Item_Tayrnhelm_of_the_Swordmaster"	"Tayrnhelm of the Swordmaster"
"DOTA_Item_Girth_of_the_Swordmaster"	"Girth of the Swordmaster"
"DOTA_Item_Fluted_Guard_of_the_Swordmaster"	"Fluted Guard of the Swordmaster"
"DOTA_Item_Grip_of_the_Swordmaster"	"Grip of the Swordmaster"
"DOTA_Item_Meranth_Executioners_Blade"	"Meranth Executioner's Blade"
"DOTA_Item_Desc_Meranth_Executioners_Blade"	"Et enegget blad som er perfekt for å raskt fjerne hoder. Eller ben. Eller armer."
"DOTA_Item_Taunt_Snipers_Celebration"	"Hån: Sniper's Celebration"
"DOTA_AnimTaunt_SniperTaunt_Desc"	"Feir et utsøkt drap eller en herlig manøver ved å vise din begeistring til fienden. Han bryr seg sikkert ikke."
"DOTA_Item_Taunt_Beautiful_Snowangel"	"Hån: Beautiful Snowangel"
"DOTA_AnimTaunt_CM_Snowangel_Desc"	"Crystal Maiden lager en snøengel!"
"DOTA_Item_Taunt_Playful_Snowball"	"Hån: Playful Snowball"
"DOTA_AnimTaunt_CM_Snowball_Desc"	"Crystal Maiden kaster en snøball!"
"DOTA_Item_Taunt_Come_and_Get_It"	"Hån: Come and Get It!"
"DOTA_Item_Desc_Taunt_Come_and_Get_It"	"Axe anmoder flere tosker å slakte!"
"DOTA_Item_Taunt_Spider_Shuffle"	"Hån: Spider Shuffle"
"DOTA_Item_Taunt_Good_Day_Sir"	"Hån: Good Day Sir!"
"DOTA_Item_Desc_Taunt_Good_Day_Sir"	" "
"DOTA_Item_Taunt_DoubleHeaded_Roar"	"Hån: Double-Headed Roar"
"DOTA_Item_Taunt_Icemelter"	"Hån: Icemelter"
"DOTA_Item_Taunt_Fish_Treat"	"Hån: Fish Treat"
"DOTA_AnimTaunt_Tidehunter_Toss_Fish_Desc"	" "
"DOTA_Item_Wrath_of_the_Orca"	"Wrath of the Orca"
"DOTA_Item_Desc_Wrath_of_the_Orca"	"Ingen beskrivelse ennå."
"DOTA_Item_Taunt_Get_Burned"	"Hån: Get Burned"
"DOTA_Item_Wuldastron_the_TwinBlade_of_Giants"	"Wuldastron the Twin-Blade of Giants"
"DOTA_Item_Desc_Wuldastron_the_TwinBlade_of_Giants"	"Få mennesker kan bruke et så mektig sverd."
"DOTA_Item_Ultimate_Belly_Flop"	"Ultimat: Belly Flop"
"DOTA_Item_Attack_Fish_Slap"	"Angrep: Fish Slap"
"DOTA_Item_Taunt_The_Jig"	"Hån: The Jig"
"DOTA_Item_Taunt_You"	"Hån: You!"
"DOTA_Item_Taunt_Dive_Dive"	"Hån: Dive! Dive!"
"DOTA_Item_Taunt_Canonical_Blast"	"Hån: Canonical Blast"
"DOTA_Item_Taunt_Shredding_the_Lute_Invisible"	"Hån: Shredding the Lute Invisible"
"DOTA_Item_Taunt_For_Death_and_Honor"	"Hån: For Death and Honor"
"DOTA_Item_Taunt_Face_the_Juggernaut"	"Hån: Face the Juggernaut"
"DOTA_Item_Taunt_Tooting_the_Horn"	"Hån: Tooting the Horn"
"DOTA_Item_Staff_of_the_TuskBereft"	"Staff of the Tusk-Bereft"
"DOTA_Item_Tusked_Bracers"	"Tusked Bracers"
"DOTA_Item_Grand_Crown_of_the_Gigas"	"Grand Crown of the Gigas"
"DOTA_Item_Desc_Grand_Crown_of_the_Gigas"	"Er det noen dyr så majestetisk som kraftfulle Gigas? Til og med Alcer og Cameloider bøyer seg for dem."
"DOTA_Item_Sinorian_Sphere_Staff"	"Sinorian Sphere Staff"
"DOTA_Item_Taunt_Bo_Staff_Beckon"	"Hån: Bo Staff Beckon"
"DOTA_Item_Taunt_Vaudville_Victory_Dance"	"Hån: Vaudville Victory Dance"
"DOTA_Item_Taunt_Murder_Lute"	"Hån: Murder Lute"
"DOTA_Item_Twin_Bull_Adornment"	"Twin Bull Adornment"
"DOTA_Item_Pauldron_of_AlFusha"	"Pauldron of Al-Fusha"
"DOTA_Item_Castors_Spaulder"	"Castor's Spaulder"
"DOTA_Item_Defender_of_the_Ivory_Isles"	"Defender of the Ivory Isles"
"DOTA_Item_Visage_of_the_Ivory_Isles"	"Visage of the Ivory Isles"
"DOTA_Item_Curled_RootStaff"	"Curled Root-Staff"
"DOTA_Item_Flared_Wooden_Crest"	"Flared Wooden Crest"
"DOTA_Item_Fireborn_Odachi"	"Fireborn Odachi"
"DOTA_Item_Taunt_Kata_of_Foot_and_Earth"	"Hån: Kata of Foot and Earth"
"DOTA_Item_Doubly_Braided_Beard"	"Doubly Braided Beard"
"DOTA_Item_Druidic_Ritual_Crest"	"Druidic Ritual Crest"
"DOTA_Item_Stoic_Mask_of_the_High_Plains"	"Stoic Mask of the High Plains"
"DOTA_Item_Wolf_Cape_of_the_High_Plains"	"Wolf Cape of the High Plains"
"DOTA_Item_Aspect_Wraps_of_the_High_Plains"	"Aspect Wraps of the High Plains"
"DOTA_Item_LongFang_the_Grey_Blade"	"Long-Fang the Grey Blade"
"DOTA_Item_Beard_of_Cycles"	"Beard of Cycles"
"DOTA_Item_Diadem_of_the_Goddess_Enthroned"	"Diadem of the Goddess Enthroned"
"DOTA_Item_Drape_of_Foliate_Magery"	"Drape of Foliate Magery"
"DOTA_Item_Guard_of_the_Deep_Tribes"	"Guard of the Deep Tribes"
"DOTA_Item_PineSage_Sigil_Stones"	"Pine-Sage Sigil Stones"
"DOTA_Item_Modestly_Braided_Beard"	"Modestly Braided Beard"
"DOTA_Item_Taunt_Kata_of_Blade_and_Sky"	"Hån: Kata of Blade and Sky"
"DOTA_Item_Cuffs_of_Oak_and_Yew"	"Cuffs of Oak and Yew"
"DOTA_Item_Kraken_Shell"	"Kraken Shell"
"DOTA_Item_Octopus_Hat"	"Octopus Hat"
"DOTA_Item_Grand_Claive_of_the_Unshamed"	"Grand Claive of the Unshamed"
"DOTA_Item_Wyrm_Shield_of_Uldorak"	"Wyrm Shield of Uldorak"
"DOTA_Item_Belt_o_Wicked_Badness"	"Belt o' Wicked Badness"
"DOTA_Item_Kimono_of_the_Ebony_Tower"	"Kimono of the Ebony Tower"
"DOTA_Item_Bracers_of_the_Ebony_Tower"	"Bracers of the Ebony Tower"
"DOTA_Item_Relic_Blade_of_the_KuurIshiminari"	"Relic Blade of the Kuur-Ishiminari"
"DOTA_Item_Kantusa_the_Script_Sword"	"Kantusa the Script Sword"
"DOTA_Item_Omnishred_the_Defiant"	"Omnishred the Defiant"
"DOTA_Item_Healing_Ward_of_the_KuurIshiminari"	"Healing Ward of the Kuur-Ishiminari"
"DOTA_Item_Call_of_the_Dendrochron"	"Call of the Dendrochron"
"DOTA_Item_100Proof_Jug"	"100-Proof Jug"
"DOTA_Item_Fine_Bone_Bracers"	"Fine Bone Bracers"
"DOTA_Item_PreyTrackers_Aspect_Mask"	"Prey-Tracker's Aspect Mask"
"DOTA_Item_Staff_of_the_Eagle"	"Staff of the Eagle"
"DOTA_Item_Blade_of_the_Dark_Ancients"	"Blade of the Dark Ancients"
"DOTA_Item_Habit_of_the_Seeker"	"Habit of the Seeker"
"DOTA_Item_HlotlFeather_Gloves"	"Hlotl-Feather Gloves"
"DOTA_Item_HlotlTusk_Headdress_of_the_Seeker"	"Hlotl-Tusk Headdress of the Seeker"
"DOTA_Item_HlotlFeather_Necklace"	"Hlotl-Feather Necklace"
"DOTA_Item_Wyrm_Helm_of_Uldorak"	"Wyrm Helm of Uldorak"
"DOTA_Item_Wyrm_Bracer_of_Uldorak"	"Wyrm Bracer of Uldorak"
"DOTA_Item_Wyrm_Skirt_of_Uldorak"	"Wyrm Skirt of Uldorak"
"DOTA_Item_Wyrm_Pauldron_of_Uldorak"	"Wyrm Pauldron of Uldorak"
"DOTA_Item_Gloves_of_the_Admirable_Admiral"	"Gloves of the Admirable Admiral"
"DOTA_Item_Ceremonial_Rapier"	"Ceremonial Rapier"
"DOTA_Item_Sword_of_the_SeventySeven_Seas"	"Sword of the Seventy-Seven Seas"
"DOTA_Item_Grand_Curls_of_the_Admirable_Admiral"	"Grand Curls of the Admirable Admiral"
"DOTA_Item_Seafarers_Shoes"	"Seafarer's Shoes"
"DOTA_Item_BackAche"	"Back-Ache"
"DOTA_Item_Excavators_Treasure"	"Excavator's Treasure"
"DOTA_Item_Excavators_Decorated_Treasure"	"Excavator's Decorated Treasure"
"DOTA_Item_Naval_Mine"	"Naval Mine"
"DOTA_Item_Swamp_Fins"	"Swamp Fins"
"DOTA_Item_Desc_Swamp_Fins"	"Ingen vet om denne oppvisningen betyr at Tidehunter er sint eller i brunst. Uansett har ingen overlevd for å spørre."
"DOTA_Item_Pillar_of_Strength"	"Pillar of Strength"
"DOTA_Item_Stone_Loins"	"Stone Loins"
"DOTA_Item_Stone_Guard"	"Stone Guard"
"DOTA_Item_Stone_Helmet"	"Stone Helmet"
"DOTA_Item_Helm_of_the_Radiant_Crusader"	"Helm of the Radiant Crusader"
"DOTA_Item_Armor_of_the_Radiant_Crusader"	"Armor of the Radiant Crusader"
"DOTA_Item_Bracers_of_the_Radiant_Crusader"	"Bracers of the Radiant Crusader"
"DOTA_Item_Sigil_of_the_Radiant_Crusader"	"Sigil of the Radiant Crusader"
"DOTA_Item_Hammer_of_the_Radiant_Crusader"	"Hammer of the Radiant Crusader"
"DOTA_Item_Champion_of_Emauracus"	"Champion of Emauracus"
"DOTA_Item_Raw_Hide"	"Raw Hide"
"DOTA_Item_Cerebral_Support"	"Cerebral Support"
"DOTA_Item_Femur_Thrasher"	"Femur Thrasher"
"DOTA_Item_BeastJaw_Bludgeoner"	"Beast-Jaw Bludgeoner"
"DOTA_Item_Mask_of_the_Freelancer"	"Mask of the Freelancer"
"DOTA_Item_Shoulderguard_of_the_Freelancer"	"Shoulderguard of the Freelancer"
"DOTA_Item_Pantaloons_of_the_Freelancer"	"Pantaloons of the Freelancer"
"DOTA_Item_Sword_of_the_Freelancer"	"Sword of the Freelancer"
"DOTA_Item_Dragonmaw"	"Dragonmaw"
"DOTA_Item_Pirate_Slayers_Bracer"	"Pirate Slayer's Bracer"
"DOTA_Item_Pirate_Slayers_Tricorn"	"Pirate Slayer's Tricorn"
"DOTA_Item_Squiddles"	"Squiddles"
"DOTA_Item_Spectrolite_Staff"	"Spectrolite Staff"
"DOTA_Item_Sword_of_the_Admirable_Admiral"	"Sword of the Admirable Admiral"
"DOTA_Item_Executioners_Axe"	"Executioner's Axe"
"DOTA_Item_Executioners_Cape"	"Executioner's Cape"
"DOTA_Item_Executioners_Trophies"	"Executioner's Trophies"
"DOTA_Item_Executioners_Hood"	"Executioner's Hood"
"DOTA_Item_SeaGods_Ceremonial_Headdress"	"Sea-God's Ceremonial Headdress"
"DOTA_Item_Desc_SeaGods_Ceremonial_Headdress"	"Denne nye gjenstanden har ingen beskrivelse."
"DOTA_Item_Cold_Case_Bow"	"Cold Case Bow"
"DOTA_Item_Shuriken_of_the_Hidden_Hunter"	"Shuriken of the Hidden Hunter"
"DOTA_Item_Harvester_of_the_Hidden_Hunter"	"Harvester of the Hidden Hunter"
"DOTA_Item_Cleaver_of_the_Hidden_Hunter"	"Cleaver of the Hidden Hunter"
"DOTA_Item_Forgemasters_Apron"	"Forgemaster's Apron"
"DOTA_Item_Forgemasters_Armlet"	"Forgemaster's Armlet"
"DOTA_Item_Forgemasters_Hammer"	"Forgemaster's Hammer"
"DOTA_Item_Forgemasters_Mask"	"Forgemaster's Mask"
"DOTA_Item_Ice_Burst_Bow"	"Ice Burst Bow"
"DOTA_Item_The_Cleaver_of_Might"	"The Cleaver of Might"
"DOTA_Item_Natures_Bow"	"Natures Bow"
"DOTA_Item_Chronite_Armor"	"Chronite Armor"
"DOTA_Item_Chronite_Bracers"	"Chronite Bracers"
"DOTA_Item_Chronite_Scepter"	"Chronite Scepter"
"DOTA_Item_Voidkeepers_Visage"	"Voidkeeper's Visage"
"DOTA_Item_Ice_Burst_Bracers"	"Ice Burst Bracers"
"DOTA_Item_Ice_Burst_Greaves"	"Ice Burst Greaves"
"DOTA_Item_Creepers_Cruel_Painsaw"	"Creeper's Cruel Painsaw"
"DOTA_Item_Creepers_Cruel_Hook"	"Creeper's Cruel Hook"
"DOTA_Item_Creepers_Cruel_Shuriken"	"Creeper's Cruel Shuriken"
"DOTA_Item_Desc_Creepers_Cruel_Shuriken"	"\"Au!\""
"DOTA_Item_Blademothers_Crawlers"	"Blademother's Crawlers"
"DOTA_Item_Blademothers_Goggles"	"Blademother's Goggles"
"DOTA_Item_Blademothers_Abdomen"	"Blademother's Abdomen"
"DOTA_Item_Spiral_Staff"	"Spiral Staff"
"DOTA_Item_Pincher_Bow"	"Pincher Bow"
"DOTA_Item_Dressed_Pauldron_of_the_Mono_Militis"	"Dressed Pauldron of the Mono Militis"
"DOTA_Item_Cyclopean_Helm_of_the_Mono_Militis"	"Cyclopean Helm of the Mono Militis"
"DOTA_Item_Sword_of_the_Mono_Militis"	"Sword of the Mono Militis"
"DOTA_Item_Sword_of_the_Flameguard"	"Sword of the Flameguard"
"DOTA_Item_Pirate_Slayers_Cutlass"	"Pirate Slayer's Cutlass"
"DOTA_Item_Pirate_Slayers_Black_Flag"	"Pirate Slayer's Black Flag"
"DOTA_Item_ShovelMouthed_Mask"	"Shovel-Mouthed Mask"
"DOTA_Item_War_Blade_Right"	"War Blade"
"DOTA_Item_War_Blade_Left"	"War Blade (Venstre)"
"DOTA_Item_Headcrusher"	"Headcrusher"
"DOTA_Item_Helm_of_the_Flameguard"	"Helm of the Flameguard"
"DOTA_Item_Dressed_Pauldron_of_the_Flameguard"	"Dressed Pauldron of the Flameguard"
"DOTA_Item_Cape_of_the_Flameguard"	"Cape of the Flameguard"
"DOTA_Item_Skirt_of_the_Flameguard"	"Skirt of the Flameguard"
"DOTA_Item_Commanders_Helm_of_the_Flameguard"	"Commander's Helm of the Flameguard"
"DOTA_Item_Commanders_Gauntlet_of_the_Flameguard"	"Commander's Gauntlet of the Flameguard"
"DOTA_Item_Lucky_Alpine_Stalkers_Hat"	"Lucky Alpine Stalker's Hat"
"DOTA_Item_Alpine_Stalkers_Scarf"	"Alpine Stalker's Scarf"
"DOTA_Item_Alpine_Stalkers_Pants"	"Alpine Stalker's Pants"
"DOTA_Item_Alpine_Stalkers_Gloves"	"Alpine Stalker's Gloves"
"DOTA_Item_Back_Hook_Right"	"Back Hook"
"DOTA_Item_Back_Hook_Left"	"Back Hook (Venstre)"
"DOTA_Item_Witch_Doctors_Vile_Hat"	"Witch Doctor's Vile Hat"
"DOTA_Item_Desc_Witch_Doctors_Vile_Hat"	"Denne nye gjenstanden har ingen beskrivelse."
"DOTA_Item_Witch_Doctors_Dreaded_Dreads"	"Witch Doctor's Dreaded Dreads"
"DOTA_Item_Juju_o_Wicked_Badness"	"Juju o' Wicked Badness"
"DOTA_Item_Staff_o_Wicked_Badness"	"Staff o' Wicked Badness"
"DOTA_Item_Mask_o_Wicked_Badness"	"Mask o' Wicked Badness"
"DOTA_Item_Witch_Doctors_Shrunken_Head_Staff"	"Witch Doctor's Shrunken Head Staff"
"DOTA_Item_Witch_Doctors_Wooden_Mask"	"Witch Doctor's Wooden Mask"
"DOTA_Item_Wich_Doctors_Tribal_Mask"	"Witch Doctor's Tribal Mask"
"DOTA_Item_Flower_Staff_of_the_PeaceBringer"	"Flower Staff of the Peace-Bringer"
"DOTA_Item_Lei_of_the_PeaceBringer"	"Lei of the Peace-Bringer"
"DOTA_Item_Horns_of_the_PeaceBringer"	"Horns of the Peace-Bringer"
"DOTA_Item_Beard_of_the_PeaceBringer"	"Beard of the Peace-Bringer"
"DOTA_Item_Desc_Beard_of_the_PeaceBringer"	"Lett og dunbløt."
"DOTA_Item_Pangolin_Carapace"	"Pangolin Carapace"
"DOTA_Item_Pangolin_Scarf"	"Pangolin Scarf"
"DOTA_Item_Frost_Spikes"	"Frost Spikes"
"DOTA_Item_Cape_of_the_Burning_Cabal"	"Cape of the Burning Cabal"
"DOTA_Item_Bracer_of_the_Burning_Cabal"	"Bracer of the Burning Cabal"
"DOTA_Item_Crest_of_the_Burning_Cabal"	"Crest of the Burning Cabal"
"DOTA_Item_Stylish_Wizards_Topnot"	"Stylish Wizard's Topnot"
"DOTA_Custom_Courier_ShittyWizard_Desc"	" "
"DOTA_Custom_Courier_MiniPudge_Desc"	"
"
"DOTA_Item_Desc_Copy_of_Minipudge_Courier"	" "
"DOTA_Item_Treasure_Chest"	" "
"DOTA_TreasureChest_Rare"	" "
"DOTA_TreasureChest_Desc"	" "
"DOTA_Item_Name_Tag"	"Navnelapp"
"DOTA_Item_75_Battle_Point_Booster_3_Days"	"75% Battle Point Booster (3 dager)"
"DOTA_Bundle_DOTA2_Access"	"Dota 2-invitasjon"
"DOTA_WearableType_Helmet"	"hjelm"
"DOTA_WearableType_All_Hero_Taunt"	"Alle heltehån"
"DOTA_WearableType_Strange_Modifier"	"Merkelig modifikasjon"
"DOTA_Item_Desc_Copy_of_Phantom_Assassins_Helmet"	"Denne nye gjenstanden har ingen beskrivelse."
"DOTA_Item_Desc_Copy_of_Phantom_Assassins_Shoulder_Pads"	"Denne nye gjenstanden har ingen beskrivelse."
"DOTA_Item_Desc_Copy_of_Phantom_Assassins_Cape"	"Denne nye gjenstanden har ingen beskrivelse."
"DOTA_Item_Horn_Mask"	"Hornmaske"
"DOTA_Item_Taunt_Its_in_the_Bag"	"Hån: It's in the Bag"
"DOTA_Item_Desc_Copy_of_Disruptors_Weapon"	"Denne nye gjenstanden har ingen beskrivelse."
"DOTA_Item_Desc_Copy_of_Disruptors_Bracers"	"Denne nye gjenstanden har ingen beskrivelse."
"DOTA_Item_Desc_Copy_of_Disruptors_Hair"	"Denne nye gjenstanden har ingen beskrivelse."
"DOTA_Item_Desc_Copy_of_Disruptors_Back"	"Denne nye gjenstanden har ingen beskrivelse."
"DOTA_Item_Desc_Copy_of_Disruptors_Shoulder_Armor"	"Denne nye gjenstanden har ingen beskrivelse."
"DOTA_Item_Unusual_Paint"	"Uvanlig maling"
"DOTA_Item_Unusual_Paint_Blue"	"Uvanlig maling: Blå"
"DOTA_Item_Unusual_Paint_Purple"	"Uvanlig maling: Lilla"
"DOTA_Item_Unusual_Paint_Green"	"Uvanlig maling: Grønn"
"DOTA_Item_Unusual_Paint_Light_Green"	"Uvanlig maling: Lysegrønn"
"DOTA_Item_Unusual_Paint_Gold"	"Uvanlig maling: Gull"
"DOTA_Item_Unusual_Paint_Orange"	"Uvanlig maling: Oransje"
"DOTA_Item_Unusual_Paint_Red"	"Uvanlig maling: Rød"
"DOTA_WearableType_Drum"	"Tromme"
"DOTA_WearableType_Wheel"	"Hjul"
"DOTA_WearableType_Knife"	"Kniv"
"DOTA_Item_Desc_Copy_of_Brewmasters_Staff"	"Denne nye gjenstanden har ingen beskrivelse."
"DOTA_Item_Desc_Copy_of_Brewmasters_Barrel"	"Denne nye gjenstanden har ingen beskrivelse."
"DOTA_Item_Desc_Copy_of_Brewmasters_Backpack"	"Denne nye gjenstanden har ingen beskrivelse."
"DOTA_Item_Desc_Copy_of_Rikis_Daggers"	"
"
"DOTA_Item_Desc_Copy_of_Rikis_Horns"	"
"
"DOTA_Item_Desc_Copy_of_Rikis_Shoulder_Armor"	"
"
"DOTA_Item_Desc_Copy_of_Rikis_Tail"	"
"
"DOTA_Item_Desc_Copy_of_BladedStaff_of_the_Reaper"	"Denne nye gjenstanden har ingen beskrivelse."
"DOTA_Item_Desc_Copy_of_Makeshift_Sword_of_the_Reaper"	"Denne nye gjenstanden har ingen beskrivelse."
"DOTA_Item_Desc_Copy_of_Nyxs_Weapon"	"Denne nye gjenstanden har ingen beskrivelse."
"DOTA_Item_Desc_Copy_of_Nyxs_Armor"	"Denne nye gjenstanden har ingen beskrivelse."
"DOTA_Item_BloodLetter_Left"	"BloodLetter (Venstre)"
"DOTA_Item_Desc_Obsidian_Destroyers_head"	"Denne nye gjenstanden har ingen beskrivelse."
"DOTA_Item_Desc_Copy_of_Rubicks_Staff"	"Denne nye gjenstanden har ingen beskrivelse."
"DOTA_Item_Desc_Copy_of_Rubicks_Cape"	"Denne nye gjenstanden har ingen beskrivelse."
"DOTA_Item_Desc_Copy_of_Necrolytes_Sickle"	"Denne nye gjenstanden har ingen beskrivelse."
"DOTA_Item_Desc_Copy_of_Necrolytes_Beard"	"Denne nye gjenstanden har ingen beskrivelse."
"DOTA_Item_Desc_Copy_of_Necrolytes_Headdress"	"Denne nye gjenstanden har ingen beskrivelse."
"DOTA_Item_Desc_Copy_of_Chens_Staff"	"Denne nye gjenstanden har ingen beskrivelse."
"DOTA_Item_Desc_Copy_of_Chens_Mount"	"Denne nye gjenstanden har ingen beskrivelse."
"DOTA_Item_Desc_Copy_of_Chens_Helmet"	"Denne nye gjenstanden har ingen beskrivelse."
"DOTA_Item_Desc_Copy_of_Chens_Bracers"	"Denne nye gjenstanden har ingen beskrivelse."
"DOTA_Item_Desc_Copy_of_Chens_Shoulder_Armor"	"Denne nye gjenstanden har ingen beskrivelse."
"DOTA_Item_Desc_Copy_of_Treants_Head"	"Denne nye gjenstanden har ingen beskrivelse."
"DOTA_Item_Desc_Copy_of_Treants_Foliage"	"Denne nye gjenstanden har ingen beskrivelse."
"DOTA_Item_Desc_Copy_of_Treants_Hands"	"Denne nye gjenstanden har ingen beskrivelse."
"DOTA_Item_Desc_Copy_of_Treants_Feet"	"Denne nye gjenstanden har ingen beskrivelse."
"DOTA_Item_Savage_Beast_Weapon_Left"	"Savage Beast Weapon (Venstre)"
"DOTA_Item_Desc_Copy_of_Dooms_Weapon"	"Denne nye gjenstanden har ingen beskrivelse."
"DOTA_Item_Desc_Copy_of_Dooms_Helm"	"Denne nye gjenstanden har ingen beskrivelse."
"DOTA_Item_Desc_Copy_of_Dooms_Shoulder_Armor"	"Denne nye gjenstanden har ingen beskrivelse."
"DOTA_Item_Desc_Copy_of_Dooms_Bracers"	"Denne nye gjenstanden har ingen beskrivelse."
"DOTA_Item_Desc_Copy_of_Dooms_Belt"	"Denne nye gjenstanden har ingen beskrivelse."
"DOTA_Item_Desc_Copy_of_Dooms_Wings"	"Denne nye gjenstanden har ingen beskrivelse."
"DOTA_Item_Desc_Copy_of_Shadow_Shamans_Weapon"	"Denne nye gjenstanden har ingen beskrivelse."
"DOTA_Item_Desc_Copy_of_Shadow_Shamans_Offhand_Weapon"	"Denne nye gjenstanden har ingen beskrivelse."
"DOTA_Item_Desc_Copy_of_Shadow_Shamans_Headdress"	"Denne nye gjenstanden har ingen beskrivelse."
"DOTA_Item_Desc_Copy_of_Shadow_Shamans_Armor"	"Denne nye gjenstanden har ingen beskrivelse."
"DOTA_Item_Desc_Copy_of_Shadow_Shamans_Stuff"	"Denne nye gjenstanden har ingen beskrivelse."
"DOTA_Item_League_AbsoluteArenaKOH_Admin"	"
"
"DOTA_WearableType_Book"	"Bok"
"DOTA_Item_Desc_KotL_Mount"	"
"
"DOTA_Item_Desc_KotL_Weapon"	"
"
"DOTA_Item_Desc_KotL_Skirt"	"
"
"DOTA_Item_Desc_KotL_Horse_Accesories"	"
"
"DOTA_Item_back_rings"	"
"
"DOTA_Item_Desc_back_rings"	"
"
"DOTA_Item_cleaver"	"
"
"DOTA_Item_Desc_Copy_of_back_rings"	"
"
"DOTA_Item_left_arm"	"
"
"DOTA_Item_Desc_left_arm"	"
"
"DOTA_Item_bracer"	"
"
"DOTA_Item_Desc_Copy_of_left_arm"	"
"
"DOTA_Item_hair"	"
"
"DOTA_Item_Desc_Copy_of_bracer"	"
"
"DOTA_Item_Cloak_of_the_Dawn"	"Cloak of the Dawn"
"DOTA_Item_Desc_Pennant_Upgrade"	"
"
"DOTA_Item_Desc_Copy_of_Drows_Shoulder_Armor"	"
"
"DOTA_WearableType_Egg"	"Egg"
"DOTA_WearableType_LeagueViewPass_Admin"	"
"
"DOTA_Item_Desc_Copy_of_Crystal_Maidens_Cape"	"
"
"DOTA_Item_Desc_Copy_of_Naga_Sirens_Sword"	"Denne nye gjenstanden har ingen beskrivelse."
"DOTA_Item_Desc_Copy_of_Rikis_Dagger"	"
"
"DOTA_Item_Mask_of_Madness"	"Mask of Madness"
"DOTA_Item_Desc_the_evildoer"	"Denne nye gjenstanden har ingen beskrivelse."
"DOTA_Item_Desc_Copy_of_Hair_of_the_Dark_Magic"	"
"
"DOTA_Item_Desc_Copy_of_Cape_of_the_Dark_Magic"	"
"
"DOTA_Item_Desc_Copy_of_Bracers_of_the_Dark_Magic"	"
"
"DOTA_Item_League_PremierLeague"	"Premier League"
"DOTA_Item_League_PremierLeague_Desc"	"Drevet av forente krefter mellom TwitchTV og SteelSeries, Season 3 er den nyeste utgaven av Premier League. Se 10 av de beste lagene fra både Europa og Nord-Amerika kjempe for $6000 med 5 intense kamper hver uke i 9 uker. Kommentert av TriumphOfMan."
"DOTA_Item_League_PremierLeague_Admin"	"
"
"DOTA_Bundle_Desc_Axe_Heavy_Steel_Armor_Set"	"
"
"DOTA_Item_Desc_Copy_of_AntiMages_Glaive"	"
"
"DOTA_Item_Desc_Copy_of_Nightstalkers_Wings"	"Denne nye gjenstanden har ingen beskrivelse."
"DOTA_Item_Desc_Copy_of_Nightstalkers_Armor"	"Denne nye gjenstanden har ingen beskrivelse."
"DOTA_Item_Unusual_Essence"	"Uvanlig essens"
"DOTA_Item_Desc_Copy_of_Dark_Seers_Hat"	"Denne nye gjenstanden har ingen beskrivelse."
"DOTA_Item_Desc_Copy_of_Dark_Seers_Loin_Cloth"	"Denne nye gjenstanden har ingen beskrivelse."
"DOTA_Item_Desc_Copy_of_Slarks_Weapon"	"Denne nye gjenstanden har ingen beskrivelse."
"DOTA_Item_Desc_Copy_of_Slarks_Bracers"	"Denne nye gjenstanden har ingen beskrivelse."
"DOTA_Item_Desc_Copy_of_Slarks_Shoulder_Armor"	"Denne nye gjenstanden har ingen beskrivelse."
"DOTA_Item_Desc_Copy_of_Kunkkas_Spyglass"	"
"
"DOTA_Item_Desc_Copy_of_Centaurs_Axe"	"Denne nye gjenstanden har ingen beskrivelse."
"DOTA_Item_Desc_Copy_of_Centaurs_Pride"	"Denne nye gjenstanden har ingen beskrivelse."
"DOTA_Item_Desc_Copy_of_Centaurs_Upper_Armor"	"Denne nye gjenstanden har ingen beskrivelse."
"DOTA_Item_Desc_Copy_of_Centaurs_Belt_Buckle"	"Denne nye gjenstanden har ingen beskrivelse."
"DOTA_Item_Desc_Copy_of_Centaurs_Trophies"	"Denne nye gjenstanden har ingen beskrivelse."
"DOTA_Item_Desc_Copy_of_Centaurs_Bracers"	"Denne nye gjenstanden har ingen beskrivelse."
"DOTA_Item_Desc_Greevil_Nose_1"	"
"
"DOTA_Item_Desc_Copy_of_Lions_Default_Weapon"	"Denne nye gjenstanden har ingen beskrivelse."
"DOTA_Item_Desc_Copy_of_Lions_Default_cape"	"Denne nye gjenstanden har ingen beskrivelse."
"DOTA_Item_Desc_Copy_of_Lions_Default_Hat"	"Denne nye gjenstanden har ingen beskrivelse."
"DOTA_Item_Desc_Copy_of_Lions_Default_Shoulders"	"Denne nye gjenstanden har ingen beskrivelse."
"DOTA_Item_Ghost_Orb_of_the_Planeswalker"	"Ghost Orb of the Planeswalker"
"DOTA_Item_Desc_Copy_of_Pucks_Wings"	"Denne nye gjenstanden har ingen beskrivelse."
"DOTA_Item_Desc_Copy_of_Pucks_Tail"	"Denne nye gjenstanden har ingen beskrivelse."
"DOTA_Item_Desc_base_off_hand_ranged_weapon"	"Denne nye gjenstanden har ingen beskrivelse."
"DOTA_Item_troll_warlord_base_weapon_melee"	"
"
"DOTA_Item_troll_warlord_off_hand_base_weapon_melee"	"
"
"DOTA_Item_Premier_League__Admin"	"Premier League - Admin"
"DOTA_Item_League_DreamHackWinter2012_Admin"	"DreamHack Dota 2 Corsair Vengeance Cup ADMIN"
"DOTA_Item_Desc_Copy_of_Medusas_Bow"	"Denne nye gjenstanden har ingen beskrivelse."
"DOTA_Item_Desc_Copy_of_Medusas_Veil"	"Denne nye gjenstanden har ingen beskrivelse."
"DOTA_Item_Desc_Copy_of_Medusas_Chest_Armor"	"Denne nye gjenstanden har ingen beskrivelse."
"DOTA_Item_Desc_Copy_of_Medusas_Bracers"	"Denne nye gjenstanden har ingen beskrivelse."
"DOTA_Item_Desc_Copy_of_Shredder_Drivers_Hat"	"Denne nye gjenstanden har ingen beskrivelse."
"DOTA_Item_Desc_Copy_of_Shredders_Claw"	"Denne nye gjenstanden har ingen beskrivelse."
"DOTA_Item_Desc_Copy_of_Shredders_Chainsaw"	"Denne nye gjenstanden har ingen beskrivelse."
"DOTA_Item_Desc_Copy_of_Shredders_Shoulder_Armor"	"Denne nye gjenstanden har ingen beskrivelse."
"DOTA_Item_Desc_Copy_of_Undyings_Bracer"	"Denne nye gjenstanden har ingen beskrivelse."
"DOTA_Item_Desc_Copy_of_Undyings_Helmet"	"Denne nye gjenstanden har ingen beskrivelse."
"DOTA_Item_Desc_Copy_of_Undyings_Armor"	"Denne nye gjenstanden har ingen beskrivelse."
"DOTA_WearableType_Wand"	"Tryllestav"
"DOTA_WearableType_Axes"	"Økser"
"DOTA_WearableType_Announcer_Bundle"	"Kommentatorsamling"
"DOTA_Item_Desc_Copy_of_Shadow_Demons_Cape"	"Denne nye gjenstanden har ingen beskrivelse."
"DOTA_Item_Desc_Copy_of_Shadow_Demons_Armor"	"Denne nye gjenstanden har ingen beskrivelse."
"DOTA_Item_Desc_Copy_of_Shadow_Demons_Belt"	"Denne nye gjenstanden har ingen beskrivelse."
"DOTA_Item_Cloak_of_the_Stormcrow"	"Cloak of the Stormcrow"
"DOTA_Item_Pile_of_Coal"	"Kullhaug"
"DOTA_Item_Desc_Copy_of_Miranas_Bow"	"Denne nye gjenstanden har ingen beskrivelse."
"DOTA_Item_Desc_Copy_of_Miranas_Mount"	"Denne nye gjenstanden har ingen beskrivelse."
"DOTA_Item_Desc_Copy_of_Miranas_Headdress"	"Denne nye gjenstanden har ingen beskrivelse."
"DOTA_Item_Desc_Copy_of_Miranas_Cape"	"Denne nye gjenstanden har ingen beskrivelse."
"DOTA_Item_Desc_Copy_of_Miranas_Shoulders"	"Denne nye gjenstanden har ingen beskrivelse."
"DOTA_Item_Desc_Copy_of_Miranas_Bracers"	"Denne nye gjenstanden har ingen beskrivelse."
"DOTA_Item_Cloak_of_the_Haruspex"	"Cloak of the Haruspex"
"DOTA_WearableType_Golem"	"Warlock-golem"
"DOTA_WearableType_Armguard"	"Armbeskytter"
"DOTA_Item_Snipers_Weapon"	"Snipers våpen"
"DOTA_Item_Snipers_Cape"	"Snipers kappe"
"DOTA_Item_Desc_Copy_of_Snipers_Weapon"	"Denne nye gjenstanden har ingen beskrivelse."
"DOTA_Item_Desc_Copy_of_Snipers_Cape"	"Denne nye gjenstanden har ingen beskrivelse."
"DOTA_Item_Desc_Copy_of_Snipers_Head_Gear"	"Denne nye gjenstanden har ingen beskrivelse."
"DOTA_Item_Desc_Copy_of_Snipers_Shoulder_Armor"	"Denne nye gjenstanden har ingen beskrivelse."
"DOTA_Item_Desc_Copy_of_Enchantress_Necklace"	"Denne nye gjenstanden har ingen beskrivelse."
"DOTA_Item_Desc_Copy_of_Enchantress_Hair"	"Denne nye gjenstanden har ingen beskrivelse."
"DOTA_Item_Desc_Copy_of_Enchantress_Dress"	"Denne nye gjenstanden har ingen beskrivelse."
"DOTA_Item_Desc_Copy_of_Enchantress_Bracers"	"Denne nye gjenstanden har ingen beskrivelse."
"DOTA_Item_Desc_venomancers_mandibles"	"Denne nye gjenstanden har ingen beskrivelse."
"DOTA_Item_Desc_Copy_of_venomancers_mandibles"	"Denne nye gjenstanden har ingen beskrivelse."
"DOTA_Item_Desc_Venomancers_Limbs"	"Denne nye gjenstanden har ingen beskrivelse."
"DOTA_Item_Desc_Copy_of_Venomancers_Limbs"	"Denne nye gjenstanden har ingen beskrivelse."
"DOTA_Item_Desc_Copy_of_Venomancers_Tail"	"Denne nye gjenstanden har ingen beskrivelse."
"DOTA_Item_Desc_Copy_of_Meepos_Weapon"	"Denne nye gjenstanden har ingen beskrivelse."
"DOTA_Item_Desc_Copy_of_Meepos_Hood"	"Denne nye gjenstanden har ingen beskrivelse."
"DOTA_Item_Desc_Copy_of_Meepos_Backpack"	"Denne nye gjenstanden har ingen beskrivelse."
"DOTA_Item_Desc_Copy_of_Meepos_Shoulderpads"	"Denne nye gjenstanden har ingen beskrivelse."
"DOTA_Item_Desc_Copy_of_Meepos_Bracers"	"Denne nye gjenstanden har ingen beskrivelse."
"DOTA_Item_Desc_Warlock_Ward"	"
"
"DOTA_WearableType_Eye"	"Øye"
"DOTA_Item_Tusks_Hat"	"Tusks hatt"
"DOTA_Item_Tusks_Horns"	"Tusks horn"
"DOTA_Item_Tusks_Weapon"	"Tusks våpen"
"DOTA_Item_Rubicks_Head"	"Rubicks hode"
"DOTA_Item_The_Premier_League_Season_4"	"Premier League Season 4"
"DOTA_Item_OLD__The_Premier_League_Season_4"	"OLD - Premier League Season 4"
"DOTA_WearableType_Claws"	"Klør"
"DOTA_Item_Chained_Snatcher"	"Chained Snatcher"
"DOTA_Item_Chained_Chopper"	"Chained Chopper"
"DOTA_Item_The_Premier_League_Season_4_ADMIN"	"Premier League Season 4 ADMIN"
"DOTA_WearableType_Flask"	"Flaske"
"DOTA_WearableType_Bat"	"Flaggermus"
"DOTA_Item_Chains_of_the_EcclesiastKing"	"Chains of the Ecclesiast-King"
"DOTA_WearableType_Artifact"	"Artefakt"
"DOTA_Item_Cloak_of_Inscrutable_Zeal"	"Cloak of Inscrutable Zeal"
"DOTA_WearableType_Horse"	"Hest"
"DOTA_Item_Desc_Copy_of_bristelback_weapon"	"Denne nye gjenstanden har ingen beskrivelse."
"DOTA_Item_Desc_Copy_of_bristelback_back"	"Denne nye gjenstanden har ingen beskrivelse."
"DOTA_Item_Desc_Copy_of_bristelback_bracer"	"Denne nye gjenstanden har ingen beskrivelse."
"DOTA_Item_Desc_Copy_of_bristelback_head"	"Denne nye gjenstanden har ingen beskrivelse."
"DOTA_Item_Chain_of_Enduring_Torment"	"Chain of Enduring Torment"
"DOTA_WearableType_Ice"	"Is"
"DOTA_Item_Desc_Copy_of_Vengeful_Wings"	"Denne nye gjenstanden har ingen beskrivelse."
"DOTA_Item_Desc_Copy_of_Vengeful_Skirt"	"Denne nye gjenstanden har ingen beskrivelse."
"DOTA_Item_Desc_Copy_of_Vengeful_Bracers"	"Denne nye gjenstanden har ingen beskrivelse."
"DOTA_Item_Desc_Copy_of_Vengeful_Shoulders"	"Denne nye gjenstanden har ingen beskrivelse."
"DOTA_Item_Desc_Copy_of_Vengeful_Hair"	"Denne nye gjenstanden har ingen beskrivelse."
"DOTA_Item_Desc_Copy_of_Vengeful_Weapon"	"Denne nye gjenstanden har ingen beskrivelse."
"DOTA_Item_AMD_Dota2_Premier_League"	"AMD Dota2 Premier League"
"DOTA_Item_Desc_AMD_Dota2_Premier_League"	"AMD, i samarbeid med DotaTalk, er stolte av å gi deg AMD Premier League. I turneringen møtes Sør-Asias fremste lag for å konkurrere om en total premiepott på $5000. To måneder med intens action vil bli kommentert av GoDz, LD, Luminous og Blaze fra BeyondthesummitTV."
"DOTA_Item_AMD_Dota2_Premier_League_ADMIN"	"AMD Dota2 Premier League -ADMIN"
"DOTA_Item_Desc_AMD_Dota2_Premier_League_ADMIN"	"AMD, i samarbeid med DotaTalk, er stolte av å gi deg AMD Premier League. I turneringen møtes Sør-Asias fremste lag for å konkurrere om en total premiepott på $5000. To måneder med intens action vil bli kommentert av GoDz, LD, Luminous og Blaze fra BeyondthesummitTV."
"DOTA_WearableType_Face"	"Ansikt"
"DOTA_Item_Taunt_Victory_Jig"	"Hån: Victory Jig"
"DOTA_Item_Taunt_Celebration_of_Death"	"Hån: Celebration of Death"
"DOTA_Item_Nature"	"Nature"
"DOTA_Item_Desc_Stone_Ruin"	"Se opp for kaoset fra fortiden. 

Inkludert med Premier League Season 5-billetten."
"DOTA_Item_Premier_League_Season_5"	"Premier League Season 5"
"DOTA_Item_Premier_League_Season_5__ADMIN"	"Premier League Season 5 - ADMIN"
"DOTA_Item_Taunt_Sharp_Blade"	"Hån: Sharp Blade"
"DOTA_Item_Taunt__Shake_Your_Money_Maker"	"Hån: Shake Your Money Maker"
"DOTA_Item_Desc_Copy_of_Lunas_Helmet"	"Denne nye gjenstanden har ingen beskrivelse."
"DOTA_Item_Desc_Copy_of_Lunas_Mount"	"Denne nye gjenstanden har ingen beskrivelse."
"DOTA_Item_Desc_Copy_of_Lunas_Shield"	"Denne nye gjenstanden har ingen beskrivelse."
"DOTA_Item_Desc_Copy_of_Lunas_Weapon"	"Denne nye gjenstanden har ingen beskrivelse."
"DOTA_Item_Gemmed_Bracers_of_the_Priest_Kings"	"Gemmed Bracers of the Priest Kings"
"DOTA_Item_Gemmed_Mitre_of_the_Priest_Kings"	"Gemmed Mitre of the Priest Kings"
"DOTA_Item_Gemmed_Pauldrons_of_the_Priest_Kings"	"Gemmed Pauldrons of the Priest Kings"
"DOTA_Item_Desc_Copy_of_Abaddons_Cape"	"Denne nye gjenstanden har ingen beskrivelse."
"DOTA_Item_Desc_Copy_of_Abaddons_Helmet"	"Denne nye gjenstanden har ingen beskrivelse."
"DOTA_Item_Desc_Copy_of_Abaddons_Shoulder_Armor"	"Denne nye gjenstanden har ingen beskrivelse."
"DOTA_Item_Desc_Copy_of_Abaddons_Weapon"	"Denne nye gjenstanden har ingen beskrivelse."
"DOTA_Item_AMD_Dota2_Premier_League_Season_2"	"AMD Dota2 Premier League Season 2"
"DOTA_Item_AMD_Dota2_Premier_League_Season_2__ADMIN"	"AMD Dota2 Premier League Season 2 - ADMIN"
"DOTA_Item_Armguard_of_the_Steppe"	"Armguard of the Steppe"
"DOTA_Item_Desc_AMD_Dota2_Premier_League_Season_2"	"Den etterlengtede AMD Premier League Season Two er tilbake. Se på at Sørøst-Asias fremste lag; Orange, Zenith, Mufc, Vici Gaming og flere konkurrerer om en total premiepott på $5000. Denne ene måneden med intens action vil bli brakt til deg av DotaTalk og drevet av AMD."
"DOTA_Item_Desc_Copy_of_AMD_Dota2_Premier_League_Season_2"	"Den etterlengtede AMD Premier League Season Two er tilbake. Se på at Sør-Asias fremste lag; Tongfu, Zenith, Orange og flere konkurrerer om en total premiepott på $5000. Denne ene måneden med intens action vil bli brakt til deg av DotaTalk og drevet av AMD."
"DOTA_Item_Cloak_of_the_Nimble_Edge"	"Cloak of the Nimble Edge"
"DOTA_Item_Gloves_of_Retribution"	"Gloves of Retribution"
"DOTA_Item_Taunt_Keep_an_Ear_Out"	"Hån: Keep an Ear Out"
"DOTA_Item_Taunt_Shake_Your_Money_Maker"	"Hån: Shake Your Money Maker"
"DOTA_Item_Taunt_The_Magic_Ends_Here"	"Hån: The Magic Ends Here"
"DOTA_Item_Yonexs_Rage"	"Yonex's Rage"
"DOTA_WearableType_Wolf"	"Ulv"
"DOTA_Item_Desc_AMD_Dota2_Premier_League_Season_2__ADMIN"	"Den etterlengtede AMD Premier League Season Two er tilbake. Se på at Sør-Asias fremste lag; Orange, Zenith, Mufc, Vici Gaming og flere konkurrerer om en total premiepott på $5000. Denne ene måneden med intens action vil bli brakt til deg av DotaTalk og drevet av AMD."
"DOTA_Item_Desc_Copy_of_Earthshakers_Bracers"	"Denne nye gjenstanden har ingen beskrivelse."
"DOTA_Item_Desc_Copy_of_Earthshakers_Totem"	"Denne nye gjenstanden har ingen beskrivelse."
"DOTA_Item_Mok"	"Mok"
"DOTA_WearableType_Arm"	"Arm"
"DOTA_WearableType_Passport_Fantasy_Team"	"Kompendium-fantasilag"
"DOTA_Item_Ataxia"	"Ataxia"
"DOTA_Item_Autograph"	"Autograf"
"DOTA_Item_Cloak_of_the_Boreal_Watch"	"Cloak of the Boreal Watch"
"DOTA_Item_Cloak_of_the_Northern_Wind"	"Cloak of the Northern Wind"
"DOTA_Item_Heat"	"Hete"
"DOTA_Item_Starlight_Armguards"	"Starlight Armguards"
"DOTA_WearableType_Beast"	"Beist"
"DOTA_Item_Bladebreaker_Armguards"	"Bladebreaker Armguards"
"DOTA_Item_Chained_Beauty"	"Chained Beauty"
"DOTA_Item_Chained_Guard"	"Chained Guard"
"DOTA_Item_Chained_Spur"	"Chained Spur"
"DOTA_Item_Chained_Wings"	"Chained Wings"
"DOTA_Item_Cloak_of_the_Dark_Wraith"	"Cloak of the Dark Wraith"
"DOTA_WearableType_Masks"	"Masker"
"DOTA_Item_StarSeries_Season_7"	"StarSeries sesong 7"
"DOTA_Item_StarSeries_Season_7ADMIN"	"StarSeries sesong 7-ADMIN"
"DOTA_Item_Baekho"	"Baekho"
"DOTA_Item_Desc_Copy_of_WETA_Placeholder_1"	"Denne nye gjenstanden har ingen beskrivelse."
"DOTA_Item_Desc_Copy_of_WETA_Placeholder_2"	"Denne nye gjenstanden har ingen beskrivelse."
"DOTA_Item_Desc_Copy_of_WETA_Placeholder_3"	"Denne nye gjenstanden har ingen beskrivelse."
"DOTA_Item_Desc_Copy_of_SteelSeries_Malaysia_Cup__October"	"Denne nye gjenstanden har ingen beskrivelse."
"DOTA_Item_Azuremir"	"Azuremir"
"DOTA_Teams_Absolute_Legends"	"Absolute Legends"
"DOTA_Teams_Alliance"	"Alliance"
"DOTA_Teams_CLG"	"CLG"
"DOTA_Teams_Complexity"	"Complexity"
"DOTA_Teams_Darer"	"Darer"
"DOTA_Teams_Dignitas"	"Dignitas"
"DOTA_Teams_DK"	"DK"
"DOTA_Teams_EHOME"	"EHOME"
"DOTA_Teams_EvilGeniuses"	"Evil Geniuses"
"DOTA_Teams_Fnatic"	"Fnatic"
"DOTA_Teams_iG"	"iG"
"DOTA_Teams_LGD"	"LGD"
"DOTA_Teams_LGD_Int"	"LGD.Int"
"DOTA_Teams_Liquid"	"Liquid"
"DOTA_Teams_Mousesports"	"Mousesports"
"DOTA_Teams_mTw"	"mTw"
"DOTA_Teams_MUFC"	"MUFC"
"DOTA_Teams_NaVi"	"NaVi"
"DOTA_Teams_Orange"	"Orange"
"DOTA_Teams_TongFu"	"TongFu"
"DOTA_Teams_WorldElite"	"World Elite"
"DOTA_Teams_Zenith"	"Zenith"
"DOTA_Corporations_Liquid_ixmike88"	"Liquid`ixmike88"
"DOTA_Corporations_iceiceice"	"iceiceice"
"DOTA_Corporations_Kuroky"	"Kuroky"
"DOTA_Corporations_Sing"	"Sing"
"DOTA_Item_Desc_Bloodstone_Blade"	" 
"
"DOTA_Item_Desc_Bloodstone_Blade__OffHand"	" "
"DOTA_Item_Desc_Copy_of_Ember_Spirits_Back_Item"	"Denne nye gjenstanden har ingen beskrivelse."
"DOTA_Item_Desc_Copy_of_Ember_Spirits_Belt_Item"	"Denne nye gjenstanden har ingen beskrivelse."
"DOTA_Item_Desc_Copy_of_Ember_Spirits_Head_Item"	"Denne nye gjenstanden har ingen beskrivelse."
"DOTA_Item_Desc_Copy_of_Ember_Spirits_Main_Weapon"	"Denne nye gjenstanden har ingen beskrivelse."
"DOTA_Item_Desc_Copy_of_Ember_Spirits_Offhand_Weapon"	"Denne nye gjenstanden har ingen beskrivelse."
"DOTA_Item_Desc_Copy_of_Ember_Spirits_Shoulders"	"Denne nye gjenstanden har ingen beskrivelse."
"DOTA_Item_Desc_Crown_of_Omoz"	" "
"DOTA_Item_Desc_Dark_Tracer"	" "
"DOTA_Item_Desc_Demonic_Collar"	" "
"DOTA_Item_Desc_Demonshard"	" "
"DOTA_Item_Desc_Dorsal_Doom"	" "
"DOTA_Item_Desc_Hook_of_the_Sorrowful_Prey"	" 
"
"DOTA_Item_Desc_Icewrack_Pack"	" 
"
"DOTA_Item_Desc_Lighted_Scepter_of_Serendipity"	" 
"
"DOTA_Item_Desc_Mantle_of_the_Crystalline_Queen"	" 
"
"DOTA_Item_Desc_Monarch"	" 
"
"DOTA_Item_Desc_Mr_Depth_Driller"	" 
"
"DOTA_Item_Desc_Sanurok_the_Ever_Able"	" 
"
"DOTA_Item_Desc_Spell_Devourer"	" 
"
"DOTA_Item_Desc_The_Elder_Shield"	" 
"
"DOTA_Item_Desc_The_Torchbearer"	" 
"
"DOTA_Item_Desc_Tiara_of_the_Crystalline_Queen"	" 
"
"DOTA_WearableType_Loading_Screen"	"Lasteskjerm"
"DOTA_Item_Desc_Copy_of_Saratov_Cup_Open_Finals"	"Denne nye gjenstanden har ingen beskrivelse."
"DOTA_Item_80_Battle_Point_Booster_500_minutes"	"80% Battle Point Booster (500 minutter)"
"DOTA_Item_Desc_Clash_of_Heroes_II"	"Denne nye gjenstanden har ingen beskrivelse."
"DOTA_Item_Sri_Lanka_Cyber_Games_2013"	"Sri Lanka Cyber Games 2013"
"DOTA_WearableType_Collector_of_Shining_Fragments"	"Battle Point Booster"
"DOTA_Item_Desc_Copy_of_Invokers_Bracer"	"Denne nye gjenstanden har ingen beskrivelse."
"DOTA_Item_Desc_Hallowed_Horde"	" "
"DOTA_Corporations_D2L"	"D2L"
"DOTA_Corporations_BZZ"	"BZZ"
"DOTA_Corporations_CaspeRRR"	"CaspeRRR"
"DOTA_WearableType_Armbands"	"Armbånd"
"DOTA_WearableType_Fur"	"Pels"
"DOTA_Item_Ashtongue"	"Ashtongue"
"DOTA_Item_Anunkasan"	"Anunkasan"
"DOTA_Item_Desc_Helm_of_the_Light_Hunter"	"
"
"DOTA_WearableType_Eagle"	"Ørn"
"DOTA_Item_Wild_West"	"Wild West"
"DOTA_WearableType_Anvil"	"Anvil"
"DOTA_WearableType_Jaw"	"Kjeve"
"DOTA_Teams_Cloud9"	"Cloud9"
"DOTA_Item_Desc_Copy_of_Wraith_Kings_head"	"Denne nye gjenstanden har ingen beskrivelse."
"DOTA_WearableType_Armguards"	"Armbeskyttere"
"DOTA_Teams_Zephyr"	"Zephyr"
"DOTA_Teams_ViciGaming"	"ViCi Gaming"
"DOTA_Teams_Titan"	"Titan"
"DOTA_Teams_Team_Empire"	"Team Empire"
"DOTA_Teams_NewBee"	"NewBee"
"DOTA_Corporations_DD"	"DD"
"DOTA_Corporations_Ars_Art"	"Ars-Art"
"DOTA_Corporations_SOLO"	"SOLO"
"DOTA_Corporations_YYF"	"YYF"
"DOTA_Corporations_ZSMJ"	"ZSMJ"
"DOTA_Corporations_NS"	"NS"
"DOTA_Corporations_Funn1k"	"Funn1k"
"DOTA_WearableType_Bomb"	"Bombe"
"DOTA_Corporations_Arteezy"	"Arteezy"
"DOTA_Corporations_Mushi"	"Mushi"
"DOTA_Corporations_BuLba"	"BuLba"
"DOTA_WearableType_Head_"	"Hode"
"DOTA_WearableType_Bundle_"	"Pakke"
"DOTA_WearableType_Tree"	"Tre"
"DOTA_WearableType_Music"	"Musikk"
"DOTA_Item_War_Machine"	"War Machine"
"DOTA_Item_War_Machine_Blaster_Shell"	"War Machine Blaster Shell"
"DOTA_Item_War_Machine_Body_Armor"	"War Machine Body Armor"
"DOTA_Item_War_Machine_Electro_Cog"	"War Machine Electro Cog"
"DOTA_Item_War_Machine_Metal_Mask"	"War Machine Metal Mask"
"DOTA_Item_War_Machine_Trench_Digger"	"War Machine Trench Digger"
"DOTA_Item_Wargod_of_the_Bladekeeper"	"Wargod of the Bladekeeper"
"DOTA_Set_Acidic_Flytrap"	"Acidic Flytrap"
"DOTA_Set_Agaric_Flourish"	"Agaric Flourish"
"DOTA_Set_Balance_of_the_Bladekeeper"	"Balance of the Bladekeeper"
"DOTA_Set_Battletrap"	"Battletrap"
"DOTA_Set_Champion_of_Discord"	"Champion of Discord"
"DOTA_Set_Eldwurms_Touch"	"Eldwurm's Touch"
"DOTA_Set_Frozen_Emperor"	"Frozen Emperor"
"DOTA_Set_Ghastly_Matriarch"	"Ghastly Matriarch"
"DOTA_Set_Keen_Machine"	"Keen Machine"
"DOTA_Set_Legacy_of_Infernal_Wings"	"Legacy of Infernal Wings"
"DOTA_Set_Monstrous_Reprisal"	"Monstrous Reprisal"
"DOTA_Set_Scavenger_of_the_Basilisk"	"Scavenger of the Basilisk"
"DOTA_Set_The_Fiend_Cleaver"	"The Fiend Cleaver"
"DOTA_Set_The_Ol_Steam_Chopper"	"The Ol' Steam Chopper"
"DOTA_Set_War_Machine"	"War Machine"
"DOTA_WearableType_Beads"	"Perler"
"DOTA_WearableType_Cog"	"Tannhjul"
"DOTA_WearableType_Jawbone"	"Kjeveben"
"DOTA_WearableType_Mandible"	"Underkjeve"
"DOTA_WearableType_Set"	"Sett"
"DOTA_WearableType_Shovel"	"Spade"
"DOTA_WearableType_Tentacles"	"Tentakler"
"DOTA_Item_Desc_Balance_of_the_Bladekeeper"	"Kjøp av dette settet bidrar til premiepotten for XMG Captain's Draft 2.0."
"DOTA_WearableType_Bo"	"Bo"
"DOTA_Item_The_Sabre_of_the_Sea_Empress"	"Hav-keiserinnens sabel"
"DOTA_Item_Sri_Lanka_Cyber_Games_SLCG_2014"	"Sri Lanka Cyber Games (SLCG) 2014"
"DOTA_WearableType_Armplates"	"Armplater"
"DOTA_Item_AD2L_Season_7"	"AD2L sesong 7"
"DOTA_Item_Luki_ESport"	"Luki E-Sport"
"DOTA_Item_Desc_Stavropol_Dota_League_"	"­"
"DOTA_Item_ancientone_guise"	"ancientone_guise"
"DOTA_Item_ancientone_horns"	"ancientone_horns"
"DOTA_Item_ancientone_totem"	"ancientone_totem"
"DOTA_Item_diving_armor_armor"	"diving_armor_armor"
"DOTA_Item_diving_armor_head"	"diving_armor_head"
"DOTA_Item_Lampions_League_III"	"Lampions League III"
"DOTA_Item_Rookie_Cup_Season_1"	"Rookie Cup sesong 1"
"DOTA_Item_Red_Bull_LAN__San_Francisco"	"Red Bull LAN - San Francisco"
"DOTA_Teams_Virtus_Pro"	"Virtus.Pro"
"DOTA_Item_Desc_Echoes_of_the_Eyrie_Loading_Screen"	" 


"
"DOTA_Item_Desc_Pauldrons_of_Tustakuri"	" 


"
"DOTA_Item_Desc_Samurai_Soul_Loading_Screen"	" 


"
"DOTA_Item_Desc_Shoulders_of_Tustakuri"	" 

"
"DOTA_Item_Desc_Totem_of_the_Samurai_Soul"	" 



"
"DOTA_Item_Desc_Vanguard_Fireblade"	" 



"
"DOTA_Item_Sri_Lanka_Cyber_Games_SLCG_2015"	"Sri Lanka Cyber Games (SLCG) 2015"
"DOTA_WearableType_Cogs"	"Tannhjul"
"DOTA_Teams_Arrow_Gaming"	"Arrow Gaming"
"DOTA_Teams_CIS_Game"	"CIS Game"
"DOTA_Teams_Evil_Geniuses"	"Evil Geniuses"
"DOTA_Teams_MVP_Phoenix"	"MVP Phoenix"
"DOTA_Teams_NaVi_NA"	"NaVi NA"
"DOTA_Teams_ViCi_Gaming"	"ViCi Gaming"
"DOTA_Teams_World_Elite"	"World Elite"
"DOTA_Item_AD2L_Season_10"	"AD2L sesong 10"
"DOTA_Item_Desc_Eyes_of_the_Watchroot"	" ­"
"DOTA_Item_AquaCup_#1"	"AquaCup #1"
"DOTA_Item_Desc_AquaCup_#1"	"Velkommen til den første Aqua Cup. Vi håper å kunne tilby engasjerende turneringer for amatører i DotA 2. Alle lag, uansett ferdighetsnivå, er velkomne til å delta i denne enkle turneringen. Turneringen opererer med \"single elimination\"-utslagsregler."
"DOTA_Item_Desc_CZSK_Dota_2_League_Season_7"	"Den sjuende sesongen av Czech-Slovakia-ligaen vil finne sted over en periode på to måneder. Vinneren vil motta en pengepremie!"
"DOTA_Item_Desc_Gamers_Lounge_WinterCup"	"Faraoer fra hele Egypt konkurrerer om Gamers Lounge WinterCup-tittelen!"
"DOTA_Item_Desc_Glazov_Cup"	"Spillere fra Udmurtia og CIS-samveldet kommer til å spille en internliga"
"DOTA_Item_Desc_Hell_League_"	"Registrer ditt lag og kjemp dere gjennom gruppespillet mot finalen"
"DOTA_Item_Desc_IGA_amateur_league_S1"	"Dette er den første fullstendige amatørligaen for DOTA 2 i midtøsten, holdt på nett. Amatørlag konkurrerer med hverandre for å nå høyere rangeringer i DOTA 2-samfunnet"
"DOTA_Item_Desc_Sudamerican_Master_4"	"Fjerde utgave av en av de største turneringene i Amerika. De beste lagene i Sør- og Nord-Amerika konkurrerer om å vinne over $4000."
"DOTA_Item_Desc_Venezuela_Dota_2_cup_Season_2"	"Venezuela-turneringen samler 16 lag for å konkurrere om en plass i finalen."
"DOTA_Item_Desc_Vortex_Gaming_Tournament_by_MOL_Indonesia"	"Nividia ICafe Vortex Gaming Jambi Dota 2-turnering organisert av MOL Indonesia
IDR 25.000.000"
"DOTA_Item_Desc_joinDOTA_League_#9"	"Den globale Dota 2-ligaen for alle. Dette inkluderer de fleste kamper fra den semi-profesjonelle divisjon 2 og noen kamper fra amatørdivisjonene."
"DOTA_Item_ESL_One_Manila_2016"	"ESL One Manila 2016"
"DOTA_Item_Gamers_Lounge_WinterCup"	"Gamers Lounge WinterCup"
"DOTA_Item_Glazov_Cup"	"Glazov Cup"
"DOTA_Item_Hell_League_"	"Hell League "
"DOTA_Item_IGA_amateur_league_S1"	"IGA amateur league S1"
"DOTA_Item_LANSKILL_WINTER_2016"	"LANSKILL WINTER 2016"
"DOTA_Item_Respawn_League_Dota_2_Edition_2016"	"Respawn League: Dota 2 Edition 2016"
"DOTA_Item_Sudamerican_Master_4"	"Sudamerican Master 4"
"DOTA_Item_The_Kaolin_Cup"	"The Kaolin Cup"
"DOTA_Item_Vortex_Gaming_Tournament_by_MOL_Indonesia"	"Vortex Gaming Tournament av MOL Indonesia"
"DOTA_Item_joinDOTA_League_#9"	"joinDOTA League #9"
"DOTA_Item_Blade_of_the_Rekindled_Ashes"	"Blade of the Rekindled Ashes"
"DOTA_Item_Guard_of_the_Rekindled_Ashes"	"Guard of the Rekindled Ashes"
"DOTA_Item_Headdress_of_the_Rekindled_Ashes"	"Headdress of the Rekindled Ashes"
"DOTA_Item_OffHand_Blade_of_the_Rekindled_Ashes"	"Off-Hand Blade of the Rekindled Ashes"
"DOTA_Item_Rekindled_Ashes"	"Rekindled Ashes"
"DOTA_Item_Robe_of_the_Rekindled_Ashes"	"Robe of the Rekindled Ashes"
"DOTA_Item_Shoulders_of_the_Rekindled_Ashes"	"Shoulders of the Rekindled Ashes"
"DOTA_Set_Rekindled_Ashes"	"Rekindled Ashes"
"DOTA_Item_Desc_The_Gathering_2016"	"The Gathering er Norges største datatreff og har eksistert siden 1992. Årets Dota 2-turnering har en premiepott på 39 000 kroner (4 000 dollar)."
"DOTA_Item_Adoring_Wingfall"	"Adoring Wingfall"
"DOTA_Item_Backplates_of_the_Razorwyrm"	"Backplates of the Razorwyrm"
"DOTA_Item_Belt_of_the_Razorwyrm"	"Belt of the Razorwyrm"
"DOTA_Item_Bindings_of_the_Battleranger"	"Bindings of the Battleranger"
"DOTA_Item_Bow_of_the_Battleranger"	"Bow of the Battleranger"
"DOTA_Item_Bow_of_the_Urushin_Huntsman"	"Bow of the Urushin Huntsman"
"DOTA_Item_Cloak_of_the_Battleranger"	"Cloak of the Battleranger"
"DOTA_Item_Controlled_Burn"	"Controlled Burn"
"DOTA_Item_Copa_de_Abertura_LBEE"	"Copa de Abertura LBEE"
"DOTA_Item_DA_5v5_Team_Series"	"DA 5v5 Team Series"
"DOTA_Item_Gauntlets_of_the_Razorwyrm"	"Gauntlets of the Razorwyrm"
"DOTA_Item_Golden_Fortunes_Tout"	"Golden Fortune's Tout"
"DOTA_Item_Immortal_Gardens"	"Immortal Gardens"
"DOTA_Item_Onibi"	"Onibi"
"DOTA_Item_Pauldrons_of_the_Battleranger"	"Pauldrons of the Battleranger"
"DOTA_Item_Phantom_Concord"	"Phantom Concord"
"DOTA_Item_Pin_AntiMage"	"Pins: Anti-Mage"
"DOTA_Item_Pin_Bristleback"	"Pins: Bristleback"
"DOTA_Item_Pin_Crystal_Maiden"	"Pins: Crystal Maiden"
"DOTA_Item_Pin_Earthshaker"	"Pins: Earthshaker"
"DOTA_Item_Pin_Enigma"	"Pins: Enigma"
"DOTA_Item_Pin_Invoker_"	"Pins: Invoker "
"DOTA_Item_Pin_Io"	"Pins: Io"
"DOTA_Item_Pin_Lina"	"Pins: Lina"
"DOTA_Item_Pin_Meepo"	"Pins: Meepo"
"DOTA_Item_Pin_Phoenix"	"Pins: Phoenix"
"DOTA_Item_Pin_Pudge"	"Pins: Pudge"
"DOTA_Item_Pin_Riki"	"Pins: Riki"
"DOTA_Item_Pin_Tiny"	"Pins: Tiny"
"DOTA_Item_Pin_Tusk_"	"Pins: Tusk "
"DOTA_Item_Pin_Warlock"	"Pins: Warlock"
"DOTA_Item_Pin_Wraith_King_"	"Pins: Wraith King "
"DOTA_Item_Portfolio_of_Heroes_Ascendant"	"Portfolio of Heroes Ascendant"
"DOTA_Item_Quiver_of_the_Battleranger"	"Quiver of the Battleranger"
"DOTA_Item_Quiver_of_the_Urushin_Huntsman"	"Quiver of the Urushin Huntsman"
"DOTA_Item_Reflex_League"	"Reflex League"
"DOTA_Item_STAN_Dota_2"	"STAN Dota 2"
"DOTA_Item_Scale_of_the_Razorwyrm"	"Scale of the Razorwyrm"
"DOTA_Item_Sentinels_of_the_Urushin_Huntsman"	"Sentinels of the Urushin Huntsman"
"DOTA_Item_Skull_of_the_Razorwyrm"	"Skull of the Razorwyrm"
"DOTA_Item_Smeevils_Penance"	"Smeevil's Penance"
"DOTA_Item_Style_of_the_Battleranger"	"Style of the Battleranger"
"DOTA_Item_Talons_of_the_Urushin_Huntsman"	"Talons of the Urushin Huntsman"
"DOTA_Item_The_International_2016"	"The International 2016"
"DOTA_Item_The_International_2016_HUD"	"The International 2016 HUD"
"DOTA_Item_UGC_League_Dota_2_Premium_2016"	"UGC League Dota 2 Premium 2016"
"DOTA_Item_Urushin_Huntsman"	"Urushin Huntsman"
"DOTA_Item_Virgas_Arc"	"Virga's Arc"
"DOTA_Item_Weather_Ash"	"Weather Ash"
"DOTA_Item_Weather_Aurora"	"Weather Aurora"
"DOTA_Item_Weather_Spring"	"Weather Spring"
"DOTA_Item_World_Electronic_sports_games"	"World Electronic sports games"
"DOTA_Item_Wrap_of_the_Urushin_Huntsman"	"Wrap of the Urushin Huntsman"
"DOTA_Item_Boris_Baumhauer"	"Boris Baumhauer"
"DOTA_WearableType_Grass_Cutter_Extraordinaire"	"Ekstraordinær gressklipper"
"DOTA_Item_Play4Series"	"Play4Series"
"DOTA_Teams_Ad_Finem"	"Ad Finem"
"DOTA_Teams_Faceless"	"Faceless"
"DOTA_Teams_IG_Vitality"	"IG.Vitality"
"DOTA_Teams_LGD_ForeverYoung"	"LGD.ForeverYoung"
"DOTA_Teams_NP"	"NP"
"DOTA_Teams_WarriorsGaming_Unity"	"WarriorsGaming.Unity"
"DOTA_Item_Desc_TI7_League"	"http://steamcommunity.com/sharedfiles/filedetails/?id=876336836"
"DOTA_Item_CHINA_DOTA2_SUPER_MAJOR"	"CHINA DOTA2 SUPER MAJOR"
"DOTA_Item_ESL_One_Birmingham_2018_powered_by_Intel"	"ESL One Birmingham 2018 sponset av Intel"
}
}
