"lang"
{
"Language"	"schinese"
"Tokens"
{
"addon_game_name"	"乱战先锋"
"[english]addon_game_name"	"Overthrow"
"DOTA_Tooltip_modifier_get_xp"	"黄金光环"
"[english]DOTA_Tooltip_modifier_get_xp"	"Golden Aura"
"DOTA_Tooltip_modifier_get_xp_Description"	"获得的金钱和经验将会更多！"
"[english]DOTA_Tooltip_modifier_get_xp_Description"	"Gaining more gold and experience!"
"DOTA_Tooltip_modifier_get_xp_global"	"全屏光环"
"[english]DOTA_Tooltip_modifier_get_xp_global"	"Global Aura"
"DOTA_Tooltip_modifier_get_xp_global_Description"	"正在获得金钱和经验"
"[english]DOTA_Tooltip_modifier_get_xp_global_Description"	"Gaining gold and experience"
"DOTA_Tooltip_modifier_fountain_aura_effect_lua"	"泉水光环"
"[english]DOTA_Tooltip_modifier_fountain_aura_effect_lua"	"Fountain Aura"
"DOTA_Tooltip_modifier_fountain_aura_effect_lua_Description"	"治疗中"
"[english]DOTA_Tooltip_modifier_fountain_aura_effect_lua_Description"	"Healing"
"DOTA_Tooltip_ability_item_bag_of_gold"	"300金钱"
"[english]DOTA_Tooltip_ability_item_bag_of_gold"	"300 Gold"
"DOTA_Tooltip_ability_item_treasure_chest"	"宝箱"
"[english]DOTA_Tooltip_ability_item_treasure_chest"	"Treasure Chest"
"PointsToWin"	"只需 +{d:points_to_win}分"
"[english]PointsToWin"	"+{d:points_to_win} more"
"PointsToWin_CloseToVictory"	"只需 +{d:points_to_win}分"
"[english]PointsToWin_CloseToVictory"	"+{d:points_to_win} more"
"PointsToWin_VeryCloseToVictory"	"只需 +{d:points_to_win}分！"
"[english]PointsToWin_VeryCloseToVictory"	"+{d:points_to_win} more!"
"PointsToWin_Victory"	"胜利！"
"[english]PointsToWin_Victory"	"Victory!"
"InstructionsTitle"	"乱战先锋"
"[english]InstructionsTitle"	"OVERTHROW"
"InstructionsObjective"	"游戏目标"
"[english]InstructionsObjective"	"OBJECTIVE"
"InstructionsObjectiveText"	"不要对敌人心慈手软！率先达到目标人头数，或者在回合结束时取得最高的人头数即可赢得游戏的胜利。"
"[english]InstructionsObjectiveText"	"Slay your enemies! Be the first to earn the goal number of kills, or the team with the most kills when the round ends, and you will be victorious."
"InstructionsHowToPlay"	"玩法介绍"
"[english]InstructionsHowToPlay"	"HOW TO PLAY"
"InstructionsLines"	"-在迈达斯王座周围获得额外的金钱和经验。<br>
-抢到乱战霸王扔出的大金币将获得额外金钱。 <br>
-千万留意运出的装备。装备出现时地图上会显示相应的图标。 <br>
-人头数越少，截到的装备将会越好。 <br>
-不要放过其他两队的任何英雄。"
"[english]InstructionsLines"	"-Approach the Midas Throne to earn bonus gold and experience.<br>
													-Snatch up any giant coins the Over Boss tosses to earn even more gold.<br>
													-Keep an eye out for item deliveries. An icon will appear on your map where an item will appear.<br>
													-The fewer kills your team has, the better the item you will receive from a delivery.<br>
													-Slay anyone who isn't on your team."
"Chest"	"装备"
"[english]Chest"	"ITEM"
"ItemWillSpawn"	"即将开始运送！"
"[english]ItemWillSpawn"	"IS ABOUT TO BE DELIVERED!"
"ItemHasSpawned"	"正在运送途中！"
"[english]ItemHasSpawned"	"IS ON ITS WAY!"
"Unassigned"	"未分配阵营"
"[english]Unassigned"	"Unassigned Team"
"Spectator"	"观众"
"[english]Spectator"	"Spectator Team"
"Neutrals"	"中立阵营"
"[english]Neutrals"	"Neutral Team"
"NoTeam"	"无阵营"
"[english]NoTeam"	"No Team"
"DOTA_GoodGuys"	"青虎队"
"[english]DOTA_GoodGuys"	"Teal Tiger"
"DOTA_BadGuys"	"黄猴队"
"[english]DOTA_BadGuys"	"Yellow Monkey"
"DOTA_Custom1"	"粉龙队"
"[english]DOTA_Custom1"	"Pink Dragon"
"DOTA_Custom2"	"橙犬队"
"[english]DOTA_Custom2"	"Orange Dog"
"DOTA_Custom3"	"蓝鸡队"
"[english]DOTA_Custom3"	"Blue Rooster"
"DOTA_Custom4"	"绿羊队"
"[english]DOTA_Custom4"	"Green Ram"
"DOTA_Custom5"	"棕鼠队"
"[english]DOTA_Custom5"	"Brown Rat"
"DOTA_Custom6"	"青豚队"
"[english]DOTA_Custom6"	"Cyan Boar"
"DOTA_Custom7"	"茶蛇队"
"[english]DOTA_Custom7"	"Olive Snake"
"DOTA_Custom8"	"紫马队"
"[english]DOTA_Custom8"	"Purple Horse"
"OverthrowTextPickup"	"拾取了"
"[english]OverthrowTextPickup"	"HAS PICKED UP"
"Remaining"	"剩余"
"[english]Remaining"	"REMAINING"
"Overtime"	"超时！"
"[english]Overtime"	"OVERTIME!"
"OvertimeInstructions"	"分获得后胜利"
"[english]OvertimeInstructions"	"SCORE TO WIN"
"KillMessageText"	"杀死了先锋"
"[english]KillMessageText"	"HAS KILLED THE LEADER"
"KillMessageBounty"	"获得了500额外金钱！"
"[english]KillMessageBounty"	"FOR 500 BONUS GOLD!"
"addonname"	"乱战先锋"
"[english]addonname"	"Overthrow"
"overthrow_game_info_header_objective"	"游戏目标："
"[english]overthrow_game_info_header_objective"	"Objective:"
"overthrow_brief_description"	"不要放过任何敌人！首个达到人头上限的队伍获胜！"
"[english]overthrow_brief_description"	"Slay your enemies! First team to hit the kill limit wins!"
"overthrow_game_info_header_how_to_play"	"玩法介绍："
"[english]overthrow_game_info_header_how_to_play"	"How To Play:"
"overthrow_game_info_throne"	"聚集在<span class='midas_throne'>迈达斯王座</span>周围可以获得额外的<span class='gold'>金钱</span>和<span class='xp'>经验</span>。"
"[english]overthrow_game_info_throne"	"Approach the <span class='midas_throne'>Midas Throne</span> to earn bonus <span class='gold'>gold</span> and <span class='xp'>experience</span>."
"overthrow_game_info_coins"	"抢到<span class='overboss'>乱战霸主</span>扔出的大金币可以获得大量<span class='gold'>金钱</span>。"
"[english]overthrow_game_info_coins"	"Snatch up coins the <span class='overboss'>Overboss</span> tosses to earn more <span class='gold'>gold</span>."
"overthrow_game_info_items"	"留意<span class='treasure'>宝箱</span>的运送情况。有<span class='items'>装备</span>出现时地图上会出现相应的图标。"
"[english]overthrow_game_info_items"	"Keep an eye out for <span class='treasure'>treasure</span> deliveries. An icon will appear on your map where an <span class='items'>item</span> will appear."
"overthrow_game_info_tips_header"	"小贴士："
"[english]overthrow_game_info_tips_header"	"Tips:"
"overthrow_game_info_tip01"	"当前的先锋头上都会有金色的王冠标志，将其击杀可以获得额外金钱。"
"[english]overthrow_game_info_tip01"	"The current leader has a gold crown, and you will get extra gold for killing them."
"overthrow_game_info_tip02"	"截到的装备可以给予队友，或在基地里售出。"
"[english]overthrow_game_info_tip02"	"Items can be given to teammates or sold at your base."
"overthrow_game_info_tip03"	"有时候面对强大的对手，可能需要跟其他的队伍通力合作。"
"[english]overthrow_game_info_tip03"	"You may need to coordinate with an opposing team to take out a strong opponent."
"overthrow_game_info_tip04"	"人头数越少，截到的装备将会越好。"
"[english]overthrow_game_info_tip04"	"The fewer kills your team has, the stronger items you will recieve from a delivery."
"npc_dota_hero_bounty_hunter"	"赏金猎人（微调）"
"[english]npc_dota_hero_bounty_hunter"	"Bounty Hunter (Modified)"
"npc_dota_hero_broodmother"	"育母蜘蛛（微调）"
"[english]npc_dota_hero_broodmother"	"Broodmother (Modified)"
"npc_dota_hero_necrolyte"	"瘟疫法师（微调）"
"[english]npc_dota_hero_necrolyte"	"Necrophos (Modified)"
"npc_dota_hero_riki"	"力丸（微调）"
"[english]npc_dota_hero_riki"	"Riki (Modified)"
"npc_dota_hero_silencer"	"沉默术士（微调）"
"[english]npc_dota_hero_silencer"	"Silencer (Modified)"
"npc_dota_hero_zuus"	"宙斯（微调）"
"[english]npc_dota_hero_zuus"	"Zeus (Modified)"
"npc_dota_hero_pudge"	"帕吉（微调）"
"[english]npc_dota_hero_pudge"	"Pudge (Modified)"
"DOTA_Tooltip_Ability_item_ward_sentry"	"岗哨守卫（微调）"
"[english]DOTA_Tooltip_Ability_item_ward_sentry"	"Sentry Ward (Modified)"
"DOTA_Tooltip_Ability_item_dust"	"显影之尘（微调）"
"[english]DOTA_Tooltip_Ability_item_dust"	"Dust of Appearance (Modified)"
"DOTA_Tooltip_ability_bounty_hunter_wind_walk_Description"	"赏金猎人进入隐身，并能够穿越其它单位，直到他攻击或使用技能。破隐一击会造成额外伤害。 \n\n<font color='#70EA72'>在乱战先锋中暗影步的冷却时间、魔法消耗以及渐隐时间增加，同时持续时间与额外伤害降低。</font>"
"[english]DOTA_Tooltip_ability_bounty_hunter_wind_walk_Description"	"Bounty Hunter becomes invisible and gains the ability to move through other units until he attacks or uses an ability.  If he breaks the invisibility with an attack, that attack will deal bonus damage.\n\n<font color='#70EA72'>Wind Walk has increased cooldown, mana cost, and fade time, while it has reduced duration and bonus damage in Overthrow.</font>"
"DOTA_Tooltip_ability_broodmother_spin_web_Description"	"编织出一张蜘蛛网，育母蜘蛛在蛛网里可以隐身，获得无视地形移动的能力，同时提高生命回复和移动速度。织网没有冷却时间，但是需要能量点数，每%charge_restore_time%秒能量点数恢复1点。一旦育母蜘蛛受到来自敌人的伤害，她将在%damage_time%秒内丧失无视地形移动的能力，移动速度加成效果也会减半。织网现在可向其他蛛网触及的区域全屏释放。蛛网永久存在，不过可以手动摧毁。当其数量超过上限，最早的蛛网将会消失。\n\n<font color='#70EA72'>在乱战先锋中蛛网的上限数量、生命回复效果以及移动速度加成降低。</font>"
"[english]DOTA_Tooltip_ability_broodmother_spin_web_Description"	"Spins a large web that renders Broodmother invisible, grants a passive movement speed increase, gives free movement, and boosts regeneration while in its vicinity. Spin Web charges restore every %charge_restore_time% seconds. If damage is taken, free movement is disabled and the movement speed increase is halved for %damage_time% seconds. Spin Web can be cast from anywhere as long as the new web touches an existing web. Webs never expire, and can be manually destroyed. When the maximum limit of webs is exceeded, the oldest web disappears.\n\n<font color='#70EA72'>Spin Web has reduced count, health regen, and bonus movement speed for Overthrow.</font>"
"DOTA_Tooltip_ability_necrolyte_reapers_scythe_Description"	"眩晕目标敌方英雄，然后造成基于他当前损失生命值的伤害。\n\n<font color='#70EA72'>在乱战先锋中，英雄被死神镰刀杀死后复活时间会增加20秒。</font>\n\n若英雄在死神镰刀效果下死亡，击杀者为瘟疫法师。\n\n可用神杖升级。"
"[english]DOTA_Tooltip_ability_necrolyte_reapers_scythe_Description"	"Stuns the target enemy hero, then deals damage based on how much life it is missing.\n\n<font color='#70EA72'>In Overthrow, heroes killed by Reaper's Scythe will have 20 seconds added to their respawn timer.</font>\n\nAny kill under this effect is credited to Necrophos.\n\nUpgradable by Aghanim's Scepter."
"DOTA_Tooltip_ability_riki_permanent_invisibility_Description"	"力丸遁入阴影，保持隐身状态，并获得额外的生命恢复速率。主动攻击敌人，力丸将会显形。 \n\n<font color='#70EA72'>在乱战先锋中，刀光谍影的渐隐时间与隐身冷却时间增加。</font>"
"[english]DOTA_Tooltip_ability_riki_permanent_invisibility_Description"	"Riki fades into the shadows, becoming invisible and gaining additional health regeneration.  If Riki attacks an enemy, he will become visible.\n\n<font color='#70EA72'>Cloak and Dagger's fade time and fade delay have been increased for Overthrow.</font>"
"DOTA_Tooltip_ability_riki_blink_strike_Description"	"传送到一个目标背后，如果是敌人则对其造成额外伤害。\n\n<font color='#70EA72'>在乱战先锋中，闪烁突袭的施法距离和额外伤害降低。</font>"
"[english]DOTA_Tooltip_ability_riki_blink_strike_Description"	"Teleports behind the target unit, striking for bonus damage if it is an enemy. \n\n<font color='#70EA72'>In Overthrow, Blink Strike has reduced range and bonus damage.</font>"
"DOTA_Tooltip_ability_silencer_glaives_of_wisdom_Description"	"\n\n沉默术士用他的智慧强化刀刃，造成基于他智力值的额外伤害。\n\n智慧之刃是攻击特效，不与其他攻击特效叠加。\n\n<font color='#70EA72'>智慧之刃的智力值伤害系数和射程在乱战先锋中有所减少。</font>"
"[english]DOTA_Tooltip_ability_silencer_glaives_of_wisdom_Description"	"Silencer enchants his glaives with his wisdom, dealing additional damage based on his Intelligence. \n\nGlaives of Wisdom is a Unique Attack Modifier, and does not stack with other Unique Attack Modifiers.\n\n<font color='#70EA72'>Glaives of Wisdom intelligence percentage and range is reduced in Overthrow.</font>"
"DOTA_Tooltip_ability_zuus_thundergods_wrath_Description"	"用闪电打击所有敌方英雄，无论他们身在何处。雷神之怒会在每个受攻击的英雄半径900的范围内提供真实视野。隐身的英雄不会受到伤害，但你依然会获得他所在之处的真实视域。\n\n可用神杖升级。\n\n<font color='#70EA72'>在乱战先锋中雷神之怒的冷却时间与魔法消耗增加，并且伤害降低。</font>"
"[english]DOTA_Tooltip_ability_zuus_thundergods_wrath_Description"	"Strikes all enemy heroes with a bolt of lightning, no matter where they may be.  Thundergod's Wrath also provides True Sight around each hero struck.  If an enemy hero is invisible, it takes no damage, but the True Sight is still created at that hero's location.\n\nUpgradable by Aghanim's Scepter.\n\n<font color='#70EA72'>Thundergod's Wrath has increased cooldown and mana cost and has reduced damage in Overthrow.</font>"
"DOTA_Tooltip_ability_pudge_flesh_heap_Description"	"给予帕吉对魔法伤害的抗性，并且帕吉每次杀死一个敌方英雄，或者附近有敌方英雄死亡时，帕吉将获得额外的力量。腐肉堆积在学习之前就可以积累力量，但是学习之后才能获得这部分力量。\n\n<font color='#70EA72'>腐肉堆积的魔法抗性，额外力量和距离在乱战先锋中有所减少。</font>"
"[english]DOTA_Tooltip_ability_pudge_flesh_heap_Description"	"Gives Pudge resistance to magic damage, as well as bonus strength that increases each time Pudge kills an enemy Hero or it dies in his vicinity.  Flesh Heap is retroactive, meaning it can gain charges before it is skilled, which then become active.\n\n<font color='#70EA72'>Flesh Heap's bonus strength and range have been reduced in Overthrow.</font>"
"DOTA_Tooltip_ability_item_ward_sentry_Description"	"使用：放置一个岗哨守卫以在周围提供真实视域。守卫放置后将持续%duration_minutes_tooltip%分钟。\n\n按住Ctrl键可以对友方英雄使用，将1个守卫转移到他的物品栏中。\n\n<font color='#70EA72'>在乱战先锋中，岗哨守卫售价100金钱并持续6分钟。</font>"
"[english]DOTA_Tooltip_ability_item_ward_sentry_Description"	"Use: Plants a Sentry Ward, an invisible watcher that grants True Sight, the ability to see invisible enemy units and wards, to any existing allied vision within its range. Lasts %duration_minutes_tooltip% minutes.\n\nHold Control to give one Sentry Ward to an allied hero.\n\n<font color='#70EA72'>In Overthrow, Sentry Wards cost 100 gold and last 6 minutes.</font>"
"DOTA_Tooltip_ability_item_dust_Description"	"使用：立刻显示周围的隐形英雄并造成减速。\n\n<font color='#70EA72'>在乱战先锋中，显影之尘售价90金钱并且冷却时间降低。</font>"
"[english]DOTA_Tooltip_ability_item_dust_Description"	"Use: Reveals and slows invisible Heroes in a nearby area.\n\n<font color='#70EA72'>In Overthrow, Dust of Appearance costs 90 gold and has a reduced cooldown.</font>"
"npc_dota_hero_obsidian_destroyer"	"殁境神蚀者（微调）"
"[english]npc_dota_hero_obsidian_destroyer"	"Outworld Devourer (Modified)"
"DOTA_Tooltip_ability_obsidian_destroyer_arcane_orb_Description"	"殁境神蚀者的攻击中附带基于他当前魔法值的额外纯粹伤害。攻击敌方英雄时每次攻击都可以窃取%int_steal%点智力，持续%int_steal_duration%秒。奥术天球对召唤单位和镜像造成额外伤害。\n\n奥术天球是攻击特效，不与其他攻击特效叠加。\n\n<font color='#70EA72'>奥术天球的魔法值百分比、智力窃取量和持续时间在乱战先锋中有所减少。</font>"
"[english]DOTA_Tooltip_ability_obsidian_destroyer_arcane_orb_Description"	"Adds extra pure damage to Outworld Devourer's attacks, based on his remaining mana pool. Steals %int_steal% intelligence for %int_steal_duration% seconds per hit when attacking an enemy hero. Arcane Orb also does bonus damage to summoned units and illusions.\n\nArcane Orb is a Unique Attack Modifier, and does not stack with other Unique Attack Modifiers.\n\n<font color='#70EA72'>Arcane Orb's mana pool percentage, intelligence steal, and duration have been reduced in Overthrow.</font>"
}
}
