"lang"
{
"Language"	"italian"
"Tokens"
{
"DOTA_BroadcasterToasts_HeroAbilityMovie_Title"	"<hc>{s:hero_name}:</hc> <ac>{s:ability_name}</ac>"
"[english]DOTA_BroadcasterToasts_HeroAbilityMovie_Title"	"<hc>{s:hero_name}:</hc> <ac>{s:ability_name}</ac>"
"DOTA_BroadcasterToasts_ItemMovie_Title"	"<ic>{s:item_name}</ic>"
"[english]DOTA_BroadcasterToasts_ItemMovie_Title"	"<ic>{s:item_name}</ic>"
"DOTA_BroadcastFact_Stat_item_hero_win_percent"	"I giocatori di <hc>{s:hero_name}</hc> hanno vinto il <nc>{s:percent}%</nc> delle partite in cui hanno acquistato l'oggetto <ic>{s:item_name}</ic>."
"[english]DOTA_BroadcastFact_Stat_item_hero_win_percent"	"<hc>{s:hero_name}</hc> players have won <nc>{s:percent}%</nc> of their games when purchasing <ic>{s:item_name}</ic>."
"DOTA_BroadcastFact_Stat_item_hero_pick_percent"	"I giocatori di <hc>{s:hero_name}</hc> hanno acquistato l'oggetto <ic>{s:item_name}</ic> nel <nc>{s:percent}%</nc> delle loro partite."
"[english]DOTA_BroadcastFact_Stat_item_hero_pick_percent"	"<hc>{s:hero_name}</hc> players have purchased <ic>{s:item_name}</ic> in <nc>{s:percent}%</nc> of their games."
"DOTA_BroadcastFact_Stat_item_player_win_percent"	"<pc>{s:player_name}</pc> ha una percentuale di vittorie pari al <nc>{s:percent}%</nc> con l'oggetto <ic>{s:item_name}</ic>."
"[english]DOTA_BroadcastFact_Stat_item_player_win_percent"	"<pc>{s:player_name}</pc> has a <nc>{s:percent}%</nc> win rate with <ic>{s:item_name}</ic>."
"DOTA_BroadcastFact_Stat_item_player_pick_percent"	"<pc>{s:player_name}</pc> ha acquistato l'oggetto <ic>{s:item_name}</ic> nel <nc>{s:percent}%</nc> delle sue partite."
"[english]DOTA_BroadcastFact_Stat_item_player_pick_percent"	"<pc>{s:player_name}</pc> has purchased <ic>{s:item_name}</ic> in <nc>{s:percent}%</nc> of his games."
"DOTA_BroadcastFact_Stat_hero_player_win_rate"	"<pc>{s:player_name}</pc> ha vinto il <nc>{s:percent}%</nc> delle partite in cui ha giocato come <hc>{s:hero_name}</hc>."
"[english]DOTA_BroadcastFact_Stat_hero_player_win_rate"	"<pc>{s:player_name}</pc> has won <nc>{s:percent}%</nc> of his games when picking <hc>{s:hero_name}</hc>."
"DOTA_BroadcastFact_Stat_hero_player_pick_rate"	"<pc>{s:player_name}</pc> ha scelto <hc>{s:hero_name}</hc> nel <nc>{s:percent}%</nc> delle sue partite."
"[english]DOTA_BroadcastFact_Stat_hero_player_pick_rate"	"<pc>{s:player_name}</pc> has picked <hc>{s:hero_name}</hc> in <nc>{s:percent}%</nc> of his games."
"DOTA_BroadcastFact_Stat_item_pick_rate"	"L'oggetto <ic>{s:item_name}</ic> è stato acquistato nel <nc>{s:percent}%</nc> delle partite."
"[english]DOTA_BroadcastFact_Stat_item_pick_rate"	"<ic>{s:item_name}</ic> has been purchased in <nc>{s:percent}%</nc> of all games."
"DOTA_BroadcastFact_Stat_item_win_rate"	"I giocatori hanno vinto il <nc>{s:percent}%</nc> delle partite in cui hanno acquistato l'oggetto <ic>{s:item_name}</ic>."
"[english]DOTA_BroadcastFact_Stat_item_win_rate"	"Players have won <nc>{s:percent}%</nc> of their games in which they purchased <ic>{s:item_name}</ic>."
"DOTA_BroadcastFact_Stat_hero_pick_rate"	"L'Eroe <hc>{s:hero_name}</hc> è stato scelto nel <nc>{s:percent}%</nc> delle partite."
"[english]DOTA_BroadcastFact_Stat_hero_pick_rate"	"<hc>{s:hero_name}</hc> has been picked in <nc>{s:percent}%</nc> of all games."
"DOTA_BroadcastFact_Stat_hero_win_rate"	"<hc>{s:hero_name}</hc> ha vinto il <nc>{s:percent}%</nc> di tutte le partite."
"[english]DOTA_BroadcastFact_Stat_hero_win_rate"	"<hc>{s:hero_name}</hc> has a <nc>{s:percent}%</nc> win rate across all games."
"DOTA_BroadcastFact_Stat_league_item_hero_win_percent"	"Durante l'evento <ec>{s:event_name}</ec>, i giocatori di <hc>{s:hero_name}</hc> hanno vinto il <nc>{s:percent}%</nc> delle partite in cui hanno acquistato l'oggetto <ic>{s:item_name}</ic>."
"[english]DOTA_BroadcastFact_Stat_league_item_hero_win_percent"	"<hc>{s:hero_name}</hc> players have won <nc>{s:percent}%</nc> of their games at <ec>{s:event_name}</ec> when purchasing <ic>{s:item_name}</ic>."
"DOTA_BroadcastFact_Stat_league_item_hero_pick_percent"	"Durante l'evento <ec>{s:event_name}</ec>, i giocatori di <hc>{s:hero_name}</hc> hanno acquistato l'oggetto <ic>{s:item_name}</ic> nel <nc>{s:percent}%</nc> delle loro partite."
"[english]DOTA_BroadcastFact_Stat_league_item_hero_pick_percent"	"<hc>{s:hero_name}</hc> players have purchased <ic>{s:item_name}</ic> in <nc>{s:percent}%</nc> of their games at <ec>{s:event_name}</ec>."
"DOTA_BroadcastFact_Stat_league_item_player_win_percent"	"Durante l'evento <ec>{s:event_name}</ec>, <pc>{s:player_name}</pc> ha vinto il <nc>{s:percent}%</nc> delle sue partite con l'oggetto <ic>{s:item_name}</ic>."
"[english]DOTA_BroadcastFact_Stat_league_item_player_win_percent"	"<pc>{s:player_name}</pc> has a <nc>{s:percent}%</nc> win rate with  <ic>{s:item_name}</ic> at <ec>{s:event_name}</ec>."
"DOTA_BroadcastFact_Stat_league_item_player_pick_percent"	"Durante l'evento <ec>{s:event_name}</ec>, <pc>{s:player_name}</pc> ha acquistato l'oggetto <ic>{s:item_name}</ic> nel <nc>{s:percent}%</nc> delle sue partite."
"[english]DOTA_BroadcastFact_Stat_league_item_player_pick_percent"	"<pc>{s:player_name}</pc> has purchased <ic>{s:item_name}</ic> in <nc>{s:percent}%</nc> of his games at <ec>{s:event_name}</ec>."
"DOTA_BroadcastFact_Stat_league_hero_player_win_rate"	"Durante l'evento <ec>{s:event_name}</ec>, <pc>{s:player_name}</pc> ha vinto il <nc>{s:percent}%</nc> delle partite in cui ha giocato come <hc>{s:hero_name}</hc>."
"[english]DOTA_BroadcastFact_Stat_league_hero_player_win_rate"	"<pc>{s:player_name}</pc> has picked <hc>{s:hero_name}</hc> with a <nc>{s:percent}%</nc> win rate at <ec>{s:event_name}</ec>."
"DOTA_BroadcastFact_Stat_league_hero_player_pick_rate"	"Durante l'evento <ec>{s:event_name}</ec>, <pc>{s:player_name}</pc> ha scelto <hc>{s:hero_name}</hc> nel <nc>{s:percent}%</nc> delle sue partite."
"[english]DOTA_BroadcastFact_Stat_league_hero_player_pick_rate"	"<pc>{s:player_name}</pc> has picked <hc>{s:hero_name}</hc> in <nc>{s:percent}%</nc> of his games at <ec>{s:event_name}</ec>."
"DOTA_BroadcastFact_Stat_league_item_pick_rate"	"L'oggetto <ic>{s:item_name}</ic> è stato acquistato nel <nc>{s:percent}%</nc> delle partite giocate durante l'evento <ec>{s:event_name}</ec>."
"[english]DOTA_BroadcastFact_Stat_league_item_pick_rate"	"<ic>{s:item_name}</ic> has been purchased in <nc>{s:percent}%</nc> of all games at <ec>{s:event_name}</ec>."
"DOTA_BroadcastFact_Stat_league_item_win_rate"	"Durante l'evento {s:event_name}, l'oggetto <ic>{s:item_name}</ic> ha avuto una percentuale di vittorie pari al <nc>{s:percent}%</nc>."
"[english]DOTA_BroadcastFact_Stat_league_item_win_rate"	"<ic>{s:item_name}</ic> has a <nc>{s:percent}%</nc> win rate at {s:event_name}."
"DOTA_BroadcastFact_Stat_league_hero_pick_rate"	"L'Eroe <hc>{s:hero_name}</hc> è stato scelto nel <nc>{s:percent}%</nc> delle partite giocate durante l'evento <ec>{s:event_name}</ec>."
"[english]DOTA_BroadcastFact_Stat_league_hero_pick_rate"	"<hc>{s:hero_name}</hc> has been picked in <nc>{s:percent}%</nc> of games at <ec>{s:event_name}</ec>."
"DOTA_BroadcastFact_Stat_league_hero_win_rate"	"Durante l'evento <ec>{s:event_name}</ec>, <hc>{s:hero_name}</hc> ha avuto una percentuale di vittorie pari al <nc>{s:percent}%</nc>."
"[english]DOTA_BroadcastFact_Stat_league_hero_win_rate"	"<hc>{s:hero_name}</hc> has a <nc>{s:percent}%</nc> win rate at <ec>{s:event_name}</ec>."
"DOTA_BroadcastFact_Stat_league_full_set_win_rate"	"Durante l'evento <ec>{s:event_name}</ec>, <pc>{s:player_name}</pc> ha vinto il <nc>{s:percent}%</nc> delle partite in cui ha acquistato l'oggetto <ic>{s:item_name}</ic> con <hc>{s:hero_name}</hc>."
"[english]DOTA_BroadcastFact_Stat_league_full_set_win_rate"	"<pc>{s:player_name}</pc> has won <nc>{s:percent}%</nc> of his games at <ec>{s:event_name}</ec> when purchasing <ic>{s:item_name}</ic> on <hc>{s:hero_name}</hc>."
"DOTA_BroadcastFact_Stat_league_full_set_pick_rate"	"Durante l'evento <ec>{s:event_name}</ec>, <pc>{s:player_name}</pc> ha acquistato l'oggetto <ic>{s:item_name}</ic> nel <nc>{s:percent}%</nc> delle partite in cui ha giocato come <hc>{s:hero_name}</hc>."
"[english]DOTA_BroadcastFact_Stat_league_full_set_pick_rate"	"<pc>{s:player_name}</pc> has purchased <ic>{s:item_name}</ic> in <nc>{s:percent}%</nc> of his <hc>{s:hero_name}</hc> games at <ec>{s:event_name}</ec>."
"DOTA_BroadcastFact_Stat_full_set_win_rate"	"<pc>{s:player_name}</pc> ha vinto il <nc>{s:percent}%</nc> delle partite in cui ha acquistato l'oggetto <ic>{s:item_name}</ic> con <hc>{s:hero_name}</hc>."
"[english]DOTA_BroadcastFact_Stat_full_set_win_rate"	"<pc>{s:player_name}</pc> has won <nc>{s:percent}%</nc> of his games when purchasing <ic>{s:item_name}</ic> on <hc>{s:hero_name}</hc>."
"DOTA_BroadcastFact_Stat_full_set_pick_rate"	"<pc>{s:player_name}</pc> ha acquistato l'oggetto <ic>{s:item_name}</ic> nel <nc>{s:percent}%</nc> delle partite in cui ha giocato come <hc>{s:hero_name}</hc>."
"[english]DOTA_BroadcastFact_Stat_full_set_pick_rate"	"<pc>{s:player_name}</pc> has purchased <ic>{s:item_name}</ic> in <nc>{s:percent}%</nc> of his games on <hc>{s:hero_name}</hc>."
"DOTA_BroadcastFact_Stat_item_hero_win_count"	"I giocatori di <hc>{s:hero_name}</hc> hanno vinto <nc>{d:count}</nc> partite dopo aver acquistato l'oggetto <ic>{s:item_name}</ic>."
"[english]DOTA_BroadcastFact_Stat_item_hero_win_count"	"<hc>{s:hero_name}</hc> players have won <nc>{d:count}</nc> games when purchasing <ic>{s:item_name}</ic>."
"DOTA_BroadcastFact_Stat_item_hero_pick_count"	"I giocatori di <hc>{s:hero_name}</hc> hanno acquistato l'oggetto <ic>{s:item_name}</ic> in <nc>{d:count}</nc> partite."
"[english]DOTA_BroadcastFact_Stat_item_hero_pick_count"	"<hc>{s:hero_name}</hc> players have purchased <ic>{s:item_name}</ic> in <nc>{d:count}</nc> games."
"DOTA_BroadcastFact_Stat_item_player_win_count"	"<pc>{s:player_name}</pc> ha vinto <nc>{d:count}</nc> partite con l'oggetto <ic>{s:item_name}</ic>."
"[english]DOTA_BroadcastFact_Stat_item_player_win_count"	"<pc>{s:player_name}</pc> has won <nc>{d:count}</nc> games with <ic>{s:item_name}</ic>."
"DOTA_BroadcastFact_Stat_item_player_pick_count"	"<pc>{s:player_name}</pc> ha acquistato l'oggetto <ic>{s:item_name}</ic> in <nc>{d:count}</nc> partite."
"[english]DOTA_BroadcastFact_Stat_item_player_pick_count"	"<pc>{s:player_name}</pc> has purchased <ic>{s:item_name}</ic> in <nc>{d:count}</nc> games."
"DOTA_BroadcastFact_Stat_hero_player_win_count"	"<pc>{s:player_name}</pc> ha vinto <nc>{d:count}</nc> partite in cui ha scelto <hc>{s:hero_name}</hc>."
"[english]DOTA_BroadcastFact_Stat_hero_player_win_count"	"<pc>{s:player_name}</pc> has won <nc>{d:count}</nc> games when picking <hc>{s:hero_name}</hc>."
"DOTA_BroadcastFact_Stat_hero_player_pick_count"	"<pc>{s:player_name}</pc> ha scelto <hc>{s:hero_name}</hc> in <nc>{d:count}</nc> partite."
"[english]DOTA_BroadcastFact_Stat_hero_player_pick_count"	"<pc>{s:player_name}</pc> has picked <hc>{s:hero_name}</hc> in <nc>{d:count}</nc> games."
"DOTA_BroadcastFact_Stat_item_pick_count"	"L'oggetto <ic>{s:item_name}</ic> è stato acquistato in <nc>{d:count}</nc> partite."
"[english]DOTA_BroadcastFact_Stat_item_pick_count"	"<ic>{s:item_name}</ic> has been purchased in <nc>{d:count}</nc> games"
"DOTA_BroadcastFact_Stat_item_win_count"	"<nc>{d:count}</nc> partite sono state vinte dalla squadra che ha acquistato l'oggetto <ic>{s:item_name}</ic>."
"[english]DOTA_BroadcastFact_Stat_item_win_count"	"<nc>{d:count}</nc> games have been decided in which <ic>{s:item_name}</ic> was purchased by the winning team."
"DOTA_BroadcastFact_Stat_hero_pick_count"	"L'Eroe <hc>{s:hero_name}</hc> è stato scelto in <nc>{d:count}</nc> partite."
"[english]DOTA_BroadcastFact_Stat_hero_pick_count"	"<hc>{s:hero_name}</hc> has been picked in <nc>{d:count}</nc> games."
"DOTA_BroadcastFact_Stat_hero_win_count"	"L'Eroe <hc>{s:hero_name}</hc> ha vinto <nc>{d:count}</nc> partite."
"[english]DOTA_BroadcastFact_Stat_hero_win_count"	"<hc>{s:hero_name}</hc> has won <nc>{d:count}</nc> games."
"DOTA_BroadcastFact_Stat_league_item_hero_win_count"	"Durante l'evento <ec>{s:event_name}</ec>, i giocatori di <hc>{s:hero_name}</hc> hanno vinto <nc>{d:count}</nc> partite dopo aver acquistato l'oggetto <ic>{s:item_name}</ic>."
"[english]DOTA_BroadcastFact_Stat_league_item_hero_win_count"	"<hc>{s:hero_name}</hc> players have won <nc>{d:count}</nc> games at <ec>{s:event_name}</ec> with <ic>{s:item_name}</ic> purchased."
"DOTA_BroadcastFact_Stat_league_item_hero_pick_count"	"Durante l'evento <ec>{s:event_name}</ec>, i giocatori di <hc>{s:hero_name}</hc> hanno acquistato l'oggetto <ic>{s:item_name}</ic> in <nc>{d:count}</nc> partite."
"[english]DOTA_BroadcastFact_Stat_league_item_hero_pick_count"	"<hc>{s:hero_name}</hc> players have purchased <ic>{s:item_name}</ic> in <nc>{d:count}</nc> games at <ec>{s:event_name}</ec>."
"DOTA_BroadcastFact_Stat_league_item_player_win_count"	"Durante l'evento <ec>{s:event_name}</ec>, i giocatori di <pc>{s:player_name}</pc> hanno vinto <nc>{d:count}</nc> partite con l'oggetto <ic>{s:item_name}</ic>."
"[english]DOTA_BroadcastFact_Stat_league_item_player_win_count"	"<pc>{s:player_name}</pc> has won <nc>{d:count}</nc> games at <ec>{s:event_name}</ec> with <ic>{s:item_name}</ic> purchased."
"DOTA_BroadcastFact_Stat_league_item_player_pick_count"	"Durante l'evento <ec>{s:event_name}</ec>, <pc>{s:player_name}</pc> ha acquistato l'oggetto <ic>{s:item_name}</ic> in <nc>{d:count}</nc> partite."
"[english]DOTA_BroadcastFact_Stat_league_item_player_pick_count"	"<pc>{s:player_name}</pc> has purchased <ic>{s:item_name}</ic> in <nc>{d:count}</nc> games at <ec>{s:event_name}</ec>."
"DOTA_BroadcastFact_Stat_league_hero_player_win_count"	"Durante l'evento <ec>{s:event_name}</ec>, <pc>{s:player_name}</pc> ha vinto <nc>{d:count}</nc> partite giocando come <hc>{s:hero_name}</hc>."
"[english]DOTA_BroadcastFact_Stat_league_hero_player_win_count"	"<pc>{s:player_name}</pc> has won <nc>{d:count}</nc> games at <ec>{s:event_name}</ec> with <hc>{s:hero_name}</hc>."
"DOTA_BroadcastFact_Stat_league_hero_player_pick_count"	"Durante l'evento <ec>{s:event_name}</ec>, <pc>{s:player_name}</pc> ha scelto <hc>{s:hero_name}</hc> in <nc>{d:count}</nc> partite."
"[english]DOTA_BroadcastFact_Stat_league_hero_player_pick_count"	"<pc>{s:player_name}</pc> has picked <hc>{s:hero_name}</hc> in <nc>{d:count}</nc> games at <ec>{s:event_name}</ec>."
"DOTA_BroadcastFact_Stat_league_item_pick_count"	"L'oggetto <hc>{s:item_name}</hc> è stato acquistato <nc>{d:count}</nc> volte durante l'evento <ec>{s:event_name}</ec>."
"[english]DOTA_BroadcastFact_Stat_league_item_pick_count"	"<ic>{s:item_name}</ic> has been purchased <nc>{d:count}</nc> times at <ec>{s:event_name}</ec>."
"DOTA_BroadcastFact_Stat_league_item_win_count"	"<nc>Durante l'evento <ec>{s:event_name}</ec>, {d:count}</nc> partite sono terminate con l'oggetto <ic>{s:item_name}</ic> nell'inventario della squadra vincente."
"[english]DOTA_BroadcastFact_Stat_league_item_win_count"	"<nc>At <ec>{s:event_name}</ec>, {d:count}</nc> games have ended with a <ic>{s:item_name}</ic> on the winning team."
"DOTA_BroadcastFact_Stat_league_hero_pick_count"	"L'Eroe <hc>{s:hero_name}</hc> è stato scelto <nc>{d:count}</nc> volte durante l'evento <ec>{s:event_name}</ec>."
"[english]DOTA_BroadcastFact_Stat_league_hero_pick_count"	"<hc>{s:hero_name}</hc> has been picked <nc>{d:count}</nc> times at <ec>{s:event_name}</ec>."
"DOTA_BroadcastFact_Stat_league_hero_win_count"	"L'Eroe <hc>{s:hero_name}</hc> ha vinto <nc>{d:count}</nc> partite durante l'evento <ec>{s:event_name}</ec>."
"[english]DOTA_BroadcastFact_Stat_league_hero_win_count"	"<hc>{s:hero_name}</hc> has won <nc>{d:count}</nc> games at <ec>{s:event_name}</ec>."
"DOTA_BroadcastFact_Stat_full_set_win_count"	"<pc>{s:player_name}</pc> ha vinto <nc>{d:count}</nc> partite dopo aver acquistato l'oggetto <ic>{s:item_name}</ic> con <hc>{s:hero_name}</hc>."
"[english]DOTA_BroadcastFact_Stat_full_set_win_count"	"<pc>{s:player_name}</pc> has won <nc>{d:count}</nc> games after purchasing <ic>{s:item_name}</ic> on <hc>{s:hero_name}</hc>."
"DOTA_BroadcastFact_Stat_full_set_pick_count"	"<pc>{s:player_name}</pc> ha acquistato l'oggetto <ic>{s:item_name}</ic> con <hc>{s:hero_name}</hc> in <nc>{d:count}</nc> partite."
"[english]DOTA_BroadcastFact_Stat_full_set_pick_count"	"<pc>{s:player_name}</pc> has purchased <ic>{s:item_name}</ic> on <hc>{s:hero_name}</hc> in <nc>{d:count}</nc> games."
"DOTA_BroadcastFact_Stat_league_full_set_win_count"	"Durante l'evento <ec>{s:event_name}</ec>, <pc>{s:player_name}</pc> ha vinto <nc>{d:count}</nc> partite dopo aver acquistato l'oggetto <ic>{s:item_name}</ic> con <hc>{s:hero_name}</hc>."
"[english]DOTA_BroadcastFact_Stat_league_full_set_win_count"	"<pc>{s:player_name}</pc> has won <nc>{d:count}</nc> games at <ec>{s:event_name}</ec> after purchasing <ic>{s:item_name}</ic> on <hc>{s:hero_name}</hc>."
"DOTA_BroadcastFact_Stat_league_full_set_pick_count"	"Durante l'evento <ec>{s:event_name}</ec>, <pc>{s:player_name}</pc> ha acquistato l'oggetto <ic>{s:item_name}</ic> con <hc>{s:hero_name}</hc> in <nc>{d:count}</nc> partite."
"[english]DOTA_BroadcastFact_Stat_league_full_set_pick_count"	"<pc>{s:player_name}</pc> has purchased <ic>{s:item_name}</ic> on <hc>{s:hero_name}</hc> in <nc>{d:count}</nc> games at <ec>{s:event_name}</ec>."
"DOTA_BroadcastFact_ItemMovie_item_bloodthorn"	"Silenzia i nemici e aumenta la probabilità di infliggere colpi critici."
"[english]DOTA_BroadcastFact_ItemMovie_item_bloodthorn"	"Silences enemies and increases the chance of critical strikes."
"DOTA_BroadcastFact_ItemMovie_item_bottle_haste"	"Permette di conservare delle Rune da utilizzare in un secondo momento. Le cariche della Bottiglia si ripristinano quando la Runa al suo interno viene attivata."
"[english]DOTA_BroadcastFact_ItemMovie_item_bottle_haste"	"Has ability to store runes for later use, replenishing a player's bottle charges."
"DOTA_BroadcastFact_ItemMovie_item_crimson_guard"	"Blocca una parte dei danni fisici inflitti al giocatore e a tutti gli alleati in una certa area."
"[english]DOTA_BroadcastFact_ItemMovie_item_crimson_guard"	"Blocks a portion of physical damage for the player and any allies in the area."
"DOTA_BroadcastFact_ItemMovie_item_dust"	"Rivela le Unità invisibili per una breve durata."
"[english]DOTA_BroadcastFact_ItemMovie_item_dust"	"Reveals invisible units for a short duration."
"DOTA_BroadcastFact_ItemMovie_item_gem"	"Permette di vedere le Unità invisibili vicine."
"[english]DOTA_BroadcastFact_ItemMovie_item_gem"	"Gives vision of nearby invisible units."
"DOTA_BroadcastFact_ItemMovie_item_mjollnir"	"Aggiunge un'abilità attiva al <ic>Maelstrom</ic> che permette di generare uno scudo elettrico."
"[english]DOTA_BroadcastFact_ItemMovie_item_mjollnir"	"Adds an active lightning shield ability to <ic>Maelstrom</ic>."
"DOTA_BroadcastFact_ItemMovie_item_maelstrom"	"Aumenta il danno e la velocità di attacco, conferendo all'Eroe l'abilità passiva Catena di fulmini."
"[english]DOTA_BroadcastFact_ItemMovie_item_maelstrom"	"Increases damage and attack speed, and provides passive Chain Lightning."
"DOTA_BroadcastFact_ItemMovie_item_pipe"	"Protegge gli alleati in una certa area da una determinata quantità di danni magici."
"[english]DOTA_BroadcastFact_ItemMovie_item_pipe"	"Shields allies in an area from a fixed amount of damage."
"DOTA_BroadcastFact_ItemMovie_item_radiance"	"Danneggia i nemici vicini e fa mancare gli attacchi."
"[english]DOTA_BroadcastFact_ItemMovie_item_radiance"	"Damages and causes nearby enemies to miss attacks."
"DOTA_BroadcastFact_ItemMovie_item_satanic"	"Permette di prosciugare una grande quantità di salute ad ogni attacco."
"[english]DOTA_BroadcastFact_ItemMovie_item_satanic"	"Provides massive lifesteal with each attack."
"DOTA_BroadcastFact_ItemMovie_item_ward_sentry"	"Permette di vedere le Unità invisibili vicine."
"[english]DOTA_BroadcastFact_ItemMovie_item_ward_sentry"	"Gives vision of nearby invisible units."
"DOTA_BroadcastFact_ItemMovie_item_invis_sword"	"Rende invisibili e aumenta la velocità di movimento."
"[english]DOTA_BroadcastFact_ItemMovie_item_invis_sword"	"Grants invisibility and increased movement speed."
"DOTA_BroadcastFact_ItemMovie_item_silver_edge"	"Utile per attaccare gli Eroi con potenti abilità passive."
"[english]DOTA_BroadcastFact_ItemMovie_item_silver_edge"	"Useful for attacking heroes with strong passive abilities."
"DOTA_BroadcastFact_ItemMovie_item_shivas_guard"	"Rilascia un'onda congelante che rallenta i nemici in una certa area."
"[english]DOTA_BroadcastFact_ItemMovie_item_shivas_guard"	"Releases an AoE wave to slow down enemies."
"DOTA_BroadcastFact_ItemMovie_item_tpscroll"	"Permette agli Eroi di teletrasportarsi velocemente verso le strutture alleate."
"[english]DOTA_BroadcastFact_ItemMovie_item_tpscroll"	"Allows heroes to quickly teleport to allied structures."
"DOTA_BroadcastFact_ItemMovie_item_smoke_of_deceit"	"Nasconde tutti gli alleati vicini e aumenta la loro velocità di movimento."
"[english]DOTA_BroadcastFact_ItemMovie_item_smoke_of_deceit"	"Hides all nearby allies and grants them increased movement speed."
"DOTA_BroadcastFact_ItemMovie_item_sheepstick"	"<ac>Maledice</ac> i nemici, trasformandoli in creature indifese."
"[english]DOTA_BroadcastFact_ItemMovie_item_sheepstick"	"<ac>Hexes</ac> enemies, turning them into helpless creatures."
"DOTA_BroadcastFact_ItemMovie_item_sphere"	"Quando non è in ricarica, questo oggetto può bloccare una singola abilità diretta all'Eroe."
"[english]DOTA_BroadcastFact_ItemMovie_item_sphere"	"Can block a single targeted ability when off cooldown."
"DOTA_BroadcastFact_ItemMovie_item_hurricane_pike"	"Respinge un nemico e permette all'Eroe di colpirlo con attacchi a distanza."
"[english]DOTA_BroadcastFact_ItemMovie_item_hurricane_pike"	"Can push an enemy away, allowing for ranged attacks."
"DOTA_BroadcastFact_ItemMovie_item_glimmer_cape"	"Rende invisibili e può essere usato durante la canalizzazione delle abilità."
"[english]DOTA_BroadcastFact_ItemMovie_item_glimmer_cape"	"Grants invisibility and can be cast while channeling spells."
"DOTA_BroadcastFact_ItemMovie_item_force_staff"	"Permette di spingere i nemici o gli alleati nella direzione in cui ci si sta muovendo."
"[english]DOTA_BroadcastFact_ItemMovie_item_force_staff"	"Allows its wielder to push enemies or allies in their direction of travel."
"DOTA_BroadcastFact_ItemMovie_item_cyclone"	"Può essere usato per disabilitare un nemico e interrompere le loro abilità."
"[english]DOTA_BroadcastFact_ItemMovie_item_cyclone"	"Can be used to disable an enemy and interrupt their abilities."
"DOTA_BroadcastFact_ItemMovie_item_dagon"	"Emette una potente esplosione che causa danni magici."
"[english]DOTA_BroadcastFact_ItemMovie_item_dagon"	"Emits a powerful burst of magical damage."
"DOTA_BroadcastFact_ItemMovie_item_travel_boots"	"Permette ad un Eroe di teletrasportarsi verso un'Unità non eroica alleata."
"[english]DOTA_BroadcastFact_ItemMovie_item_travel_boots"	"Allows a hero to teleport to any allied non-hero unit."
"DOTA_BroadcastFact_ItemMovie_item_blink"	"Permette ad un Eroe di teletrasportarsi in avanti per una breve distanza."
"[english]DOTA_BroadcastFact_ItemMovie_item_blink"	"Allows a hero to jump a short distance."
"DOTA_BroadcastFact_ItemMovie_item_black_king_bar"	"Rende immune agli incantesimi per un breve periodo."
"[english]DOTA_BroadcastFact_ItemMovie_item_black_king_bar"	"Provides spell immunity for a short duration."
"DOTA_BroadcastFact_ItemMovie_item_abyssal_blade"	"Dona una probabilità passiva di stordire ad ogni attacco e un'abilità attiva che permette di disabilitare il bersaglio."
"[english]DOTA_BroadcastFact_ItemMovie_item_abyssal_blade"	"Grants a passive chance to stun on attacks and an active disable."
"DOTA_BroadcastFact_AbilityMovie_invoker_sun_strike"	"Può infliggere dei danni in qualsiasi punto della mappa."
"[english]DOTA_BroadcastFact_AbilityMovie_invoker_sun_strike"	"Strikes anywhere in the map to deal damage."
"DOTA_BroadcastFact_AbilityMovie_invoker_tornado"	"Danneggia i nemici scaraventandoli in aria."
"[english]DOTA_BroadcastFact_AbilityMovie_invoker_tornado"	"Throws enemies into the air, dealing damage."
"DOTA_BroadcastFact_AbilityMovie_abaddon_mist_coil"	"L'Eroe sacrifica i suoi punti salute per danneggiare i nemici o curare gli alleati."
"[english]DOTA_BroadcastFact_AbilityMovie_abaddon_mist_coil"	"Damages foes or heals allies at the cost of health."
"DOTA_BroadcastFact_AbilityMovie_abaddon_aphotic_shield"	"Crea uno scudo che protegge un alleato. Lo scudo danneggia i nemici quando scoppia."
"[english]DOTA_BroadcastFact_AbilityMovie_abaddon_aphotic_shield"	"Shields an ally. Damages enemies upon bursting."
"DOTA_BroadcastFact_AbilityMovie_abaddon_curse_of_avernus"	"Una maledizione che aumenta la velocità di movimento e la velocità di attacco degli alleati."
"[english]DOTA_BroadcastFact_AbilityMovie_abaddon_curse_of_avernus"	"A curse that boosts allied movement and attack speed."
"DOTA_BroadcastFact_AbilityMovie_abaddon_borrowed_time"	"Quando viene attivata, tutti gli attacchi subiti da Abaddon lo curano invece di danneggiarlo."
"[english]DOTA_BroadcastFact_AbilityMovie_abaddon_borrowed_time"	"When activated, all damage taken heals instead of harms."
"DOTA_BroadcastFact_AbilityMovie_alchemist_acid_spray"	"Spruzza dell'acido che danneggia e riduce l'armatura."
"[english]DOTA_BroadcastFact_AbilityMovie_alchemist_acid_spray"	"Sprays acid, causing damage and armor reduction."
"DOTA_BroadcastFact_AbilityMovie_alchemist_unstable_concoction"	"Prepara una pozione che deve essere lanciata per stordire i nemici. Può stordire Alchemist."
"[english]DOTA_BroadcastFact_AbilityMovie_alchemist_unstable_concoction"	"Brews a potion to throw and stun. Can self-stun."
"DOTA_BroadcastFact_AbilityMovie_alchemist_greevil's_greed"	"Permette di ottenere oro aggiuntivo quando si infliggono dei colpi di grazia e quando si attiva una Runa della Generosità."
"[english]DOTA_BroadcastFact_AbilityMovie_alchemist_greevil's_greed"	"Grants bonus gold to last hits and bounty runes."
"DOTA_BroadcastFact_AbilityMovie_alchemist_chemical_rage"	"Aumenta la velocità di movimento, la velocità di attacco e la rigenerazione della salute."
"[english]DOTA_BroadcastFact_AbilityMovie_alchemist_chemical_rage"	"Grants attack and move speed, and health regen."
"DOTA_BroadcastFact_AbilityMovie_ancient_apparition_cold_feet"	"Congela e blocca un nemico se questo non si sposta a sufficienza."
"[english]DOTA_BroadcastFact_AbilityMovie_ancient_apparition_cold_feet"	"Freezes an enemy in place if they don't move."
"DOTA_BroadcastFact_AbilityMovie_ancient_apparition_ice_vortex"	"Rallenta i nemici e aumenta i danni magici."
"[english]DOTA_BroadcastFact_AbilityMovie_ancient_apparition_ice_vortex"	"Slows enemies and increases magic damage."
"DOTA_BroadcastFact_AbilityMovie_ancient_apparition_chilling_touch"	"Aumenta il danno d'attacco degli alleati."
"[english]DOTA_BroadcastFact_AbilityMovie_ancient_apparition_chilling_touch"	"Grants allies bonus attack damage."
"DOTA_BroadcastFact_AbilityMovie_ancient_apparition_ice_blast"	"Lancia un tracciante in qualsiasi punto della mappa che danneggia e impedisce di curarsi."
"[english]DOTA_BroadcastFact_AbilityMovie_ancient_apparition_ice_blast"	"Aims a blast across the map that damages and prevents healing. "
"DOTA_BroadcastFact_AbilityMovie_anti-mage_mana_break"	"Consuma il mana di un nemico ad ogni attacco."
"[english]DOTA_BroadcastFact_AbilityMovie_anti-mage_mana_break"	"Burns an enemy's mana with each attack."
"DOTA_BroadcastFact_AbilityMovie_anti-mage_blink"	"Permette di teletrasportarsi per una breve distanza."
"[english]DOTA_BroadcastFact_AbilityMovie_anti-mage_blink"	"Teleports a short distance."
"DOTA_BroadcastFact_AbilityMovie_anti-mage_spell_shield"	"Aumenta la resistenza ai danni magici."
"[english]DOTA_BroadcastFact_AbilityMovie_anti-mage_spell_shield"	"Increases resistance to magic damage."
"DOTA_BroadcastFact_AbilityMovie_anti-mage_mana_void"	"Infligge dei danni in un'area in base ad ogni punto di mana mancante dal bersaglio originale."
"[english]DOTA_BroadcastFact_AbilityMovie_anti-mage_mana_void"	"Deals damage in an area for each point of mana the target is missing."
"DOTA_BroadcastFact_AbilityMovie_arc_warden_flux"	"Diminuisce la velocità di movimento e danneggia con il passare del tempo."
"[english]DOTA_BroadcastFact_AbilityMovie_arc_warden_flux"	"Slows movement speed and damages over time."
"DOTA_BroadcastFact_AbilityMovie_arc_warden_magnetic_field"	"Crea un campo di energia che protegge gli alleati dagli attacchi dei nemici."
"[english]DOTA_BroadcastFact_AbilityMovie_arc_warden_magnetic_field"	"Creates a field that shields from outside attackers."
"DOTA_BroadcastFact_AbilityMovie_arc_warden_spark_wraith"	"Evoca uno Spettro Scintilla che controlla l'area bersagliata, rallentando e danneggiando gli invasori."
"[english]DOTA_BroadcastFact_AbilityMovie_arc_warden_spark_wraith"	"Guards an area. Slows and damages an enemy that enters."
"DOTA_BroadcastFact_AbilityMovie_arc_warden_tempest_double"	"Crea una copia di <hc>Arc Warden</hc> con le proprie abilità e i propri tempi di ricarica degli oggetti."
"[english]DOTA_BroadcastFact_AbilityMovie_arc_warden_tempest_double"	"Creates a copy of <hc>Arc Warden</hc> with its own ability and item cooldowns."
"DOTA_BroadcastFact_AbilityMovie_axe_berserker's_call"	"Provoca i nemici vicini, obbligandoli ad attaccare."
"[english]DOTA_BroadcastFact_AbilityMovie_axe_berserker's_call"	"Taunts nearby enemies, forcing them to attack."
"DOTA_BroadcastFact_AbilityMovie_axe_battle_hunger"	"Danneggia un nemico finché non uccide un'altra Unità."
"[english]DOTA_BroadcastFact_AbilityMovie_axe_battle_hunger"	"Damages an enemy until it kills another unit."
"DOTA_BroadcastFact_AbilityMovie_axe_counter_helix"	"Un contrattacco rotante che danneggia i nemici vicini."
"[english]DOTA_BroadcastFact_AbilityMovie_axe_counter_helix"	"Spinning counter-attack that hurts nearby enemies."
"DOTA_BroadcastFact_AbilityMovie_axe_culling_blade"	"Uccide istantaneamente un Eroe nemico con pochi punti salute."
"[english]DOTA_BroadcastFact_AbilityMovie_axe_culling_blade"	"Instantly kills an enemy hero with low health."
"DOTA_BroadcastFact_AbilityMovie_bane_enfeeble"	"Indebolisce gli attacchi fisici di un nemico."
"[english]DOTA_BroadcastFact_AbilityMovie_bane_enfeeble"	"Weakens an enemy's physical attacks."
"DOTA_BroadcastFact_AbilityMovie_bane_brain_sap"	"Danneggia il bersaglio e cura <hc>Bane</hc>."
"[english]DOTA_BroadcastFact_AbilityMovie_bane_brain_sap"	"Deals damage while healing <hc>Bane</hc>."
"DOTA_BroadcastFact_AbilityMovie_bane_nightmare"	"Fa sì che un'Unità si addormenti finché non viene attaccata."
"[english]DOTA_BroadcastFact_AbilityMovie_bane_nightmare"	"Puts an enemy to sleep until it is attacked."
"DOTA_BroadcastFact_AbilityMovie_bane_fiend's_grip"	"Afferra un nemico, disabilitandolo e danneggiandolo notevolmente."
"[english]DOTA_BroadcastFact_AbilityMovie_bane_fiend's_grip"	"Grips an enemy, disabling it and causing heavy damage."
"DOTA_BroadcastFact_AbilityMovie_batrider_sticky_napalm"	"Del petrolio appiccicoso che rallenta i nemici e aumenta i danni inflitti."
"[english]DOTA_BroadcastFact_AbilityMovie_batrider_sticky_napalm"	"Sticky oil slows enemies and boosts damage taken."
"DOTA_BroadcastFact_AbilityMovie_batrider_flamebreak"	"Un cocktail esplosivo che respinge i nemici."
"[english]DOTA_BroadcastFact_AbilityMovie_batrider_flamebreak"	"An explosive cocktail that knocks back enemies."
"DOTA_BroadcastFact_AbilityMovie_batrider_firefly"	"Permette all'Eroe di muoversi in volo, lasciando dietro di sé una scia di fiamme."
"[english]DOTA_BroadcastFact_AbilityMovie_batrider_firefly"	"Grants flying movement. Lays a trail of flames."
"DOTA_BroadcastFact_AbilityMovie_batrider_flaming_lasso"	"Afferra un nemico e lo trascina dietro a <hc>Batrider</hc>."
"[english]DOTA_BroadcastFact_AbilityMovie_batrider_flaming_lasso"	"Grabs an enemy and drags them behind <hc>Batrider</hc>."
"DOTA_BroadcastFact_AbilityMovie_beastmaster_wild_axes"	"Lancia delle asce come se fossero dei boomerang, tagliando gli alberi e danneggiando i nemici."
"[english]DOTA_BroadcastFact_AbilityMovie_beastmaster_wild_axes"	"Throws axes in an arc, cutting trees and enemies."
"DOTA_BroadcastFact_AbilityMovie_beastmaster_call_of_the_wild"	"Evoca un Falco o un Cinghiale."
"[english]DOTA_BroadcastFact_AbilityMovie_beastmaster_call_of_the_wild"	"Summons a flying hawk or beast."
"DOTA_BroadcastFact_AbilityMovie_beastmaster_inner_beast"	"Aumenta la velocità di attacco degli alleati vicini."
"[english]DOTA_BroadcastFact_AbilityMovie_beastmaster_inner_beast"	"Increases the attack speed of nearby allies."
"DOTA_BroadcastFact_AbilityMovie_beastmaster_primal_roar"	"Danneggia e stordisce i nemici davanti all'Eroe. Ignora l'immunità agli incantesimi."
"[english]DOTA_BroadcastFact_AbilityMovie_beastmaster_primal_roar"	"Damages and stuns enemies in a cone. Pierces BKB."
"DOTA_BroadcastFact_AbilityMovie_bloodseeker_bloodrage"	"Aumenta i danni inflitti e subiti. Guarisce ad ogni uccisione."
"[english]DOTA_BroadcastFact_AbilityMovie_bloodseeker_bloodrage"	"Increases damage dealt and taken. Heals on kill."
"DOTA_BroadcastFact_AbilityMovie_bloodseeker_blood_rite"	"Danneggia e silenzia i nemici in una certa area."
"[english]DOTA_BroadcastFact_AbilityMovie_bloodseeker_blood_rite"	"A circle of blood that damages and silences an area."
"DOTA_BroadcastFact_AbilityMovie_bloodseeker_thirst"	"Aumenta la velocità di movimento e il danno d'attacco quando i nemici hanno salute bassa."
"[english]DOTA_BroadcastFact_AbilityMovie_bloodseeker_thirst"	"Bonus speed and damage when enemies have low HP."
"DOTA_BroadcastFact_AbilityMovie_bloodseeker_rupture"	"Provoca enormi danni ai nemici che si muovono. Ignora l'immunità agli incantesimi."
"[english]DOTA_BroadcastFact_AbilityMovie_bloodseeker_rupture"	"Causes massive damage to enemies who move. Pierces BKB."
"DOTA_BroadcastFact_AbilityMovie_bounty_hunter_shuriken_toss"	"Lancia una lama che danneggia e infligge un mini-stordimento."
"[english]DOTA_BroadcastFact_AbilityMovie_bounty_hunter_shuriken_toss"	"Throws a blade for damage and mini-stun."
"DOTA_BroadcastFact_AbilityMovie_bounty_hunter_jinada"	"Fa sì che un singolo attacco provochi più danni e rallenti il bersaglio."
"[english]DOTA_BroadcastFact_AbilityMovie_bounty_hunter_jinada"	"Grants bonus damage and slow to a single attack."
"DOTA_BroadcastFact_AbilityMovie_bounty_hunter_shadow_walk"	"Rende invisibili e aumenta i danni inflitti dall'attacco successivo."
"[english]DOTA_BroadcastFact_AbilityMovie_bounty_hunter_shadow_walk"	"Invisibility. Gives bonus damage to next attack."
"DOTA_BroadcastFact_AbilityMovie_bounty_hunter_track"	"Applica l'effetto di Vera Visione ad un nemico. Se il nemico muore, l'Eroe otterrà dell'oro aggiuntivo."
"[english]DOTA_BroadcastFact_AbilityMovie_bounty_hunter_track"	"Gives True Sight of an enemy, bonus gold upon their death."
"DOTA_BroadcastFact_AbilityMovie_brewmaster_thunder_clap"	"Colpisce il terreno rallentando e danneggiando i nemici."
"[english]DOTA_BroadcastFact_AbilityMovie_brewmaster_thunder_clap"	"Slams the earth, damaging and slowing enemies."
"DOTA_BroadcastFact_AbilityMovie_brewmaster_drunken_haze"	"Inzuppa un bersaglio facendogli mandare a vuoto gli attacchi."
"[english]DOTA_BroadcastFact_AbilityMovie_brewmaster_drunken_haze"	"Drenches a target, causing them to miss attacks."
"DOTA_BroadcastFact_AbilityMovie_brewmaster_drunken_brawler"	"Dona una probabilità di evitare gli attacchi e di infliggere danni critici."
"[english]DOTA_BroadcastFact_AbilityMovie_brewmaster_drunken_brawler"	"Gives a chance to avoid attacks and deal critical damage."
"DOTA_BroadcastFact_AbilityMovie_brewmaster_primal_split"	"Divide <hc>Brewmaster</hc> in tre guerrieri. Se uno di questi sopravvive, l'Eroe verrà resuscitato."
"[english]DOTA_BroadcastFact_AbilityMovie_brewmaster_primal_split"	"Splits <hc>Brewmaster</hc> into three warriors. If any survive, he is reborn."
"DOTA_BroadcastFact_AbilityMovie_bristleback_viscous_nasal_goo"	"Ricopre il bersaglio di muco, riducendone velocità e armatura."
"[english]DOTA_BroadcastFact_AbilityMovie_bristleback_viscous_nasal_goo"	"Covers a target in snot, reducing speed and armor."
"DOTA_BroadcastFact_AbilityMovie_bristleback_quill_spray"	"Lancia degli aculei in tutte le direzioni. I danni sono cumulabili."
"[english]DOTA_BroadcastFact_AbilityMovie_bristleback_quill_spray"	"Launches quills in all directions. Damage stacks."
"DOTA_BroadcastFact_AbilityMovie_bristleback_bristleback"	"Riduce i danni subiti dal fianco o alle spalle."
"[english]DOTA_BroadcastFact_AbilityMovie_bristleback_bristleback"	"Reduces damage taken from the side or rear."
"DOTA_BroadcastFact_AbilityMovie_bristleback_warpath"	"Aumenta la velocità di movimento e il danno d'attacco ogni volta che usa un'abilità."
"[english]DOTA_BroadcastFact_AbilityMovie_bristleback_warpath"	"Increases movement speed and damage each time he casts a spell."
"DOTA_BroadcastFact_AbilityMovie_broodmother_spawn_spiderlings"	"Inserisce delle uova in un nemico. Se il bersaglio muore, le uova si schiuderanno."
"[english]DOTA_BroadcastFact_AbilityMovie_broodmother_spawn_spiderlings"	"Injects eggs into an enemy that hatch if it dies."
"DOTA_BroadcastFact_AbilityMovie_broodmother_spin_web"	"Le ragnatele rendono invisibili e aumentano la velocità di movimento e la rigenerazione della salute."
"[english]DOTA_BroadcastFact_AbilityMovie_broodmother_spin_web"	"Webs grant invisibility, movement, and HP regen."
"DOTA_BroadcastFact_AbilityMovie_broodmother_incapacitating_bite"	"Il veleno rallenta i nemici e fa mandare a vuoto i loro attacchi."
"[english]DOTA_BroadcastFact_AbilityMovie_broodmother_incapacitating_bite"	"Venom slows enemies and causes them to miss attacks."
"DOTA_BroadcastFact_AbilityMovie_broodmother_insatiable_hunger"	"Gli attacchi dell'Eroe infliggono danni maggiori e prosciugano la salute dei nemici."
"[english]DOTA_BroadcastFact_AbilityMovie_broodmother_insatiable_hunger"	"A violent urge grants bonus damage and lifesteal to her attacks."
"DOTA_BroadcastFact_AbilityMovie_centaur_warrunner_hoof_stomp"	"Stordisce e danneggia i nemici intorno all'Eroe."
"[english]DOTA_BroadcastFact_AbilityMovie_centaur_warrunner_hoof_stomp"	"Stuns and damages enemies around him."
"DOTA_BroadcastFact_AbilityMovie_centaur_warrunner_double_edge"	"Danneggia i nemici all'interno di un'area e <hc>Centaur Warrunner</hc> stesso."
"[english]DOTA_BroadcastFact_AbilityMovie_centaur_warrunner_double_edge"	"Damages enemies in an area and <hc>Centaur Warrunner</hc> himself."
"DOTA_BroadcastFact_AbilityMovie_centaur_warrunner_return"	"Fa sì che i nemici che attaccano <hc>Centaur Warrunner</hc> subiscano dei danni."
"[english]DOTA_BroadcastFact_AbilityMovie_centaur_warrunner_return"	"Causes enemies to take damage when attacking <hc>Centaur Warrunner</hc>."
"DOTA_BroadcastFact_AbilityMovie_centaur_warrunner_stampede"	"Permette agli alleati di muoversi attraverso le Unità alla massima velocità."
"[english]DOTA_BroadcastFact_AbilityMovie_centaur_warrunner_stampede"	"Leads a charge that allows allies to move through units at max speed."
"DOTA_BroadcastFact_AbilityMovie_chaos_knight_chaos_bolt"	"Un dardo che infligge un danno e uno stordimento casuali."
"[english]DOTA_BroadcastFact_AbilityMovie_chaos_knight_chaos_bolt"	"Bolt that deals random damage and stun duration."
"DOTA_BroadcastFact_AbilityMovie_chaos_knight_reality_rift"	"Teletrasporta le Illusioni dell'Eroe verso un bersaglio, riducendone l'armatura."
"[english]DOTA_BroadcastFact_AbilityMovie_chaos_knight_reality_rift"	"Teleports his illusions to target, reducing its armor."
"DOTA_BroadcastFact_AbilityMovie_chaos_knight_chaos_strike"	"Gli attacchi hanno una probabilità di infliggere danni maggiori. I colpi critici curano l'Eroe."
"[english]DOTA_BroadcastFact_AbilityMovie_chaos_knight_chaos_strike"	"Attacks have a chance for bonus damage. Lifesteal on crits."
"DOTA_BroadcastFact_AbilityMovie_chaos_knight_phantasm"	"Evoca delle copie di <hc>Chaos Knight</hc> che infliggono il 100% dei danni."
"[english]DOTA_BroadcastFact_AbilityMovie_chaos_knight_phantasm"	"Summons copies of <hc>Chaos Knight</hc> that deal full damage on attacks."
"DOTA_BroadcastFact_AbilityMovie_chen_penitence"	"Rallenta un nemico. I bersagli subiscono più danni."
"[english]DOTA_BroadcastFact_AbilityMovie_chen_penitence"	"Slows an enemy. Targets take more damage."
"DOTA_BroadcastFact_AbilityMovie_chen_test_of_faith"	"Danneggia i nemici. Teletrasporta gli alleati alla base."
"[english]DOTA_BroadcastFact_AbilityMovie_chen_test_of_faith"	"Deals damage to enemies. Teleports allies to base."
"DOTA_BroadcastFact_AbilityMovie_chen_holy_persuasion"	"Permette di assumere il controllo permanente di un creep nemico o di un creep neutrale."
"[english]DOTA_BroadcastFact_AbilityMovie_chen_holy_persuasion"	"Permanently takes control of an enemy or neutral creep."
"DOTA_BroadcastFact_AbilityMovie_chen_hand_of_god"	"Cura tutti gli Eroi alleati e i creep controllati presenti sulla mappa."
"[english]DOTA_BroadcastFact_AbilityMovie_chen_hand_of_god"	"Heals all allied heroes and controlled creeps on the map."
"DOTA_BroadcastFact_AbilityMovie_clinkz_strafe"	"Aumenta notevolmente la velocità di attacco per un breve periodo."
"[english]DOTA_BroadcastFact_AbilityMovie_clinkz_strafe"	"Massively boosts attack speed for a short time."
"DOTA_BroadcastFact_AbilityMovie_clinkz_searing_arrows"	"Incendia le frecce per infliggere danni maggiori."
"[english]DOTA_BroadcastFact_AbilityMovie_clinkz_searing_arrows"	"Imbues arrows with fire for extra damage."
"DOTA_BroadcastFact_AbilityMovie_clinkz_skeleton_walk"	"Rende invisibili e aumenta la velocità di movimento."
"[english]DOTA_BroadcastFact_AbilityMovie_clinkz_skeleton_walk"	"Becomes invisible and gains move speed."
"DOTA_BroadcastFact_AbilityMovie_clinkz_death_pact"	"Divora un creep convertendo una percentuale della sua energia in salute e danni aggiuntivi."
"[english]DOTA_BroadcastFact_AbilityMovie_clinkz_death_pact"	"Devours a creep, gaining a percentage of its HP as health and damage."
"DOTA_BroadcastFact_AbilityMovie_clockwerk_battery_assault"	"Spara delle schegge che danneggiano e infliggono dei mini-stordimenti."
"[english]DOTA_BroadcastFact_AbilityMovie_clockwerk_battery_assault"	"Discharges shrapnel that damages and ministuns."
"DOTA_BroadcastFact_AbilityMovie_clockwerk_power_cogs"	"Intrappola il bersaglio e prosciuga il mana e la salute dei nemici che toccano gli ingranaggi."
"[english]DOTA_BroadcastFact_AbilityMovie_clockwerk_power_cogs"	"Traps foes and drains health/mana if they enemy teammates touch the cogs"
"DOTA_BroadcastFact_AbilityMovie_clockwerk_rocket_flare"	"Un razzo esplosivo che fornisce visione per 10 secondi."
"[english]DOTA_BroadcastFact_AbilityMovie_clockwerk_rocket_flare"	"An explosive rocket. Provides vision for 10 seconds."
"DOTA_BroadcastFact_AbilityMovie_clockwerk_hookshot"	"Spara un gancio che fa avvicinare <hc>Clockwerk</hc> al bersaglio. Stordisce e danneggia."
"[english]DOTA_BroadcastFact_AbilityMovie_clockwerk_hookshot"	"Fires a hook that reels <hc>Clockwerk</hc> to the target. Stuns and deals damage."
"DOTA_BroadcastFact_AbilityMovie_crystal_maiden_crystal_nova"	"Un'esplosione di ghiaccio che danneggia e rallenta i nemici."
"[english]DOTA_BroadcastFact_AbilityMovie_crystal_maiden_crystal_nova"	"A burst of frost that damages and slows enemies."
"DOTA_BroadcastFact_AbilityMovie_crystal_maiden_frostbite"	"Congela l'Unità nemica bersagliata, bloccandola sul posto e danneggiandola con il passare del tempo."
"[english]DOTA_BroadcastFact_AbilityMovie_crystal_maiden_frostbite"	"Roots an enemy with damaging ice."
"DOTA_BroadcastFact_AbilityMovie_crystal_maiden_arcane_aura"	"Aumenta la rigenerazione del mana di tutte le Unità alleate."
"[english]DOTA_BroadcastFact_AbilityMovie_crystal_maiden_arcane_aura"	"Provides bonus mana regen to all friendly units."
"DOTA_BroadcastFact_AbilityMovie_crystal_maiden_freezing_field"	"L'Eroe viene circondato da esplosioni di ghiaccio che danneggiano e rallentano i nemici."
"[english]DOTA_BroadcastFact_AbilityMovie_crystal_maiden_freezing_field"	"Covers the area in icy explosions that damage and slow enemies."
"DOTA_BroadcastFact_AbilityMovie_dark_seer_vacuum"	"Risucchia i nemici verso il punto bersagliato."
"[english]DOTA_BroadcastFact_AbilityMovie_dark_seer_vacuum"	"Sucks enemies towards a target point."
"DOTA_BroadcastFact_AbilityMovie_dark_seer_ion_shell"	"Protegge un'Unità con uno scudo di energia che danneggia i nemici."
"[english]DOTA_BroadcastFact_AbilityMovie_dark_seer_ion_shell"	"Creates a damaging energy shield around a unit."
"DOTA_BroadcastFact_AbilityMovie_dark_seer_surge"	"Aumenta la velocità di movimento dell'Eroe stesso o dei suoi alleati."
"[english]DOTA_BroadcastFact_AbilityMovie_dark_seer_surge"	"Charges self or allies with increased move speed."
"DOTA_BroadcastFact_AbilityMovie_dark_seer_wall_of_replica"	"Un muro che genera Illusioni dei nemici che lo attraversano."
"[english]DOTA_BroadcastFact_AbilityMovie_dark_seer_wall_of_replica"	"A wall that spawns illusions of enemies that pass through."
"DOTA_BroadcastFact_AbilityMovie_dazzle_poison_touch"	"Un incantesimo che rallenta e danneggia i nemici."
"[english]DOTA_BroadcastFact_AbilityMovie_dazzle_poison_touch"	"A noxious spell that slows and damages enemies."
"DOTA_BroadcastFact_AbilityMovie_dazzle_shallow_grave"	"Impedisce ad un alleato di morire per un breve periodo."
"[english]DOTA_BroadcastFact_AbilityMovie_dazzle_shallow_grave"	"Prevents an ally from dying for a short time."
"DOTA_BroadcastFact_AbilityMovie_dazzle_shadow_wave"	"Un raggio di energia che cura gli alleati e danneggia i nemici."
"[english]DOTA_BroadcastFact_AbilityMovie_dazzle_shadow_wave"	"An arcing bolt that heals allies and hurts enemies."
"DOTA_BroadcastFact_AbilityMovie_dazzle_weave"	"Aumenta l'armatura degli alleati e diminuisce quella dei nemici."
"[english]DOTA_BroadcastFact_AbilityMovie_dazzle_weave"	"Buffs allies' armor while decreasing enemy armor."
"DOTA_BroadcastFact_AbilityMovie_death_prophet_crypt_swarm"	"Invoca un'ondata di creature alate che danneggiano i nemici."
"[english]DOTA_BroadcastFact_AbilityMovie_death_prophet_crypt_swarm"	"Flings a harmful wave of winged beasts."
"DOTA_BroadcastFact_AbilityMovie_death_prophet_silence"	"Silenzia i nemici all'interno di una certa area."
"[english]DOTA_BroadcastFact_AbilityMovie_death_prophet_silence"	"Silences enemies in a target area."
"DOTA_BroadcastFact_AbilityMovie_death_prophet_spirit_siphon"	"Prosciuga la salute di un Eroe nemico e lo rallenta."
"[english]DOTA_BroadcastFact_AbilityMovie_death_prophet_spirit_siphon"	"Drains health and slows an enemy hero."
"DOTA_BroadcastFact_AbilityMovie_death_prophet_exorcism"	"Scatena una tempesta di spiriti che danneggia i nemici e le strutture vicine."
"[english]DOTA_BroadcastFact_AbilityMovie_death_prophet_exorcism"	"Unleashes a storm of spirits that damages nearby enemies and structures."
"DOTA_BroadcastFact_AbilityMovie_disruptor_thunder_strike"	"Colpisce ripetutamente il bersaglio con delle saette."
"[english]DOTA_BroadcastFact_AbilityMovie_disruptor_thunder_strike"	"Repeatedly strikes target with lightning."
"DOTA_BroadcastFact_AbilityMovie_disruptor_glimpse"	"Teletrasporta il bersaglio nel luogo in cui si trovava qualche secondo prima."
"[english]DOTA_BroadcastFact_AbilityMovie_disruptor_glimpse"	"Teleports the target back to where it was a few seconds ago."
"DOTA_BroadcastFact_AbilityMovie_disruptor_kinetic_field"	"Crea una barriera circolare che i nemici non possono oltrepassare."
"[english]DOTA_BroadcastFact_AbilityMovie_disruptor_kinetic_field"	"Creates a circular barrier that enemies can't pass."
"DOTA_BroadcastFact_AbilityMovie_disruptor_static_storm"	"Crea una tempesta che silenzia e danneggia i nemici."
"[english]DOTA_BroadcastFact_AbilityMovie_disruptor_static_storm"	"Brews a storm that damages and silences enemies."
"DOTA_BroadcastFact_AbilityMovie_doom_devour"	"Mangia un creep non alleato e permette di acquisire le sue abilità."
"[english]DOTA_BroadcastFact_AbilityMovie_doom_devour"	"Eats a non-friendly creep and grants its abilities."
"DOTA_BroadcastFact_AbilityMovie_doom_scorched_earth"	"Una distesa di fiamme che cura Doom e danneggia i nemici."
"[english]DOTA_BroadcastFact_AbilityMovie_doom_scorched_earth"	"A self-healing flame field that damages enemies."
"DOTA_BroadcastFact_AbilityMovie_doom_infernal_blade"	"Stordisce per breve tempo e danneggia con il passare del tempo."
"[english]DOTA_BroadcastFact_AbilityMovie_doom_infernal_blade"	"Briefly stuns and deals damage over time."
"DOTA_BroadcastFact_AbilityMovie_doom_doom"	"Danneggia un nemico nel corso del tempo, impedendogli di usare abilità o oggetti."
"[english]DOTA_BroadcastFact_AbilityMovie_doom_doom"	"Damages an enemy over time, stopping all ability or item-use."
"DOTA_BroadcastFact_AbilityMovie_dragon_knight_breathe_fire"	"Un'onda di fuoco che indebolisce gli attacchi dei nemici."
"[english]DOTA_BroadcastFact_AbilityMovie_dragon_knight_breathe_fire"	"A wave of fire that weakens enemy attacks."
"DOTA_BroadcastFact_AbilityMovie_dragon_knight_dragon_tail"	"Stordisce un nemico che si trova a corta distanza."
"[english]DOTA_BroadcastFact_AbilityMovie_dragon_knight_dragon_tail"	"Stuns an enemy in melee range."
"DOTA_BroadcastFact_AbilityMovie_dragon_knight_dragon_blood"	"Aumenta l'armatura e la rigenerazione della salute."
"[english]DOTA_BroadcastFact_AbilityMovie_dragon_knight_dragon_blood"	"Improves health regeneration and armor."
"DOTA_BroadcastFact_AbilityMovie_dragon_knight_elder_dragon_form"	"Dragon Knight si trasforma in un dragone con attacchi elementali a distanza che rallentano."
"[english]DOTA_BroadcastFact_AbilityMovie_dragon_knight_elder_dragon_form"	"Transforms into a dragon with ranged elemental attacks that slow."
"DOTA_BroadcastFact_AbilityMovie_drow_ranger_frost_arrows"	"Spara delle frecce congelanti che rallentano i nemici."
"[english]DOTA_BroadcastFact_AbilityMovie_drow_ranger_frost_arrows"	"Fires freezing arrows, slowing enemy heroes."
"DOTA_BroadcastFact_AbilityMovie_drow_ranger_gust"	"Silenzia e respinge i nemici."
"[english]DOTA_BroadcastFact_AbilityMovie_drow_ranger_gust"	"Silences and knocks back enemies."
"DOTA_BroadcastFact_AbilityMovie_drow_ranger_precision_aura"	"Aumenta il danno degli attacchi a distanza degli alleati."
"[english]DOTA_BroadcastFact_AbilityMovie_drow_ranger_precision_aura"	"Increases damage of allies' ranged attacks."
"DOTA_BroadcastFact_AbilityMovie_drow_ranger_marksmanship"	"Aumenta l'Agilità se non ci sono nemici nelle vicinanze."
"[english]DOTA_BroadcastFact_AbilityMovie_drow_ranger_marksmanship"	"Grants bonus agility if no enemies are nearby."
"DOTA_BroadcastFact_AbilityMovie_earth_spirit_boulder_smash"	"Colpisce un bersaglio o un Residuo di pietra, facendolo volare in una direzione e stordendo i nemici che si trovano nel suo cammino."
"[english]DOTA_BroadcastFact_AbilityMovie_earth_spirit_boulder_smash"	"Smashes a target or remnant, sending it flying and stunning enemies caught in its path."
"DOTA_BroadcastFact_AbilityMovie_earth_spirit_rolling_boulder"	"Earth Spirit si trasforma in un macigno e rotola verso un bersaglio."
"[english]DOTA_BroadcastFact_AbilityMovie_earth_spirit_rolling_boulder"	"Transforms and rolls toward a target."
"DOTA_BroadcastFact_AbilityMovie_earth_spirit_geomagnetic_grip"	"Attira a sé un Residuo di pietra, silenziando i nemici che vengono colpiti."
"[english]DOTA_BroadcastFact_AbilityMovie_earth_spirit_geomagnetic_grip"	"Pulls a stone remnant, silencing enemies hit."
"DOTA_BroadcastFact_AbilityMovie_earth_spirit_magnetize"	"Danneggia con il passare del tempo e fa esplodere i Residui di pietra vicini."
"[english]DOTA_BroadcastFact_AbilityMovie_earth_spirit_magnetize"	"Causes pulsing damage and detonates nearby remnants."
"DOTA_BroadcastFact_AbilityMovie_earthshaker_fissure"	"Crea un muro di pietra che stordisce i nemici."
"[english]DOTA_BroadcastFact_AbilityMovie_earthshaker_fissure"	"Creates a wall of stone that stuns foes."
"DOTA_BroadcastFact_AbilityMovie_earthshaker_enchant_totem"	"Potenzia il suo prossimo attacco aumentandone il danno."
"[english]DOTA_BroadcastFact_AbilityMovie_earthshaker_enchant_totem"	"Empowers his next attack with bonus damage."
"DOTA_BroadcastFact_AbilityMovie_earthshaker_aftershock"	"Le abilità infliggono danni maggiori e stordiscono i nemici vicini."
"[english]DOTA_BroadcastFact_AbilityMovie_earthshaker_aftershock"	"Abilities do damage and stun nearby enemies."
"DOTA_BroadcastFact_AbilityMovie_earthshaker_echo_slam"	"Colpisce violentemente una certa area. Più nemici si trovano nell'area e più grande sarà il danno inflitto."
"[english]DOTA_BroadcastFact_AbilityMovie_earthshaker_echo_slam"	"Slams and stuns an area. Damage increases with more enemies."
"DOTA_BroadcastFact_AbilityMovie_elder_titan_echo_stomp"	"Danneggia e fa addormentare i nemici con un potente pestone. Gli attacchi svegliano i bersagli."
"[english]DOTA_BroadcastFact_AbilityMovie_elder_titan_echo_stomp"	"Damages and sleeps enemies with a mighty stomp. Attacks wake up his targets."
"DOTA_BroadcastFact_AbilityMovie_elder_titan_ancestral_spirit"	"Uno spirito che danneggia le Unità che tocca. Può usare l'abilità Pestone ecosismico."
"[english]DOTA_BroadcastFact_AbilityMovie_elder_titan_ancestral_spirit"	"Spirit that damages units touched. Can use Stomp."
"DOTA_BroadcastFact_AbilityMovie_elder_titan_natural_order"	"Riduce l'armatura e la resistenza ai danni magici dei nemici vicini."
"[english]DOTA_BroadcastFact_AbilityMovie_elder_titan_natural_order"	"Reduces armor and magic resistance of nearby foes."
"DOTA_BroadcastFact_AbilityMovie_elder_titan_earth_splitter"	"Spezza il terreno, danneggiando e rallentando i nemici."
"[english]DOTA_BroadcastFact_AbilityMovie_elder_titan_earth_splitter"	"Cracks the earth, damaging and displacing enemies, subsequently slowing them."
"DOTA_BroadcastFact_AbilityMovie_ember_spirit_searing_chains"	"Scatena delle bolas infuocate che intrappolano e danneggiano i nemici."
"[english]DOTA_BroadcastFact_AbilityMovie_ember_spirit_searing_chains"	"Unleashes bolas to trap and damage enemies."
"DOTA_BroadcastFact_AbilityMovie_ember_spirit_sleight_of_fist"	"Effettua un attacco ad area per poi ritornare al punto di partenza."
"[english]DOTA_BroadcastFact_AbilityMovie_ember_spirit_sleight_of_fist"	"Attacks in an area and returns to starting spot."
"DOTA_BroadcastFact_AbilityMovie_ember_spirit_flame_guard"	"Blocca i danni magici mentre infligge danni ad area."
"[english]DOTA_BroadcastFact_AbilityMovie_ember_spirit_flame_guard"	"Blocks magic damage while radiating area damage."
"DOTA_BroadcastFact_AbilityMovie_ember_spirit_fire_remnant"	"Permette di teletrasportarsi verso un Residuo di fuoco presente sulla mappa."
"[english]DOTA_BroadcastFact_AbilityMovie_ember_spirit_fire_remnant"	"Teleport to a remnant placed on the map."
"DOTA_BroadcastFact_AbilityMovie_enchantress_untouchable"	"Rallenta i nemici che la attaccano."
"[english]DOTA_BroadcastFact_AbilityMovie_enchantress_untouchable"	"Slows enemies who attack her."
"DOTA_BroadcastFact_AbilityMovie_enchantress_enchant"	"Permette di assumere il controllo di creep nemici e neutrali. Rallenta gli Eroi nemici bersagliati."
"[english]DOTA_BroadcastFact_AbilityMovie_enchantress_enchant"	"Brings neutral or enemy creeps under her control. Slows targeted enemy heroes."
"DOTA_BroadcastFact_AbilityMovie_enchantress_nature's_attendants"	"Una nube di spiriti cura <hc>Enchantress</hc> e gli alleati vicini."
"[english]DOTA_BroadcastFact_AbilityMovie_enchantress_nature's_attendants"	"A cloud of wisps heal <hc>Enchantress</hc> and nearby allies."
"DOTA_BroadcastFact_AbilityMovie_enchantress_impetus"	"Gli attacchi infliggono danni maggiori all'aumentare della distanza del bersaglio."
"[english]DOTA_BroadcastFact_AbilityMovie_enchantress_impetus"	"Attacks deal more damage as the distance to target increases."
"DOTA_BroadcastFact_AbilityMovie_enigma_malefice"	"Danneggia e stordisce ripetutamente un nemico."
"[english]DOTA_BroadcastFact_AbilityMovie_enigma_malefice"	"Damages and repeatedly stuns and enemy."
"DOTA_BroadcastFact_AbilityMovie_enigma_demonic_conversion"	"Converte un creep in frammenti più piccoli di <hc>Enigma</hc>. Gli attacchi dei frammenti raddoppiano il loro numero."
"[english]DOTA_BroadcastFact_AbilityMovie_enigma_demonic_conversion"	"Converts a creep into smaller fragments of <hc>Enigma</hc>. Attacks from fragments doubles their number."
"DOTA_BroadcastFact_AbilityMovie_enigma_midnight_pulse"	"Danneggia i nemici in un'area in base alla loro salute massima."
"[english]DOTA_BroadcastFact_AbilityMovie_enigma_midnight_pulse"	"Damages enemies in an area based on their max HP."
"DOTA_BroadcastFact_AbilityMovie_enigma_black_hole"	"Risucchia i nemici, danneggiandoli e immobilizzandoli."
"[english]DOTA_BroadcastFact_AbilityMovie_enigma_black_hole"	"Pulls in enemies, damaging and immobilizing them."
"DOTA_BroadcastFact_AbilityMovie_faceless_void_time_walk"	"L'Eroe sfreccia verso la posizione bersagliata, annullando tutti i danni ricevuti negli ultimi secondi."
"[english]DOTA_BroadcastFact_AbilityMovie_faceless_void_time_walk"	"Jumps forward, undoing damage received within the last few seconds."
"DOTA_BroadcastFact_AbilityMovie_faceless_void_time_dilation"	"Rallenta i nemici e blocca i tempi di ricarica."
"[english]DOTA_BroadcastFact_AbilityMovie_faceless_void_time_dilation"	"Freezes cooldowns of enemies, slowing them."
"DOTA_BroadcastFact_AbilityMovie_faceless_void_time_lock"	"L'Eroe ha la probabilità di stordire un nemico e infliggere dei danni aggiuntivi."
"[english]DOTA_BroadcastFact_AbilityMovie_faceless_void_time_lock"	"Grants chance to stun and increase damage."
"DOTA_BroadcastFact_AbilityMovie_faceless_void_chronosphere"	"Intrappola i nemici in una sfera, ma <hc>Faceless Void</hc> può muoversi ed attaccare liberamente."
"[english]DOTA_BroadcastFact_AbilityMovie_faceless_void_chronosphere"	"Traps enemies in a sphere, but <hc>Faceless Void</hc> can freely move and attack."
"DOTA_BroadcastFact_AbilityMovie_gyrocopter_rocket_barrage"	"Una raffica di razzi che colpisce i nemici vicini per qualche secondo."
"[english]DOTA_BroadcastFact_AbilityMovie_gyrocopter_rocket_barrage"	"Rapid-fires rockets at nearby enemies for several seconds."
"DOTA_BroadcastFact_AbilityMovie_gyrocopter_homing_missile"	"Spara un missile a ricerca che stordisce il bersaglio."
"[english]DOTA_BroadcastFact_AbilityMovie_gyrocopter_homing_missile"	"Fires a homing missle that stuns its target."
"DOTA_BroadcastFact_AbilityMovie_gyrocopter_flak_cannon"	"Colpisce tutti i nemici in una certa area per un numero limitato di attacchi."
"[english]DOTA_BroadcastFact_AbilityMovie_gyrocopter_flak_cannon"	"Hits all enemies in an area for a limited number of attacks."
"DOTA_BroadcastFact_AbilityMovie_gyrocopter_call_down"	"Un attacco aereo missilistico che rallenta e danneggia tutti i nemici nell'area colpita."
"[english]DOTA_BroadcastFact_AbilityMovie_gyrocopter_call_down"	"Aerial missile strikes that slow, then damage, all enemies within the blast area."
"DOTA_BroadcastFact_AbilityMovie_huskar_inner_vitality"	"Aumenta notevolmente la rigenerazione della salute del bersaglio."
"[english]DOTA_BroadcastFact_AbilityMovie_huskar_inner_vitality"	"Massively boosts health regen of a target."
"DOTA_BroadcastFact_AbilityMovie_huskar_burning_spear"	"Gli attacchi provocano danni da bruciatura. I danni si accumulano ad ogni attacco consecutivo."
"[english]DOTA_BroadcastFact_AbilityMovie_huskar_burning_spear"	"Grants burning damage to attacks. Damage stacks with each subsequent attack."
"DOTA_BroadcastFact_AbilityMovie_huskar_berserker's_blood"	"A mano a mano che la salute diminuisce, la velocità di attacco e la resistenza ai danni magici aumentano."
"[english]DOTA_BroadcastFact_AbilityMovie_huskar_berserker's_blood"	"As health decreases, attack speed and spell resistance increases."
"DOTA_BroadcastFact_AbilityMovie_huskar_life_break"	"L'Eroe balza verso un bersaglio, danneggiandolo e rallentandolo."
"[english]DOTA_BroadcastFact_AbilityMovie_huskar_life_break"	"Leaps to a target, damaging and slowing them."
"DOTA_BroadcastFact_AbilityMovie_invoker_quas"	"Aumenta la rigenerazione della salute e permette all'Eroe di utilizzare gli incantesimi di ghiaccio."
"[english]DOTA_BroadcastFact_AbilityMovie_invoker_quas"	"Grants ice spells, strength, and health regen."
"DOTA_BroadcastFact_AbilityMovie_invoker_wex"	"Aumenta la velocità di movimento e di attacco e permette all'Eroe di utilizzare gli incantesimi della tempesta."
"[english]DOTA_BroadcastFact_AbilityMovie_invoker_wex"	"Grants storm spells, agility, move and attack speed."
"DOTA_BroadcastFact_AbilityMovie_invoker_exort"	"Aumenta il danno d'attacco e permette all'Eroe di utilizzare gli incantesimi di fuoco."
"[english]DOTA_BroadcastFact_AbilityMovie_invoker_exort"	"Grants fire spells, intelligence, and attack damage."
"DOTA_BroadcastFact_AbilityMovie_invoker_invoke"	"Combina i diversi elementi per preparare uno dei 10 incantesimi."
"[english]DOTA_BroadcastFact_AbilityMovie_invoker_invoke"	"Combines spell types to ready any one of 11 spells."
"DOTA_BroadcastFact_AbilityMovie_io_tether"	"Permette di legarsi ad un alleato, aumentando la velocità di movimento e la rigenerazione della salute e del mana quando <hc>Io</hc> cura se stesso."
"[english]DOTA_BroadcastFact_AbilityMovie_io_tether"	"Tethers to an ally. Grants movespeed and improved health/mana regen when <hc>Io</hc> heals itself."
"DOTA_BroadcastFact_AbilityMovie_io_spirits"	"Degli <ac>spiriti</ac> che ruotano intorno ad <hc>Io</hc> e danneggiano i nemici al contatto."
"[english]DOTA_BroadcastFact_AbilityMovie_io_spirits"	"<ac>Spirits</ac> that circle <hc>Io</hc> and damage heroes on contact."
"DOTA_BroadcastFact_AbilityMovie_io_overcharge"	"Sacrifica salute e mana per aumentare la velocità di attacco e la resistenza ai danni."
"[english]DOTA_BroadcastFact_AbilityMovie_io_overcharge"	"Use health/mana for attack speed and damage reduction."
"DOTA_BroadcastFact_AbilityMovie_io_relocate"	"Teletrasporta <hc>Io</hc> e un alleato ad esso legato in qualsiasi punto della mappa. Ritorneranno al punto di partenza dopo alcuni secondi."
"[english]DOTA_BroadcastFact_AbilityMovie_io_relocate"	"Teleports <hc>Io</hc> and a tethered ally to any location. Returns momentarily after."
"DOTA_BroadcastFact_AbilityMovie_jakiro_dual_breath"	"Esplosioni di fuoco e di gelo che rallentano e bruciano i nemici."
"[english]DOTA_BroadcastFact_AbilityMovie_jakiro_dual_breath"	"Hot and cold blasts that slow and burn enemies."
"DOTA_BroadcastFact_AbilityMovie_jakiro_ice_path"	"Una distesa di ghiaccio che stordisce e danneggia i nemici."
"[english]DOTA_BroadcastFact_AbilityMovie_jakiro_ice_path"	"A path of ice that stuns and damages enemies."
"DOTA_BroadcastFact_AbilityMovie_jakiro_liquid_fire"	"Brucia i nemici e le strutture in una certa area. Rallenta gli attacchi."
"[english]DOTA_BroadcastFact_AbilityMovie_jakiro_liquid_fire"	"Burns enemies and buildings in an area. Slows attacks."
"DOTA_BroadcastFact_AbilityMovie_jakiro_macropyre"	"Esala delle fiamme in linea retta che bruciano i nemici dall'interno."
"[english]DOTA_BroadcastFact_AbilityMovie_jakiro_macropyre"	"Lays down a line of flames that burn any enemy inside."
"DOTA_BroadcastFact_AbilityMovie_juggernaut_blade_fury"	"Un attacco rotante che colpisce i nemici nelle vicinanze e rende <hc>Juggernaut</hc> immune agli incantesimi."
"[english]DOTA_BroadcastFact_AbilityMovie_juggernaut_blade_fury"	"A spinning attack that attacks nearby enemies and grants <hc>Juggernaut</hc> magic immunity."
"DOTA_BroadcastFact_AbilityMovie_juggernaut_healing_ward"	"Evoca un guardiano mobile che cura gli alleati vicini."
"[english]DOTA_BroadcastFact_AbilityMovie_juggernaut_healing_ward"	"Summons a mobile ward to heal nearby allies."
"DOTA_BroadcastFact_AbilityMovie_juggernaut_blade_dance"	"L'Eroe ottiene la probabilità di infliggere il doppio dei danni quando attacca."
"[english]DOTA_BroadcastFact_AbilityMovie_juggernaut_blade_dance"	"Gives a chance for double damage on attacks."
"DOTA_BroadcastFact_AbilityMovie_juggernaut_omnislash"	"Una potente sequenza di salti che danneggiano ripetutamente."
"[english]DOTA_BroadcastFact_AbilityMovie_juggernaut_omnislash"	"A powerful jumping assault that strikes repeatedly."
"DOTA_BroadcastFact_AbilityMovie_keeper_of_the_light_illuminate"	"Canalizza dell'energia che danneggia e dà visione lungo il suo percorso."
"[english]DOTA_BroadcastFact_AbilityMovie_keeper_of_the_light_illuminate"	"Channels energy that damages and grants vision."
"DOTA_BroadcastFact_AbilityMovie_keeper_of_the_light_mana_leak"	"Fa sì che un nemico perda del mana quando si muove."
"[english]DOTA_BroadcastFact_AbilityMovie_keeper_of_the_light_mana_leak"	"Causes enemy to lose mana as they move."
"DOTA_BroadcastFact_AbilityMovie_keeper_of_the_light_chakra_magic"	"Ripristina il mana e riduce il tempo di ricarica dell'abilità successiva del bersaglio."
"[english]DOTA_BroadcastFact_AbilityMovie_keeper_of_the_light_chakra_magic"	"Restores mana, reduces target's next cooldown."
"DOTA_BroadcastFact_AbilityMovie_keeper_of_the_light_spirit_form"	"Sblocca temporaneamente nuove potenti abilità."
"[english]DOTA_BroadcastFact_AbilityMovie_keeper_of_the_light_spirit_form"	"Temporarily unlocks powerful new abilities."
"DOTA_BroadcastFact_AbilityMovie_kunkka_torrent"	"Scaraventa i nemici in aria. Stordisce e rallenta i nemici colpiti."
"[english]DOTA_BroadcastFact_AbilityMovie_kunkka_torrent"	"Hurls enemies in the air. Stuns then slows caught foes."
"DOTA_BroadcastFact_AbilityMovie_kunkka_tidebringer"	"Gli attacchi infliggono dei danni in un'area davanti all'Eroe."
"[english]DOTA_BroadcastFact_AbilityMovie_kunkka_tidebringer"	"Attacks deal damage in an area in front of Kunkaa."
"DOTA_BroadcastFact_AbilityMovie_kunkka_x_marks_the_spot"	"Marchia la posizione di un bersaglio con una X e lo fa ritornare in quel punto dopo alcuni secondi."
"[english]DOTA_BroadcastFact_AbilityMovie_kunkka_x_marks_the_spot"	"Marks a target with an X and returns them to that spot."
"DOTA_BroadcastFact_AbilityMovie_kunkka_ghost_ship"	"Evoca una nave che danneggia e stordisce i nemici in una certa area."
"[english]DOTA_BroadcastFact_AbilityMovie_kunkka_ghost_ship"	"Summons a ship that damages and stuns enemies in an area."
"DOTA_BroadcastFact_AbilityMovie_legion_commander_overwhelming_odds"	"Infligge danni ad area e aumenta la velocità di movimento di <hc>Legion Commander</hc>."
"[english]DOTA_BroadcastFact_AbilityMovie_legion_commander_overwhelming_odds"	"Deals area damage and grants bonus movespeed to <hc>Legion Commander</hc>."
"DOTA_BroadcastFact_AbilityMovie_legion_commander_press_the_attack"	"Rimuove gli effetti negativi e le disabilitazioni. Aumenta la rigenerazione della salute e la velocità di attacco."
"[english]DOTA_BroadcastFact_AbilityMovie_legion_commander_press_the_attack"	"Removes debuffs and disables. Grants HP regen and attack speed."
"DOTA_BroadcastFact_AbilityMovie_legion_commander_moment_of_courage"	"L'Eroe ottiene la probabilità di contrattaccare prosciugando la salute dei nemici."
"[english]DOTA_BroadcastFact_AbilityMovie_legion_commander_moment_of_courage"	"Grants a chance for counterattacks with bonus lifesteal."
"DOTA_BroadcastFact_AbilityMovie_legion_commander_duel"	"Obbliga l'Eroe bersagliato a combattere. Il vincitore ottiene danni aggiuntivi."
"[english]DOTA_BroadcastFact_AbilityMovie_legion_commander_duel"	"Forces the target hero to battle. The winner gains bonus damage."
"DOTA_BroadcastFact_AbilityMovie_leshrac_split_earth"	"Spacca la terra danneggiando e stordendo i nemici."
"[english]DOTA_BroadcastFact_AbilityMovie_leshrac_split_earth"	"Splits the earth, damaging and stunning enemies."
"DOTA_BroadcastFact_AbilityMovie_leshrac_diabolic_edict"	"Genera delle esplosioni intorno a <hc>Leshrac</hc> che danneggiano nemici e strutture."
"[english]DOTA_BroadcastFact_AbilityMovie_leshrac_diabolic_edict"	"Creates explosions all around <hc>Leshrac</hc>, damaging enemies and buildings."
"DOTA_BroadcastFact_AbilityMovie_leshrac_lightning_storm"	"Una tempesta che rallenta e danneggia un bersaglio, per poi diffondersi ai nemici vicini."
"[english]DOTA_BroadcastFact_AbilityMovie_leshrac_lightning_storm"	"Blasts and slows the target, and jumps to nearby enemies."
"DOTA_BroadcastFact_AbilityMovie_leshrac_pulse_nova"	"Crea delle ondate di energia che danneggiano i nemici vicini."
"[english]DOTA_BroadcastFact_AbilityMovie_leshrac_pulse_nova"	"Creates waves of energy that damage nearby enemies."
"DOTA_BroadcastFact_AbilityMovie_lich_frost_nova"	"Danneggia un nemico rallentandone la velocità di movimento e la velocità di attacco."
"[english]DOTA_BroadcastFact_AbilityMovie_lich_frost_nova"	"Damages an enemy that slows their movespeed and attack speed."
"DOTA_BroadcastFact_AbilityMovie_lich_frost_armor"	"Crea uno scudo che aumenta l'armatura di un alleato."
"[english]DOTA_BroadcastFact_AbilityMovie_lich_frost_armor"	"Creates a shield that adds armor to an ally."
"DOTA_BroadcastFact_AbilityMovie_lich_dark_ritual"	"Sacrifica un creep alleato e lo converte in mana."
"[english]DOTA_BroadcastFact_AbilityMovie_lich_dark_ritual"	"Consumes a friendly creep to convert into mana."
"DOTA_BroadcastFact_AbilityMovie_lich_chain_frost"	"Una potente esplosione che rimbalza da un nemico all'altro."
"[english]DOTA_BroadcastFact_AbilityMovie_lich_chain_frost"	"A powerful blast that bounces between enemies."
"DOTA_BroadcastFact_AbilityMovie_life_stealer_rage"	"Una furia scatenata che rende immuni agli incantesimi e aumenta la velocità di attacco."
"[english]DOTA_BroadcastFact_AbilityMovie_life_stealer_rage"	"Induces a rage that grants magic immunity and attack speed."
"DOTA_BroadcastFact_AbilityMovie_life_stealer_feast"	"Attaccare un nemico guarisce <hc>Lifestealer</hc>."
"[english]DOTA_BroadcastFact_AbilityMovie_life_stealer_feast"	"Attacking an enemy heals <hc>Lifestealer</hc>."
"DOTA_BroadcastFact_AbilityMovie_life_stealer_open_wounds"	"Rallenta un nemico. I danni ricevuti dagli aggressori curano l'Eroe."
"[english]DOTA_BroadcastFact_AbilityMovie_life_stealer_open_wounds"	"Slows an enemy. Damage received from attackers heals them."
"DOTA_BroadcastFact_AbilityMovie_life_stealer_infest"	"Permette di nascondersi in un'Unità o in un Eroe, infliggendo dei danni all'uscita."
"[english]DOTA_BroadcastFact_AbilityMovie_life_stealer_infest"	"Hides inside a unit or hero. Damages upon exit."
"DOTA_BroadcastFact_AbilityMovie_lina_dragon_slave"	"Un'onda di fuoco che danneggia i nemici che incontra."
"[english]DOTA_BroadcastFact_AbilityMovie_lina_dragon_slave"	"A wave of fire that scorches enemies in its path."
"DOTA_BroadcastFact_AbilityMovie_lina_light_strike_array"	"Stordisce e danneggia i nemici dall'alto."
"[english]DOTA_BroadcastFact_AbilityMovie_lina_light_strike_array"	"Stuns and damages enemies from above."
"DOTA_BroadcastFact_AbilityMovie_lina_fiery_soul"	"Aumenta la velocità di attacco e la velocità di movimento ogni volta che viene lanciato un incantesimo. È cumulabile."
"[english]DOTA_BroadcastFact_AbilityMovie_lina_fiery_soul"	"Boosts attack and move speed with each spell cast. Stacks."
"DOTA_BroadcastFact_AbilityMovie_lina_laguna_blade"	"Annienta un singolo bersaglio infliggendo un'enorme quantità di danni."
"[english]DOTA_BroadcastFact_AbilityMovie_lina_laguna_blade"	"Obliterates a single enemy with massive damage."
"DOTA_BroadcastFact_AbilityMovie_lion_earth_spike"	"Stordisce uno o più nemici in linea retta."
"[english]DOTA_BroadcastFact_AbilityMovie_lion_earth_spike"	"Stuns one or more enemies in a line."
"DOTA_BroadcastFact_AbilityMovie_lion_hex"	"Trasforma un nemico in una creatura indifesa."
"[english]DOTA_BroadcastFact_AbilityMovie_lion_hex"	"Transforms an enemy into a harmless beast."
"DOTA_BroadcastFact_AbilityMovie_lion_mana_drain"	"Prosciuga il mana del bersaglio con il passare del tempo."
"[english]DOTA_BroadcastFact_AbilityMovie_lion_mana_drain"	"Continuously steals mana from a target."
"DOTA_BroadcastFact_AbilityMovie_lion_finger_of_death"	"Squarcia un'Unità nemica danneggiandola enormemente."
"[english]DOTA_BroadcastFact_AbilityMovie_lion_finger_of_death"	"Rips an enemy for massive damage."
"DOTA_BroadcastFact_AbilityMovie_lone_druid_summon_spirit_bear"	"Evoca uno <ac>Spirito orso</ac> che può equipaggiare oggetti e attaccare i nemici."
"[english]DOTA_BroadcastFact_AbilityMovie_lone_druid_summon_spirit_bear"	"Summons a <ac>Spirit Bear</ac> that can equip items and attack enemies."
"DOTA_BroadcastFact_AbilityMovie_lone_druid_rabid"	"Aumenta la velocità di attacco e la velocità di movimento dell'Eroe e del suo orso."
"[english]DOTA_BroadcastFact_AbilityMovie_lone_druid_rabid"	"Increases his and his bear's attack and move speeds."
"DOTA_BroadcastFact_AbilityMovie_lone_druid_savage_roar"	"Emette un ruggito che fa fuggire i nemici nelle vicinanze."
"[english]DOTA_BroadcastFact_AbilityMovie_lone_druid_savage_roar"	"Unleashes a roar that causes nearby enemies to flee."
"DOTA_BroadcastFact_AbilityMovie_lone_druid_true_form"	"L'Eroe si trasforma in un potente orso con attacchi corpo a corpo."
"[english]DOTA_BroadcastFact_AbilityMovie_lone_druid_true_form"	"Transform into a mighty bear with melee attack."
"DOTA_BroadcastFact_AbilityMovie_luna_lucent_beam"	"Un raggio di luce che stordisce e danneggia un nemico."
"[english]DOTA_BroadcastFact_AbilityMovie_luna_lucent_beam"	"A beam of light that stuns and damages an enemy."
"DOTA_BroadcastFact_AbilityMovie_luna_moon_glaive"	"Fa sì che gli attacchi rimbalzino da un nemico all'altro."
"[english]DOTA_BroadcastFact_AbilityMovie_luna_moon_glaive"	"Empowers attacks to bounce between enemies."
"DOTA_BroadcastFact_AbilityMovie_luna_lunar_blessing"	"Aumenta il danno d'attacco di <hc>Luna</hc> e dei suoi alleati."
"[english]DOTA_BroadcastFact_AbilityMovie_luna_lunar_blessing"	"Increases attack damage of <hc>Luna</hc> and her allies."
"DOTA_BroadcastFact_AbilityMovie_luna_eclipse"	"Colpisce casualmente i nemici vicini con l'abilità <ac>Raggio lucente</ac>."
"[english]DOTA_BroadcastFact_AbilityMovie_luna_eclipse"	"Showers random nearby enemies with <ac>Lucent Beams</ac>."
"DOTA_BroadcastFact_AbilityMovie_lycan_summon_wolves"	"Evoca due lupi che combatteranno al fianco di <hc>Lycan</hc>."
"[english]DOTA_BroadcastFact_AbilityMovie_lycan_summon_wolves"	"Summons two wolves to fight for <hc>Lycan</hc>."
"DOTA_BroadcastFact_AbilityMovie_lycan_howl"	"Aumenta il danno d'attacco e la salute di <hc>Lycan</hc> e degli alleati."
"[english]DOTA_BroadcastFact_AbilityMovie_lycan_howl"	"Grants bonus damage and health to <hc>Lycan</hc> and allies."
"DOTA_BroadcastFact_AbilityMovie_lycan_feral_impulse"	"Aumenta la rigenerazione della salute e il danno di <hc>Lycan</hc> e delle sue Unità."
"[english]DOTA_BroadcastFact_AbilityMovie_lycan_feral_impulse"	"Increases HP regen and damage of <hc>Lycan</hc> and his units."
"DOTA_BroadcastFact_AbilityMovie_lycan_shapeshift"	"L'Eroe si trasforma in un lupo, ottenendo una maggiore velocità di movimento e una probabilità di infliggere dei colpi critici."
"[english]DOTA_BroadcastFact_AbilityMovie_lycan_shapeshift"	"Transforms into a wolf with increased movespeed and critical hit chance."
"DOTA_BroadcastFact_AbilityMovie_magnus_shockwave"	"Rilascia un'onda d'urto che danneggia le Unità in linea retta."
"[english]DOTA_BroadcastFact_AbilityMovie_magnus_shockwave"	"Hurls a wave of force that damages units in a line."
"DOTA_BroadcastFact_AbilityMovie_magnus_empower"	"Aumenta il danno d'attacco di un alleato e gli permette di eseguire attacchi a squarcio."
"[english]DOTA_BroadcastFact_AbilityMovie_magnus_empower"	"Grants an allied unit bonus damage and cleave."
"DOTA_BroadcastFact_AbilityMovie_magnus_skewer"	"L'Eroe scatta in avanti, trascinando con sé tutti i nemici colpiti."
"[english]DOTA_BroadcastFact_AbilityMovie_magnus_skewer"	"Charges forward, dragging impaled enemies with him."
"DOTA_BroadcastFact_AbilityMovie_magnus_reverse_polarity"	"<hc>Magnus</hc> attrae a sé tutte le Unità vicine e le stordisce."
"[english]DOTA_BroadcastFact_AbilityMovie_magnus_reverse_polarity"	"Sucks all nearby units to <hc>Magnus</hc>, stunning them."
"DOTA_BroadcastFact_AbilityMovie_medusa_split_shot"	"L'Eroe divide magicamente il suo colpo in molteplici frecce che colpiscono più nemici."
"[english]DOTA_BroadcastFact_AbilityMovie_medusa_split_shot"	"Magically splits arrows to hit multiple enemies."
"DOTA_BroadcastFact_AbilityMovie_medusa_mystic_snake"	"Danneggia più bersagli e ruba il loro mana."
"[english]DOTA_BroadcastFact_AbilityMovie_medusa_mystic_snake"	"Damages multiple targets and steals their mana."
"DOTA_BroadcastFact_AbilityMovie_medusa_mana_shield"	"Assorbe il 60% dei danni subiti in cambio di mana."
"[english]DOTA_BroadcastFact_AbilityMovie_medusa_mana_shield"	"Absorbs 60% of damage taken in exhange for mana."
"DOTA_BroadcastFact_AbilityMovie_medusa_stone_gaze"	"I nemici che guardano <hc>Medusa</hc> verranno rallentati e trasformati in pietra."
"[english]DOTA_BroadcastFact_AbilityMovie_medusa_stone_gaze"	"Enemies looking at <hc>Medusa</hc> will be slowed and turned to stone."
"DOTA_BroadcastFact_AbilityMovie_meepo_earthbind"	"Lancia una rete per intrappolare i nemici."
"[english]DOTA_BroadcastFact_AbilityMovie_meepo_earthbind"	"Tosses a net to pin down enemies."
"DOTA_BroadcastFact_AbilityMovie_meepo_poof"	"<hc>Meepo</hc> può teletrasportarsi verso un altro Meepo. Infligge danni ad area."
"[english]DOTA_BroadcastFact_AbilityMovie_meepo_poof"	"Teleports <hc>Meepos</hc> to each other. Deals area damage."
"DOTA_BroadcastFact_AbilityMovie_meepo_geostrike"	"Fa sì che gli attacchi infliggano danni al secondo e rallentino la velocità di movimento. È cumulabile."
"[english]DOTA_BroadcastFact_AbilityMovie_meepo_geostrike"	"Attacks deal DPS and slow movement. Stacks."
"DOTA_BroadcastFact_AbilityMovie_meepo_divided_we_stand"	"<hc>Meepo</hc> evoca un clone di se stesso in grado di ottenere oro ed esperienza."
"[english]DOTA_BroadcastFact_AbilityMovie_meepo_divided_we_stand"	"<hc>Meepo</hc> summons a duplicate of himself which can gain gold and XP."
"DOTA_BroadcastFact_AbilityMovie_mirana_starstorm"	"Evoca delle meteore che danneggiano le Unità vicine."
"[english]DOTA_BroadcastFact_AbilityMovie_mirana_starstorm"	"Calls down meteors that damage nearby units."
"DOTA_BroadcastFact_AbilityMovie_mirana_sacred_arrow"	"Spara una freccia a lungo raggio che stordisce e danneggia."
"[english]DOTA_BroadcastFact_AbilityMovie_mirana_sacred_arrow"	"Fires a long-rang arrow that stuns and damages."
"DOTA_BroadcastFact_AbilityMovie_mirana_leap"	"Un agile salto che aumenta la velocità di movimento e la velocità di attacco degli alleati."
"[english]DOTA_BroadcastFact_AbilityMovie_mirana_leap"	"An agile leap that grants allied move and attack speed."
"DOTA_BroadcastFact_AbilityMovie_mirana_moonlight_shadow"	"Permette a <hc>Mirana</hc> e a tutti gli Eroi alleati di diventare invisibili per un breve periodo."
"[english]DOTA_BroadcastFact_AbilityMovie_mirana_moonlight_shadow"	"Turns <hc>Mirana</hc> and all allied heroes invisible for a short time."
"DOTA_BroadcastFact_AbilityMovie_monkey_king_boundless_strike"	"Stordisce i nemici in linea retta e li danneggia con un colpo critico."
"[english]DOTA_BroadcastFact_AbilityMovie_monkey_king_boundless_strike"	"Stuns in a line with a critical hit."
"DOTA_BroadcastFact_AbilityMovie_monkey_king_tree_dance"	"Permette a <hc>Monkey King</hc> di saltare e aggrapparsi ad un albero."
"[english]DOTA_BroadcastFact_AbilityMovie_monkey_king_tree_dance"	"Allows <hc>Monkey King</hc> to jump and perch on a tree."
"DOTA_BroadcastFact_AbilityMovie_monkey_king_jingu_mastery"	"Colpire quattro volte lo stesso Eroe aumenta il danno d'attacco e permette di prosciugare la salute del nemico."
"[english]DOTA_BroadcastFact_AbilityMovie_monkey_king_jingu_mastery"	"Four hits to the same hero grants damage and lifesteal."
"DOTA_BroadcastFact_AbilityMovie_monkey_king_wukong's_command"	"Crea una formazione circolare di soldati che attaccano tutti gli Eroi nemici nell'area."
"[english]DOTA_BroadcastFact_AbilityMovie_monkey_king_wukong's_command"	"Creates a circle of soldiers that attack all enemy heroes in the area."
"DOTA_BroadcastFact_AbilityMovie_morphling_waveform"	"<hc>Morphling</hc> scorre in avanti danneggiando i nemici."
"[english]DOTA_BroadcastFact_AbilityMovie_morphling_waveform"	"<hc>Morphling</hc> surges forward, damaging enemies."
"DOTA_BroadcastFact_AbilityMovie_morphling_adaptive_strike"	"Un getto d'acqua che stordisce e danneggia un nemico."
"[english]DOTA_BroadcastFact_AbilityMovie_morphling_adaptive_strike"	"A surge of water that stuns and damages an enemy."
"DOTA_BroadcastFact_AbilityMovie_morphling_morph"	"L'Eroe cambia la sua forma, trasformando la sua Forza in Agilità."
"[english]DOTA_BroadcastFact_AbilityMovie_morphling_morph"	"Morphling morphs into a targetted enemy and gains their basic abilities."
"DOTA_BroadcastFact_AbilityMovie_morphling_replicate"	"Crea una replica di qualsiasi Eroe, amico o nemico. <hc>Morphling</hc> può prendere il posto della Replica in qualsiasi momento."
"[english]DOTA_BroadcastFact_AbilityMovie_morphling_replicate"	"Replicates any hero—friend or foe and deals damage. <hc>Morphling</hc> can teleport to replicant's location."
"DOTA_BroadcastFact_AbilityMovie_naga_siren_naga_siren"	"Crea delle immagini di <hc>Naga Siren</hc> da controllare."
"[english]DOTA_BroadcastFact_AbilityMovie_naga_siren_naga_siren"	"Creates multiple images of <hc>Naga Siren</hc> to control."
"DOTA_BroadcastFact_AbilityMovie_naga_siren_ensnare"	"Interrompe il bersaglio e lo blocca sul posto."
"[english]DOTA_BroadcastFact_AbilityMovie_naga_siren_ensnare"	"Interrupts target and traps them in place."
"DOTA_BroadcastFact_AbilityMovie_naga_siren_rip_tide"	"<hc>Naga Siren</hc> e tutte le sue immagini danneggiano le Unità vicine."
"[english]DOTA_BroadcastFact_AbilityMovie_naga_siren_rip_tide"	"<hc>Naga Siren</hc> and all her images damage nearby units."
"DOTA_BroadcastFact_AbilityMovie_naga_siren_song_of_the_siren"	"Tutti i nemici vicini vengono messi in una stasi magica in cui non possono né agire né venire attaccati."
"[english]DOTA_BroadcastFact_AbilityMovie_naga_siren_song_of_the_siren"	"Places all nearby enemies into a temporary invulnerable stasis."
"DOTA_BroadcastFact_AbilityMovie_nature's_prophet_sprout"	"<ac>Evoca</ac> un anello di alberi per intrappolare un nemico."
"[english]DOTA_BroadcastFact_AbilityMovie_nature's_prophet_sprout"	"<ac>Sprouts</ac> a ring of trees to trap an enemy."
"DOTA_BroadcastFact_AbilityMovie_nature's_prophet_teleportation"	"Teletrasporta l'Eroe in un qualsiasi punto della mappa."
"[english]DOTA_BroadcastFact_AbilityMovie_nature's_prophet_teleportation"	"Teleports to any point on the map."
"DOTA_BroadcastFact_AbilityMovie_nature's_prophet_nature's_call"	"Trasforma gli alberi in <ac>Alberi animati</ac> che possono essere controllati."
"[english]DOTA_BroadcastFact_AbilityMovie_nature's_prophet_nature's_call"	"Converts trees into controllable <ac>Treants</ac>."
"DOTA_BroadcastFact_AbilityMovie_nature's_prophet_wrath_of_nature"	"Danneggia tutti i nemici visibili sulla mappa."
"[english]DOTA_BroadcastFact_AbilityMovie_nature's_prophet_wrath_of_nature"	"Damages all enemies visible on the map."
"DOTA_BroadcastFact_AbilityMovie_necrophos_death_pulse"	"Danneggia i nemici vicini e cura gli alleati."
"[english]DOTA_BroadcastFact_AbilityMovie_necrophos_death_pulse"	"Damages nearby enemies and heals allies."
"DOTA_BroadcastFact_AbilityMovie_necrophos_ghost_shroud"	"Fa sì che <hc>Necrophos</hc> non possa attaccare o essere attaccato."
"[english]DOTA_BroadcastFact_AbilityMovie_necrophos_ghost_shroud"	"<hc>Necrophos</hc> becomes unable to attack or be attacked."
"DOTA_BroadcastFact_AbilityMovie_necrophos_heartstopper_aura"	"Fa sì che i nemici vicini perdano punti salute con il passare del tempo."
"[english]DOTA_BroadcastFact_AbilityMovie_necrophos_heartstopper_aura"	"Causes nearby enemies to lose health over time."
"DOTA_BroadcastFact_AbilityMovie_necrophos_reaper's_scythe"	"Stordisce e danneggia, aumentando il tempo di rinascita dei bersagli che muoiono."
"[english]DOTA_BroadcastFact_AbilityMovie_necrophos_reaper's_scythe"	"Stuns and deals damage, adding respawn time if the target dies."
"DOTA_BroadcastFact_AbilityMovie_night_stalker_void"	"Rallenta e danneggia un'Unità nemica, infliggendo un mini-stordimento."
"[english]DOTA_BroadcastFact_AbilityMovie_night_stalker_void"	"Slows and damages an enemy unit, mini-stunning."
"DOTA_BroadcastFact_AbilityMovie_night_stalker_crippling_fear"	"Silenzia il bersaglio e gli fa mancare gli attacchi."
"[english]DOTA_BroadcastFact_AbilityMovie_night_stalker_crippling_fear"	"Causes target to miss attacks and become silenced."
"DOTA_BroadcastFact_AbilityMovie_night_stalker_hunter_in_the_night"	"Aumenta la velocità di movimento e la velocità di attacco durante la notte."
"[english]DOTA_BroadcastFact_AbilityMovie_night_stalker_hunter_in_the_night"	"Grants bonus move and attack speed at night."
"DOTA_BroadcastFact_AbilityMovie_night_stalker_darkness"	"Blocca il sole provocando un'oscurità che riduce la visione dei nemici."
"[english]DOTA_BroadcastFact_AbilityMovie_night_stalker_darkness"	"Blocks the sun to cause instant darkness, reducing enemy vision."
"DOTA_BroadcastFact_AbilityMovie_nyx_assassin_impale"	"Stordisce i nemici in linea retta."
"[english]DOTA_BroadcastFact_AbilityMovie_nyx_assassin_impale"	"Stuns enemies in a line."
"DOTA_BroadcastFact_AbilityMovie_nyx_assassin_mana_burn"	"Distrugge il mana di un nemico e lo danneggia."
"[english]DOTA_BroadcastFact_AbilityMovie_nyx_assassin_mana_burn"	"Destroys enemy mana pool while dealing damage."
"DOTA_BroadcastFact_AbilityMovie_nyx_assassin_spiked_carapace"	"Crea uno scudo protettivo che stordisce gli aggressori."
"[english]DOTA_BroadcastFact_AbilityMovie_nyx_assassin_spiked_carapace"	"Creates a protective shell that stuns attackers."
"DOTA_BroadcastFact_AbilityMovie_nyx_assassin_vendetta"	"Rende invisibili e aumenta la velocità di movimento e il danno d'attacco."
"[english]DOTA_BroadcastFact_AbilityMovie_nyx_assassin_vendetta"	"Grants invisibility, move speed, and damage bonus on attack."
"DOTA_BroadcastFact_AbilityMovie_ogre_magi_fireblast"	"Danneggia e stordisce un nemico."
"[english]DOTA_BroadcastFact_AbilityMovie_ogre_magi_fireblast"	"Blasts an enemy, dealing damage and stunning."
"DOTA_BroadcastFact_AbilityMovie_ogre_magi_ignite"	"Fa prendere fuoco ad un nemico, rallentandolo e danneggiandolo con il passare del tempo."
"[english]DOTA_BroadcastFact_AbilityMovie_ogre_magi_ignite"	"Flings fire that slows and damages over time."
"DOTA_BroadcastFact_AbilityMovie_ogre_magi_bloodlust"	"Incita alla frenesia, aumentando la velocità di movimento e la velocità di attacco di un alleato."
"[english]DOTA_BroadcastFact_AbilityMovie_ogre_magi_bloodlust"	"Incites a frenzy, increasing movespeed and attack speed of his allied target."
"DOTA_BroadcastFact_AbilityMovie_ogre_magi_multicast"	"Potenzia gli incantesimi e permette all'Eroe di lanciarli più volte, rendendoli allo stesso tempo più potenti."
"[english]DOTA_BroadcastFact_AbilityMovie_ogre_magi_multicast"	"Empowers spells and gives a chance for spells to cast multiple times."
"DOTA_BroadcastFact_AbilityMovie_omniknight_purification"	"Cura un'Unità alleata e danneggia i nemici vicini."
"[english]DOTA_BroadcastFact_AbilityMovie_omniknight_purification"	"Heals a friendly unit. Damages nearby enemies."
"DOTA_BroadcastFact_AbilityMovie_omniknight_repel"	"Rende un alleato immune agli incantesimi per un breve periodo."
"[english]DOTA_BroadcastFact_AbilityMovie_omniknight_repel"	"Temporarily grants an ally spell immunity."
"DOTA_BroadcastFact_AbilityMovie_omniknight_degen_aura"	"Rallenta la velocità di movimento e di attacco dei nemici vicini."
"[english]DOTA_BroadcastFact_AbilityMovie_omniknight_degen_aura"	"Slows movement and attack speeds of nearby enemies."
"DOTA_BroadcastFact_AbilityMovie_omniknight_guardian_angel"	"Rende <hc>Omniknight</hc> e gli alleati vicini immuni agli attacchi fisici."
"[english]DOTA_BroadcastFact_AbilityMovie_omniknight_guardian_angel"	"Makes <hc>Omniknight</hc> and nearby allies immune to physical attacks."
"DOTA_BroadcastFact_AbilityMovie_oracle_fortune's_end"	"Un fulmine che danneggia, intrappola e purga i nemici."
"[english]DOTA_BroadcastFact_AbilityMovie_oracle_fortune's_end"	"A bolt that damages, roots, and purges enemies."
"DOTA_BroadcastFact_AbilityMovie_oracle_fate's_edict"	"Disarma il bersaglio e gli conferisce il 100% di resistenza ai danni magici."
"[english]DOTA_BroadcastFact_AbilityMovie_oracle_fate's_edict"	"Disarms target, granting 100% magic resistance."
"DOTA_BroadcastFact_AbilityMovie_oracle_purifying_flames"	"Prima danneggia il bersaglio, per poi rigenerare la sua salute con il passare del tempo."
"[english]DOTA_BroadcastFact_AbilityMovie_oracle_purifying_flames"	"Deals damage to target but causes health regen over time."
"DOTA_BroadcastFact_AbilityMovie_oracle_false_promise"	"Ritarda qualsiasi guarigione o danno che un bersaglio subisce. Le guarigioni ritardate saranno doppiamente efficaci."
"[english]DOTA_BroadcastFact_AbilityMovie_oracle_false_promise"	"Temporarily delays all healing and damage a target takes. Any healing applied is doubled to the target."
"DOTA_BroadcastFact_AbilityMovie_outworld_devourer_arcane_orb"	"Aggiunge danni puri agli attacchi. Sottrae punti di Intelligenza ad ogni colpo inflitto."
"[english]DOTA_BroadcastFact_AbilityMovie_outworld_devourer_arcane_orb"	"Adds pure damage to attacks. Steals intelligence with each hit."
"DOTA_BroadcastFact_AbilityMovie_outworld_devourer_astral_imprisonment"	"Rinchiude il bersaglio in una prigione astrale, facendolo sparire da questo mondo. Infligge dei danni ad area quando la prigione esplode."
"[english]DOTA_BroadcastFact_AbilityMovie_outworld_devourer_astral_imprisonment"	"Places target in astral prison, vanishing them from existence. Deals area damage upon returning."
"DOTA_BroadcastFact_AbilityMovie_outworld_devourer_essence_aura"	"Dona agli alleati una probabilità di rigenerare il loro mana quando usano un'abilità."
"[english]DOTA_BroadcastFact_AbilityMovie_outworld_devourer_essence_aura"	"Grants chance to restore mana when allies cast a spell."
"DOTA_BroadcastFact_AbilityMovie_outworld_devourer_sanity's_eclipse"	"Danneggia i nemici in un'area in base alla differenza tra la loro Intelligenza e quella dell'Eroe."
"[english]DOTA_BroadcastFact_AbilityMovie_outworld_devourer_sanity's_eclipse"	"Damages enemies in an area based on difference in intelligence."
"DOTA_BroadcastFact_AbilityMovie_phantom_assassin_stifling_dagger"	"Lancia un pugnale che danneggia e rallenta il bersaglio."
"[english]DOTA_BroadcastFact_AbilityMovie_phantom_assassin_stifling_dagger"	"Throws a dagger, damaging and slowing target."
"DOTA_BroadcastFact_AbilityMovie_phantom_assassin_phantom_strike"	"L'Eroe si teletrasporta vicino ad un'Unità e ottiene una velocità di attacco maggiore."
"[english]DOTA_BroadcastFact_AbilityMovie_phantom_assassin_phantom_strike"	"Blinks to a unit and increases PA's attack speed."
"DOTA_BroadcastFact_AbilityMovie_phantom_assassin_blur"	"Aumenta la probabilità di schivare gli attacchi nemici e rende invisibili sulla minimappa."
"[english]DOTA_BroadcastFact_AbilityMovie_phantom_assassin_blur"	"Increases evasion to enemy attacks. Invisible on minimap."
"DOTA_BroadcastFact_AbilityMovie_phantom_assassin_coup_de_grace"	"L'Eroe ottiene la probabilità di assestare un devastante colpo critico."
"[english]DOTA_BroadcastFact_AbilityMovie_phantom_assassin_coup_de_grace"	"Grants a chance to deliver a devastating critical strike."
"DOTA_BroadcastFact_AbilityMovie_phantom_lancer_spirit_lance"	"Danneggia e rallenta un bersaglio. Evoca un'Illusione."
"[english]DOTA_BroadcastFact_AbilityMovie_phantom_lancer_spirit_lance"	"Damages and slows a target. Summons an illusion."
"DOTA_BroadcastFact_AbilityMovie_phantom_lancer_doppelganger"	"Svanisce, si teletrasporta e crea delle Illusioni nel punto selezionato."
"[english]DOTA_BroadcastFact_AbilityMovie_phantom_lancer_doppelganger"	"Vanish, blink, and create illusions at target location."
"DOTA_BroadcastFact_AbilityMovie_phantom_lancer_phantom_rush"	"<hc>Phantom Lancer</hc> e le sue Illusioni si lanciano contro un nemico."
"[english]DOTA_BroadcastFact_AbilityMovie_phantom_lancer_phantom_rush"	"<hc>Phantom Lancer</hc> and illusions charge at an enemy."
"DOTA_BroadcastFact_AbilityMovie_phantom_lancer_juxtapose"	"L'Eroe ottiene la probabilità di creare un'Illusione quando sferra un attacco. Le Illusioni possono creare altre Illusioni."
"[english]DOTA_BroadcastFact_AbilityMovie_phantom_lancer_juxtapose"	"Grants a chance to create illusion on attack. Illusions can create illusions."
"DOTA_BroadcastFact_AbilityMovie_phoenix_icarus_dive"	"Vola ad arco, danneggiando e rallentando i nemici."
"[english]DOTA_BroadcastFact_AbilityMovie_phoenix_icarus_dive"	"Dives in an arc, damaging and slowing enemies."
"DOTA_BroadcastFact_AbilityMovie_phoenix_fire_spirits"	"Lancia degli spiriti che danneggiano e diminuiscono la velocità di attacco."
"[english]DOTA_BroadcastFact_AbilityMovie_phoenix_fire_spirits"	"Fires damaging spirits that debuff attack speed."
"DOTA_BroadcastFact_AbilityMovie_phoenix_sun_ray"	"Spara un raggio che danneggia i nemici e cura gli alleati."
"[english]DOTA_BroadcastFact_AbilityMovie_phoenix_sun_ray"	"Fires a beam that hurts enemies and heals allies."
"DOTA_BroadcastFact_AbilityMovie_phoenix_supernova"	"Diventa un sole incandescente che brucia e stordisce i nemici quando l'Eroe risorge."
"[english]DOTA_BroadcastFact_AbilityMovie_phoenix_supernova"	"Collapses into a fiery egg, burning and stunning enemies once he is reborn."
"DOTA_BroadcastFact_AbilityMovie_puck_illusory_orb"	"Lancia una sfera che danneggia e a cui <hc>Puck</hc> può teletrasportarsi."
"[english]DOTA_BroadcastFact_AbilityMovie_puck_illusory_orb"	"Launches a damaging orb that <hc>Puck</hc> can teleport to."
"DOTA_BroadcastFact_AbilityMovie_puck_waning_rift"	"Un'esplosione di polvere fatata che danneggia e silenzia."
"[english]DOTA_BroadcastFact_AbilityMovie_puck_waning_rift"	"A burst of faerie dust deals damage and silences."
"DOTA_BroadcastFact_AbilityMovie_puck_phase_shift"	"<hc>Puck</hc> si sposta in un'altra dimensione per breve tempo, evitando ogni danno."
"[english]DOTA_BroadcastFact_AbilityMovie_puck_phase_shift"	"<hc>Puck</hc> briefly shifts to another dimension, avoiding harm."
"DOTA_BroadcastFact_AbilityMovie_puck_dream_coil"	"Una spirale che si lega ai nemici. Se si muovono troppo lontano, il legame si spezza e li stordisce."
"[english]DOTA_BroadcastFact_AbilityMovie_puck_dream_coil"	"Latches onto enemies. If they move away, the coil breaks and stuns."
"DOTA_BroadcastFact_AbilityMovie_pudge_meat_hook"	"Lancia un gancio che avvicina il nemico che colpisce."
"[english]DOTA_BroadcastFact_AbilityMovie_pudge_meat_hook"	"Throws a hook that reels in the enemy it hits."
"DOTA_BroadcastFact_AbilityMovie_pudge_rot"	"Una nube tossica che danneggia e rallenta i nemici e <hc>Pudge</hc> stesso."
"[english]DOTA_BroadcastFact_AbilityMovie_pudge_rot"	"A toxic cloud that damages and slows enemies and <hc>Pudge</hc>."
"DOTA_BroadcastFact_AbilityMovie_pudge_flesh_heap"	"L'Eroe riceve Forza aggiuntiva ogni volta che un nemico muore nelle vicinanze."
"[english]DOTA_BroadcastFact_AbilityMovie_pudge_flesh_heap"	"Grants permanent strength when an enemy dies nearby."
"DOTA_BroadcastFact_AbilityMovie_pudge_dismember"	"Afferra un nemico, disabilitandolo ed infliggendo danno."
"[english]DOTA_BroadcastFact_AbilityMovie_pudge_dismember"	"Grabs an enemy, disabling and dealing damage."
"DOTA_BroadcastFact_AbilityMovie_pugna_nether_blast"	"Danneggia i nemici e le strutture in una certa area."
"[english]DOTA_BroadcastFact_AbilityMovie_pugna_nether_blast"	"Damages enemies and structures in an area."
"DOTA_BroadcastFact_AbilityMovie_pugna_decrepify"	"Rallenta un'Unità impedendole di attaccare o di essere attaccata."
"[english]DOTA_BroadcastFact_AbilityMovie_pugna_decrepify"	"Slows unit. Makes it unable to attack or be attacked."
"DOTA_BroadcastFact_AbilityMovie_pugna_nether_ward"	"Un guardiano che danneggia i nemici vicini che lanciano un incantesimo."
"[english]DOTA_BroadcastFact_AbilityMovie_pugna_nether_ward"	"A ward that damages nearby enemies that cast a spell."
"DOTA_BroadcastFact_AbilityMovie_pugna_life_drain"	"Prosciuga la salute di un nemico, curando <hc>Pugna</hc>."
"[english]DOTA_BroadcastFact_AbilityMovie_pugna_life_drain"	"Drains health from an enemy, healing <hc>Pugna</hc>."
"DOTA_BroadcastFact_AbilityMovie_queen_of_pain_shadow_strike"	"Un pugnale che rallenta e danneggia con il passare del tempo."
"[english]DOTA_BroadcastFact_AbilityMovie_queen_of_pain_shadow_strike"	"A dagger that slows and damages over time."
"DOTA_BroadcastFact_AbilityMovie_queen_of_pain_blink"	"Permette di teletrasportarsi in un punto vicino."
"[english]DOTA_BroadcastFact_AbilityMovie_queen_of_pain_blink"	"Teleports to a nearby spot."
"DOTA_BroadcastFact_AbilityMovie_queen_of_pain_scream_of_pain"	"Lancia un urlo travolgente intorno a sé che danneggia i nemici vicini."
"[english]DOTA_BroadcastFact_AbilityMovie_queen_of_pain_scream_of_pain"	"Unleashes damage in a small burst around her."
"DOTA_BroadcastFact_AbilityMovie_queen_of_pain_sonic_wave"	"Crea una gigantesca onda sonora che danneggia tutti i nemici sul suo cammino."
"[english]DOTA_BroadcastFact_AbilityMovie_queen_of_pain_sonic_wave"	"Emits a cone of massive sonic damage."
"DOTA_BroadcastFact_AbilityMovie_razor_plasma_field"	"Un'onda di plasma che si espande e danneggia i nemici."
"[english]DOTA_BroadcastFact_AbilityMovie_razor_plasma_field"	"An expanding wave of plasma that damages foes."
"DOTA_BroadcastFact_AbilityMovie_razor_static_link"	"Prosciuga il danno d'attacco di un Eroe nemico per un breve periodo."
"[english]DOTA_BroadcastFact_AbilityMovie_razor_static_link"	"Steals damage from an enemy hero for a short time."
"DOTA_BroadcastFact_AbilityMovie_razor_unstable_current"	"Aumenta la velocità di movimento e contrattacca gli attacchi nemici."
"[english]DOTA_BroadcastFact_AbilityMovie_razor_unstable_current"	"Increases move speed and counters enemy attacks."
"DOTA_BroadcastFact_AbilityMovie_razor_eye_of_the_storm"	"Una tempesta di fulmini che danneggia e riduce l'armatura."
"[english]DOTA_BroadcastFact_AbilityMovie_razor_eye_of_the_storm"	"A lightning storm that deals damage and reduces armor."
"DOTA_BroadcastFact_AbilityMovie_riki_smoke_screen"	"Crea una nube di fumo che silenzia e rallenta."
"[english]DOTA_BroadcastFact_AbilityMovie_riki_smoke_screen"	"Creates a smoke cloud that silences and slows."
"DOTA_BroadcastFact_AbilityMovie_riki_blink_strike"	"L'Eroe si teletrasporta dietro un bersaglio per infliggere danni maggiori."
"[english]DOTA_BroadcastFact_AbilityMovie_riki_blink_strike"	"Teleports behind a target for bonus damage."
"DOTA_BroadcastFact_AbilityMovie_riki_cloak_and_dagger"	"Rende invisibili finché non si attacca. Infligge danni aggiuntivi quando l'Eroe attacca alle spalle."
"[english]DOTA_BroadcastFact_AbilityMovie_riki_cloak_and_dagger"	"Grants invisibility that breaks when attacking. Deals bonus damage when attacking from behind."
"DOTA_BroadcastFact_AbilityMovie_riki_tricks_of_the_trade"	"L'Eroe svanisce dal mondo per poi colpire alle spalle tutti i nemici in una certa area."
"[english]DOTA_BroadcastFact_AbilityMovie_riki_tricks_of_the_trade"	"Phases into a large damaging AOE that deals bonus backstab damage."
"DOTA_BroadcastFact_AbilityMovie_rubick_telekinesis"	"Stordisce un nemico sollevandolo e facendolo cadere."
"[english]DOTA_BroadcastFact_AbilityMovie_rubick_telekinesis"	"Lifts and drops an enemy, stunning it."
"DOTA_BroadcastFact_AbilityMovie_rubick_fade_bolt"	"Un incantesimo che danneggia e riduce il danno d'attacco."
"[english]DOTA_BroadcastFact_AbilityMovie_rubick_fade_bolt"	"A spell that damages and reduces attack damage."
"DOTA_BroadcastFact_AbilityMovie_rubick_null_field"	"Protegge gli alleati vicini aumentandone la resistenza ai danni magici."
"[english]DOTA_BroadcastFact_AbilityMovie_rubick_null_field"	"Protects nearby allies, granting magic resistance."
"DOTA_BroadcastFact_AbilityMovie_rubick_spell_steal"	"Ruba l'ultima abilità utilizzata da un Eroe nemico."
"[english]DOTA_BroadcastFact_AbilityMovie_rubick_spell_steal"	"Steals the last spell an enemy hero casted."
"DOTA_BroadcastFact_AbilityMovie_sand_king_burrow_strike"	"<hc>Sand King</hc> scava in avanti, stordendo tutti i nemici che incontra."
"[english]DOTA_BroadcastFact_AbilityMovie_sand_king_burrow_strike"	"<hc>Sand King</hc> tunnels forward, stunning units."
"DOTA_BroadcastFact_AbilityMovie_sand_king_sand_storm"	"Danneggia le Unità vicine. Rende invisibili."
"[english]DOTA_BroadcastFact_AbilityMovie_sand_king_sand_storm"	"Damages nearby units. Grants invisibility."
"DOTA_BroadcastFact_AbilityMovie_sand_king_caustic_finale"	"Gli attacchi fanno esplodere le Unità, rallentando e infliggendo danni."
"[english]DOTA_BroadcastFact_AbilityMovie_sand_king_caustic_finale"	"Attacks cause units to explode, slowing and damaging."
"DOTA_BroadcastFact_AbilityMovie_sand_king_epicenter"	"Un terremoto che rallenta e danneggia i nemici vicini."
"[english]DOTA_BroadcastFact_AbilityMovie_sand_king_epicenter"	"An earthquake that slows and damages nearby enemies."
"DOTA_BroadcastFact_AbilityMovie_shadow_demon_disruption"	"Esilia il bersaglio per breve tempo, creandone delle Illusioni."
"[english]DOTA_BroadcastFact_AbilityMovie_shadow_demon_disruption"	"Briefly banishes the target, creating illusions."
"DOTA_BroadcastFact_AbilityMovie_shadow_demon_soul_catcher"	"Maledice i nemici all'interno di una certa area, facendo sì che subiscano danni maggiori."
"[english]DOTA_BroadcastFact_AbilityMovie_shadow_demon_soul_catcher"	"Curses one enemy in an area to take more damage."
"DOTA_BroadcastFact_AbilityMovie_shadow_demon_shadow_poison"	"Infligge danni cumulativi alle Unità in linea retta."
"[english]DOTA_BroadcastFact_AbilityMovie_shadow_demon_shadow_poison"	"Deals stacking damage to units in a line."
"DOTA_BroadcastFact_AbilityMovie_shadow_demon_demonic_purge"	"Danneggia, rallenta e rimuove gli effetti positivi da un bersaglio."
"[english]DOTA_BroadcastFact_AbilityMovie_shadow_demon_demonic_purge"	"Damages, slows, and removes buffs from a target."
"DOTA_BroadcastFact_AbilityMovie_shadow_fiend_shadowraze"	"Danneggia tutti i nemici in una certa area davanti all'Eroe."
"[english]DOTA_BroadcastFact_AbilityMovie_shadow_fiend_shadowraze"	"Blasts the area ahead, damaging enemies."
"DOTA_BroadcastFact_AbilityMovie_shadow_fiend_necromastery"	"Ruba le anime dei morti, aumentando il danno d'attacco."
"[english]DOTA_BroadcastFact_AbilityMovie_shadow_fiend_necromastery"	"Steals souls of the dead, increasing attack damage."
"DOTA_BroadcastFact_AbilityMovie_shadow_fiend_presence_of_the__dark_lord"	"Un'aura che riduce l'armatura dei nemici vicini."
"[english]DOTA_BroadcastFact_AbilityMovie_shadow_fiend_presence_of_the__dark_lord"	"An aura that reduces the armor of nearby enemies."
"DOTA_BroadcastFact_AbilityMovie_shadow_fiend_requiem_of_souls"	"Libera le anime imprigionate, danneggiando tutti i nemici vicini."
"[english]DOTA_BroadcastFact_AbilityMovie_shadow_fiend_requiem_of_souls"	"Releases captured souls, damaging all nearby enemies."
"DOTA_BroadcastFact_AbilityMovie_shadow_shaman_ether_shock"	"Un cono di energia eterea che colpisce molteplici Unità nemiche."
"[english]DOTA_BroadcastFact_AbilityMovie_shadow_shaman_ether_shock"	"Damaging energy that chains to other enemies."
"DOTA_BroadcastFact_AbilityMovie_shadow_shaman_hex"	"Trasforma il bersaglio in una creatura indifesa."
"[english]DOTA_BroadcastFact_AbilityMovie_shadow_shaman_hex"	"Transforms an enemy into a harmless beast."
"DOTA_BroadcastFact_AbilityMovie_shadow_shaman_shackles"	"Blocca un nemico sul posto, danneggiandolo con il passare del tempo."
"[english]DOTA_BroadcastFact_AbilityMovie_shadow_shaman_shackles"	"Holds an enemy in place, damaging over time."
"DOTA_BroadcastFact_AbilityMovie_shadow_shaman_mass_serpent_ward"	"Evoca dei serpenti di fuoco che attaccano le strutture e le Unità nemiche."
"[english]DOTA_BroadcastFact_AbilityMovie_shadow_shaman_mass_serpent_ward"	"Summons fire serpents to attack enemy units and structures."
"DOTA_BroadcastFact_AbilityMovie_silencer_arcane_curse"	"Maledice gli avversari. La durata aumenta se lanciano un incantesimo."
"[english]DOTA_BroadcastFact_AbilityMovie_silencer_arcane_curse"	"Curses foes. Duration increases if they cast a spell."
"DOTA_BroadcastFact_AbilityMovie_silencer_glaives_of_wisdom"	"Gli attacchi infliggono danni aggiuntivi in base all'Intelligenza."
"[english]DOTA_BroadcastFact_AbilityMovie_silencer_glaives_of_wisdom"	"Attacks deal bonus damage based on Intelligence."
"DOTA_BroadcastFact_AbilityMovie_silencer_last_word"	"Il bersaglio viene danneggiato e silenziato se utilizza un'abilità."
"[english]DOTA_BroadcastFact_AbilityMovie_silencer_last_word"	"Damages and silences the target if they cast a spell."
"DOTA_BroadcastFact_AbilityMovie_silencer_global_silence"	"Impedisce a tutti i nemici di lanciare degli incantesimi per qualche secondo."
"[english]DOTA_BroadcastFact_AbilityMovie_silencer_global_silence"	"Prevents all enemies from casting spells for a few seconds."
"DOTA_BroadcastFact_AbilityMovie_skywrath_mage_arcane_bolt"	"Un dardo che danneggia in base all'Intelligenza dell'Eroe."
"[english]DOTA_BroadcastFact_AbilityMovie_skywrath_mage_arcane_bolt"	"A bolt that deals damage based on his Intelligence."
"DOTA_BroadcastFact_AbilityMovie_skywrath_mage_concussive_shot"	"Un colpo a lunga distanza che danneggia e rallenta i nemici."
"[english]DOTA_BroadcastFact_AbilityMovie_skywrath_mage_concussive_shot"	"Long-range shot that damages and slows enemies."
"DOTA_BroadcastFact_AbilityMovie_skywrath_mage_ancient_seal"	"<ac>Silenzia</ac> un nemico, aumentando i danni magici che subisce."
"[english]DOTA_BroadcastFact_AbilityMovie_skywrath_mage_ancient_seal"	"<ac>Silence</ac>s an enemy, increasing magical damage it takes."
"DOTA_BroadcastFact_AbilityMovie_skywrath_mage_mystic_flare"	"Un'esplosione violenta che danneggia tutte le Unità nella sua area d'effetto."
"[english]DOTA_BroadcastFact_AbilityMovie_skywrath_mage_mystic_flare"	"A violent blast that damages all units in its area."
"DOTA_BroadcastFact_AbilityMovie_slardar_guardian_spirit"	"Aumenta la velocità di movimento facendo subire più danni all'Eroe."
"[english]DOTA_BroadcastFact_AbilityMovie_slardar_guardian_spirit"	"Increases movespeed in exchange for more damage taken."
"DOTA_BroadcastFact_AbilityMovie_slardar_slithereen_crush"	"Colpisce il terreno stordendo i nemici vicini."
"[english]DOTA_BroadcastFact_AbilityMovie_slardar_slithereen_crush"	"Slams the ground, stunning nearby enemies."
"DOTA_BroadcastFact_AbilityMovie_slardar_bash_of_the_deep"	"Gli attacchi hanno una probabilità di stordire i nemici e di infliggere danni maggiori."
"[english]DOTA_BroadcastFact_AbilityMovie_slardar_bash_of_the_deep"	"Attacks have a chance to do extra damage and stun."
"DOTA_BroadcastFact_AbilityMovie_slardar_corrosive_haze"	"Riduce l'armatura del bersaglio e applica un effetto di Vera Visione che rivela le Unità invisibili."
"[english]DOTA_BroadcastFact_AbilityMovie_slardar_corrosive_haze"	"Reduces enemy armor and provides True Sight, revealing invisible units."
"DOTA_BroadcastFact_AbilityMovie_slark_dark_pact"	"Rimuove la maggior parte degli effetti negativi e danneggia i nemici."
"[english]DOTA_BroadcastFact_AbilityMovie_slark_dark_pact"	"Removes most debuffs and damages enemies."
"DOTA_BroadcastFact_AbilityMovie_slark_pounce"	"<ac>Balza</ac> in avanti, incatenando un Eroe al terreno."
"[english]DOTA_BroadcastFact_AbilityMovie_slark_pounce"	"<ac>Leap</ac>s forward, leashing a hero to the ground."
"DOTA_BroadcastFact_AbilityMovie_slark_essence_shift"	"Prosciuga gli attributi e aumenta l'Agilità ad ogni attacco."
"[english]DOTA_BroadcastFact_AbilityMovie_slark_essence_shift"	"Drains attributes and boosts agility with each hit."
"DOTA_BroadcastFact_AbilityMovie_slark_shadow_dance"	"Rende invisibili per breve tempo. Aumenta la rigenerazione della salute e la velocità di movimento quando l'Eroe è invisibile."
"[english]DOTA_BroadcastFact_AbilityMovie_slark_shadow_dance"	"Temporary invisibility. Boosts health regen and move speed while unseen."
"DOTA_BroadcastFact_AbilityMovie_sniper_shrapnel"	"Colpisce l'area selezionata con dei pallettoni esplosivi che danneggiano e rallentano i nemici."
"[english]DOTA_BroadcastFact_AbilityMovie_sniper_shrapnel"	"Showers area with shrapnel. Damages and slows."
"DOTA_BroadcastFact_AbilityMovie_sniper_headshot"	"Gli attacchi possono rallentare i nemici e infliggere danni aggiuntivi."
"[english]DOTA_BroadcastFact_AbilityMovie_sniper_headshot"	"Attacks can deal bonus damage and slow enemies."
"DOTA_BroadcastFact_AbilityMovie_sniper_take_aim"	"Aumenta la gittata degli attacchi di <hc>Sniper</hc>."
"[english]DOTA_BroadcastFact_AbilityMovie_sniper_take_aim"	"Extends the range of <hc>Sniper</hc>'s attacks."
"DOTA_BroadcastFact_AbilityMovie_sniper_assassinate"	"Spara un colpo devastante che danneggia a lunga distanza."
"[english]DOTA_BroadcastFact_AbilityMovie_sniper_assassinate"	"Fires a devastating shot that deals damage at long range."
"DOTA_BroadcastFact_AbilityMovie_spectre_spectral_dagger"	"Traccia un percorso oscuro che danneggia e rallenta i nemici, permettendo a <hc>Spectre</hc> di attraversare anche i terreni inaccessibili."
"[english]DOTA_BroadcastFact_AbilityMovie_spectre_spectral_dagger"	"Draws a dark path that hurts and slows enemies. Grants free movement for <hc>Spectre</hc>."
"DOTA_BroadcastFact_AbilityMovie_spectre_desolate"	"Gli attacchi infliggono danni aggiuntivi ai nemici isolati."
"[english]DOTA_BroadcastFact_AbilityMovie_spectre_desolate"	"Attacks deal bonus damage to isolated enemies."
"DOTA_BroadcastFact_AbilityMovie_spectre_dispersion"	"Riflette i danni subiti contro gli aggressori."
"[english]DOTA_BroadcastFact_AbilityMovie_spectre_dispersion"	"Reflects damage back upon enemy attackers."
"DOTA_BroadcastFact_AbilityMovie_spectre_haunt"	"Crea delle Illusioni che attaccano tutti gli Eroi nemici. <hc>Spectre</hc> può teletrasportarsi verso la posizione di qualsiasi Illusione."
"[english]DOTA_BroadcastFact_AbilityMovie_spectre_haunt"	"Creates illusions to attack all enemy heroes. <hc>Spectre</hc> can teleport to any illusion location."
"DOTA_BroadcastFact_AbilityMovie_spirit_breaker_charge_of_darkness"	"L'Eroe si lancia contro un bersaglio da qualsiasi punto della mappa."
"[english]DOTA_BroadcastFact_AbilityMovie_spirit_breaker_charge_of_darkness"	"Charges at a target from anywhere on the map."
"DOTA_BroadcastFact_AbilityMovie_spirit_breaker_empowering_haste"	"Aumenta la velocità di movimento degli alleati vicini."
"[english]DOTA_BroadcastFact_AbilityMovie_spirit_breaker_empowering_haste"	"Increases movement speed of nearby allies."
"DOTA_BroadcastFact_AbilityMovie_spirit_breaker_greater_bash"	"Gli attacchi hanno il 17% di probabilità di stordire e di respingere i nemici."
"[english]DOTA_BroadcastFact_AbilityMovie_spirit_breaker_greater_bash"	"Attacks have a 17% chance to stun and knockback enemies."
"DOTA_BroadcastFact_AbilityMovie_spirit_breaker_nether_strike"	"L'Eroe si teletrasporta vicino ad un'Unità nemica, infliggendole un Colpo violento e dei danni aggiuntivi."
"[english]DOTA_BroadcastFact_AbilityMovie_spirit_breaker_nether_strike"	"Teleports to a nearby enemy, bashing them and dealing damage."
"DOTA_BroadcastFact_AbilityMovie_storm_spirit_static_remnant"	"Genera un'immagine che esplode quando i nemici si avvicinano."
"[english]DOTA_BroadcastFact_AbilityMovie_storm_spirit_static_remnant"	"Places an image that explodes when enemies approach."
"DOTA_BroadcastFact_AbilityMovie_storm_spirit_electric_vortex"	"Attira un'Unità nemica verso <hc>Storm Spirit</hc>, rallentandola."
"[english]DOTA_BroadcastFact_AbilityMovie_storm_spirit_electric_vortex"	"Pulls an enemy unit to <hc>Storm Spirit</hc>, slowing them."
"DOTA_BroadcastFact_AbilityMovie_storm_spirit_overload"	"Usare un'abilità fa sì che l'attacco successivo infligga danni aggiuntivi e rallenti il nemico."
"[english]DOTA_BroadcastFact_AbilityMovie_storm_spirit_overload"	"Casting spells grants bonus damage and slow to attacks."
"DOTA_BroadcastFact_AbilityMovie_storm_spirit_ball_lightning"	"Permette a <hc>Storm Spirit</hc> di saettare attraverso la mappa in cambio di mana."
"[english]DOTA_BroadcastFact_AbilityMovie_storm_spirit_ball_lightning"	"Allows <hc>Storm Spirit</hc> to charge across the map at the cost of mana."
"DOTA_BroadcastFact_AbilityMovie_sven_storm_hammer"	"Un'esplosione magica che stordisce e danneggia i nemici in un'area."
"[english]DOTA_BroadcastFact_AbilityMovie_sven_storm_hammer"	"A magical AOE blast that stuns and deals damage."
"DOTA_BroadcastFact_AbilityMovie_sven_great_cleave"	"Gli attacchi colpiscono tutti i nemici vicini."
"[english]DOTA_BroadcastFact_AbilityMovie_sven_great_cleave"	"Attacks slice through to nearby enemies."
"DOTA_BroadcastFact_AbilityMovie_sven_warcry"	"Aumenta la velocità di movimento e l'armatura degli alleati."
"[english]DOTA_BroadcastFact_AbilityMovie_sven_warcry"	"Grants move speed and armor to allies."
"DOTA_BroadcastFact_AbilityMovie_sven_god's_strength"	"Aumenta sensibilmente il danno degli attacchi."
"[english]DOTA_BroadcastFact_AbilityMovie_sven_god's_strength"	"Gains massive bonus damage on attacks."
"DOTA_BroadcastFact_AbilityMovie_techies_proximity_mines"	"Posiziona una mina invisibile."
"[english]DOTA_BroadcastFact_AbilityMovie_techies_proximity_mines"	"Plants an invisible proximity mine."
"DOTA_BroadcastFact_AbilityMovie_techies_stasis_trap"	"Una trappola invisibile che blocca i nemici vicini."
"[english]DOTA_BroadcastFact_AbilityMovie_techies_stasis_trap"	"An invisible trap that roots nearby enemies."
"DOTA_BroadcastFact_AbilityMovie_techies_blast_off!"	"<hc>Techies</hc> si lancia verso un nemico, facendosi esplodere e silenziando i nemici."
"[english]DOTA_BroadcastFact_AbilityMovie_techies_blast_off!"	"<hc>Techies</hc> leaps at an enemy, detonating themselves and silencing foes."
"DOTA_BroadcastFact_AbilityMovie_techies_remote_mines"	"Delle mine che esplodono solo se attivate in remoto."
"[english]DOTA_BroadcastFact_AbilityMovie_techies_remote_mines"	"Powerful mines that will only detonate when triggered remotely."
"DOTA_BroadcastFact_AbilityMovie_templar_assassin_refraction"	"Uno scudo che blocca i danni e potenzia gli attacchi."
"[english]DOTA_BroadcastFact_AbilityMovie_templar_assassin_refraction"	"A shield that blocks damage and boosts attacks."
"DOTA_BroadcastFact_AbilityMovie_templar_assassin_meld"	"Rende invisibili finché l'Eroe non si muove, aumentandone il danno d'attacco."
"[english]DOTA_BroadcastFact_AbilityMovie_templar_assassin_meld"	"Hides until she moves, gives bonus damage."
"DOTA_BroadcastFact_AbilityMovie_templar_assassin_psi_blades"	"Gli attacchi attraversano il bersaglio e colpiscono i nemici dietro di esso."
"[english]DOTA_BroadcastFact_AbilityMovie_templar_assassin_psi_blades"	"Attacks slice through to enemies behind target."
"DOTA_BroadcastFact_AbilityMovie_templar_assassin_psionic_trap"	"Fornisce visione e rallenta i nemici quando viene attivata."
"[english]DOTA_BroadcastFact_AbilityMovie_templar_assassin_psionic_trap"	"Gives vision and slows enemies when sprung."
"DOTA_BroadcastFact_AbilityMovie_terrorblade_reflection"	"Crea una copia oscura di un Eroe nemico."
"[english]DOTA_BroadcastFact_AbilityMovie_terrorblade_reflection"	"Creates a dark copy of an enemy hero."
"DOTA_BroadcastFact_AbilityMovie_terrorblade_conjure_image"	"Genera un'Illusione di <hc>Terrorblade</hc>."
"[english]DOTA_BroadcastFact_AbilityMovie_terrorblade_conjure_image"	"Spawns an illusion of <hc>Terrorblade</hc>."
"DOTA_BroadcastFact_AbilityMovie_terrorblade_metamorphosis"	"L'Eroe si trasforma in un demone più grande con attacchi a distanza."
"[english]DOTA_BroadcastFact_AbilityMovie_terrorblade_metamorphosis"	"Transforms into a larger demon with ranged attack."
"DOTA_BroadcastFact_AbilityMovie_terrorblade_sunder"	"Scambia i punti salute dell'Eroe con quelli di un nemico o di un alleato."
"[english]DOTA_BroadcastFact_AbilityMovie_terrorblade_sunder"	"Instantly swaps health with an enemy or ally."
"DOTA_BroadcastFact_AbilityMovie_tidehunter_gush"	"Danneggia, rallenta e riduce l'armatura di un nemico."
"[english]DOTA_BroadcastFact_AbilityMovie_tidehunter_gush"	"Damages, slows, and reduces enemy armor."
"DOTA_BroadcastFact_AbilityMovie_tidehunter_kraken_shell"	"Blocca i danni fisici e rimuove gli effetti negativi."
"[english]DOTA_BroadcastFact_AbilityMovie_tidehunter_kraken_shell"	"Blocks physical damage and removes debuffs."
"DOTA_BroadcastFact_AbilityMovie_tidehunter_anchor_smash"	"Danneggia i nemici e riduce i danni d'attacco."
"[english]DOTA_BroadcastFact_AbilityMovie_tidehunter_anchor_smash"	"Damages enemies and reduces attack damage."
"DOTA_BroadcastFact_AbilityMovie_tidehunter_ravage"	"Evoca dei tentacoli che stordiscono e danneggiano i nemici in una grande area."
"[english]DOTA_BroadcastFact_AbilityMovie_tidehunter_ravage"	"Stuns a large area with tentacles, causing damage."
"DOTA_BroadcastFact_AbilityMovie_timbersaw_whirling_death"	"Danneggia i nemici e riduce il loro attributo primario."
"[english]DOTA_BroadcastFact_AbilityMovie_timbersaw_whirling_death"	"Damages enemies and reduces their primary stat."
"DOTA_BroadcastFact_AbilityMovie_timbersaw_timber_chain"	"Lancia una catena che si incastra in un albero, proiettando l'Eroe al punto d'impatto e danneggiando i nemici colpiti."
"[english]DOTA_BroadcastFact_AbilityMovie_timbersaw_timber_chain"	"Fires a chain into a tree, pulling him towards it and damaging foes caught in its path."
"DOTA_BroadcastFact_AbilityMovie_timbersaw_reactive_armor"	"L'armatura e la velocità di rigenerazione della salute aumentano ogni volta che viene attaccato."
"[english]DOTA_BroadcastFact_AbilityMovie_timbersaw_reactive_armor"	"Boosts health regen and armor when attacked."
"DOTA_BroadcastFact_AbilityMovie_timbersaw_chakram"	"Lancia una lama che ruota su se stessa, danneggiando e rallentando i nemici colpiti."
"[english]DOTA_BroadcastFact_AbilityMovie_timbersaw_chakram"	"Fires a damaging saw blade that spins in place and slows foes caught."
"DOTA_BroadcastFact_AbilityMovie_tinker_laser"	"Acceca il nemico facendogli mancare ogni attacco."
"[english]DOTA_BroadcastFact_AbilityMovie_tinker_laser"	"Blinds the target, causing it to miss attacks."
"DOTA_BroadcastFact_AbilityMovie_tinker_heat-seeking_missile"	"Spara dei missili ai nemici visibili più vicini."
"[english]DOTA_BroadcastFact_AbilityMovie_tinker_heat-seeking_missile"	"Launches rockets at nearest visible enemies."
"DOTA_BroadcastFact_AbilityMovie_tinker_march_of_the_machines"	"Un esercito di robot distrugge i nemici all'interno di una certa area."
"[english]DOTA_BroadcastFact_AbilityMovie_tinker_march_of_the_machines"	"An army of robots destroy enemies in an area."
"DOTA_BroadcastFact_AbilityMovie_tinker_rearm"	"Azzera i tempi di ricarica di molti oggetti e abilità di <hc>Tinker</hc>."
"[english]DOTA_BroadcastFact_AbilityMovie_tinker_rearm"	"Resets the cooldowns on most of <hc>Tinker</hc>'s items and abilities."
"DOTA_BroadcastFact_AbilityMovie_tiny_avalanche"	"Bombarda un'area con delle pietre, stordendo i nemici."
"[english]DOTA_BroadcastFact_AbilityMovie_tiny_avalanche"	"Blasts an area with rocks, stunning enemies."
"DOTA_BroadcastFact_AbilityMovie_tiny_toss"	"Afferra l'Unità più vicina e la lancia contro un bersaglio."
"[english]DOTA_BroadcastFact_AbilityMovie_tiny_toss"	"Grabs the nearest unit and throws it at a target."
"DOTA_BroadcastFact_AbilityMovie_tiny_craggy_exterior"	"Respinge i danni contro gli avversari, con una probabilità che vengano storditi."
"[english]DOTA_BroadcastFact_AbilityMovie_tiny_craggy_exterior"	"Bounces damage back on attackers. Chance to stun."
"DOTA_BroadcastFact_AbilityMovie_tiny_grow"	"<hc>Tiny</hc> cresce di dimensioni, aumentando la sua forza a scapito della velocità."
"[english]DOTA_BroadcastFact_AbilityMovie_tiny_grow"	"<hc>Tiny</hc> grows in size, gaining strength but losing speed."
"DOTA_BroadcastFact_AbilityMovie_treant_protector_nature's_guise"	"L'Eroe diventa invisibile quando si trova vicino a degli alberi."
"[english]DOTA_BroadcastFact_AbilityMovie_treant_protector_nature's_guise"	"Treant turns invisible when near trees."
"DOTA_BroadcastFact_AbilityMovie_treant_protector_leech_seed"	"Prosciuga punti salute e rallenta i nemici. Guarisce gli alleati vicini."
"[english]DOTA_BroadcastFact_AbilityMovie_treant_protector_leech_seed"	"Drains health and slows. Heals nearby allies."
"DOTA_BroadcastFact_AbilityMovie_treant_protector_living_armor"	"Aumenta la rigenerazione degli alleati e delle strutture. Blocca i danni."
"[english]DOTA_BroadcastFact_AbilityMovie_treant_protector_living_armor"	"Boosts regen of allies and buildings. Also blocks damage."
"DOTA_BroadcastFact_AbilityMovie_treant_protector_overgrowth"	"Evoca dei rampicanti che bloccano i nemici e impediscono ogni attacco."
"[english]DOTA_BroadcastFact_AbilityMovie_treant_protector_overgrowth"	"Summons vines to hold enemies in place and prevent attacks."
"DOTA_BroadcastFact_AbilityMovie_troll_warlord_berserker's_rage"	"Alterna tra gli attacchi a distanza e quelli corpo a corpo."
"[english]DOTA_BroadcastFact_AbilityMovie_troll_warlord_berserker's_rage"	"Swaps attacks between ranged and melee."
"DOTA_BroadcastFact_AbilityMovie_troll_warlord_whirling_axes"	"Lancia delle asce contro il bersaglio, rallentandolo e danneggiandolo."
"[english]DOTA_BroadcastFact_AbilityMovie_troll_warlord_whirling_axes"	"Hurls axes at the target, slowing and damaging."
"DOTA_BroadcastFact_AbilityMovie_troll_warlord_fervor"	"Aumenta la velocità di attacco per ogni colpo inflitto allo stesso bersaglio."
"[english]DOTA_BroadcastFact_AbilityMovie_troll_warlord_fervor"	"Grants attack speed with each hit on the same target."
"DOTA_BroadcastFact_AbilityMovie_troll_warlord_battle_trance"	"Aumenta la velocità di attacco di <hc>Troll Warlord</hc> e di tutti gli alleati."
"[english]DOTA_BroadcastFact_AbilityMovie_troll_warlord_battle_trance"	"Increases the attack speed of <hc>Troll Warlord</hc> and all allies."
"DOTA_BroadcastFact_AbilityMovie_tusk_ice_shards"	"Lancia una barriera di ghiaccio che può intrappolare i nemici."
"[english]DOTA_BroadcastFact_AbilityMovie_tusk_ice_shards"	"Throws an icy barrier that can trap enemies."
"DOTA_BroadcastFact_AbilityMovie_tusk_snowball"	"<hc>Tusk</hc> si trasforma in una palla di neve per inseguire i nemici."
"[english]DOTA_BroadcastFact_AbilityMovie_tusk_snowball"	"<hc>Tusk</hc> rolls into a snowball to chase down an enemy."
"DOTA_BroadcastFact_AbilityMovie_tusk_frozen_sigil"	"Evoca un sigillo glaciale che rallenta tutti i nemici vicini."
"[english]DOTA_BroadcastFact_AbilityMovie_tusk_frozen_sigil"	"Summons an icy sigil that slows all nearby enemies."
"DOTA_BroadcastFact_AbilityMovie_tusk_walrus_punch"	"Un pugno potentissimo in grado di lanciare la vittima in aria."
"[english]DOTA_BroadcastFact_AbilityMovie_tusk_walrus_punch"	"A mighty punch that launches an enemy into the air."
"DOTA_BroadcastFact_AbilityMovie_underlord_firestorm"	"Evoca delle ondate di fuoco che bruciano le Unità nemiche."
"[english]DOTA_BroadcastFact_AbilityMovie_underlord_firestorm"	"Calls down waves of fire, burning enemy units."
"DOTA_BroadcastFact_AbilityMovie_underlord_pit_of_malice"	"Una fossa che intrappola i nemici al suo interno."
"[english]DOTA_BroadcastFact_AbilityMovie_underlord_pit_of_malice"	"A pit that continually roots enemies trapped in it."
"DOTA_BroadcastFact_AbilityMovie_underlord_atrophy_aura"	"Indebolisce i nemici vicini. Se questi muoiono, il danno d'attacco dell'Eroe aumenterà."
"[english]DOTA_BroadcastFact_AbilityMovie_underlord_atrophy_aura"	"Weakens nearby enemies. Earns bonus damage if they die."
"DOTA_BroadcastFact_AbilityMovie_underlord_dark_rift"	"Teletrasporta <hc>Underlord</hc> e i compagni vicini nel punto selezionato."
"[english]DOTA_BroadcastFact_AbilityMovie_underlord_dark_rift"	"Teleports <hc>Underlord</hc> and nearby allies to a location."
"DOTA_BroadcastFact_AbilityMovie_undying_decay"	"Ruba la Forza di tutti gli Eroi in una certa area."
"[english]DOTA_BroadcastFact_AbilityMovie_undying_decay"	"Steals strength from all heroes in an area."
"DOTA_BroadcastFact_AbilityMovie_undying_soul_rip"	"Prosciuga la salute delle Unità vicine e cura un alleato."
"[english]DOTA_BroadcastFact_AbilityMovie_undying_soul_rip"	"Rips health from nearby units and heals an ally."
"DOTA_BroadcastFact_AbilityMovie_undying_tombstone"	"Evoca una lapide e genera degli zombi che rallentano i nemici."
"[english]DOTA_BroadcastFact_AbilityMovie_undying_tombstone"	"Summons a tombstone and spawns zombies that slow."
"DOTA_BroadcastFact_AbilityMovie_undying_flesh_golem"	"Si trasforma in un golem che rallenta i nemici e amplifica i danni."
"[english]DOTA_BroadcastFact_AbilityMovie_undying_flesh_golem"	"Changes into a golem that slows enemies and amps damage."
"DOTA_BroadcastFact_AbilityMovie_ursa_earthshock"	"Colpisce il terreno danneggiando e rallentando i nemici."
"[english]DOTA_BroadcastFact_AbilityMovie_ursa_earthshock"	"Slams the earth, damaging and slowing enemies."
"DOTA_BroadcastFact_AbilityMovie_ursa_overpower"	"Aumenta la velocità di un certo numero di attacchi."
"[english]DOTA_BroadcastFact_AbilityMovie_ursa_overpower"	"Gains attack speed for a number of attacks."
"DOTA_BroadcastFact_AbilityMovie_ursa_fury_swipes"	"Attaccare più volte lo stesso bersaglio permette all'Eroe di infliggere danni aggiuntivi."
"[english]DOTA_BroadcastFact_AbilityMovie_ursa_fury_swipes"	"Subsequent hits on same target do bonus damage."
"DOTA_BroadcastFact_AbilityMovie_ursa_enrage"	"Aumenta il danno di <ac>Sfuriate</ac> e riduce i danni subiti."
"[english]DOTA_BroadcastFact_AbilityMovie_ursa_enrage"	"Increases <ac>Fury Swipe</ac> damage and reduces incoming damage."
"DOTA_BroadcastFact_AbilityMovie_vengeful_spirit_magic_missile"	"Un incantesimo a distanza che stordisce e danneggia."
"[english]DOTA_BroadcastFact_AbilityMovie_vengeful_spirit_magic_missile"	"A ranged spell that stuns and deals damage."
"DOTA_BroadcastFact_AbilityMovie_vengeful_spirit_wave_of_terror"	"Riduce l'armatura dei nemici e fornisce visione del percorso coperto dall'abilità."
"[english]DOTA_BroadcastFact_AbilityMovie_vengeful_spirit_wave_of_terror"	"Reduces enemy armor and grants vision."
"DOTA_BroadcastFact_AbilityMovie_vengeful_spirit_vengeance_aura"	"Aumenta il danno d'attacco di Vengeful Spirit e degli alleati vicini."
"[english]DOTA_BroadcastFact_AbilityMovie_vengeful_spirit_vengeance_aura"	"Grants bonus damage to self and nearby allies."
"DOTA_BroadcastFact_AbilityMovie_vengeful_spirit_nether_swap"	"Scambia la posizione con un altro Eroe, amico o nemico."
"[english]DOTA_BroadcastFact_AbilityMovie_vengeful_spirit_nether_swap"	"Swaps position with another hero—friend or foe."
"DOTA_BroadcastFact_AbilityMovie_venomancer_venomous_gale"	"Lancia una tossina che rallenta e avvelena."
"[english]DOTA_BroadcastFact_AbilityMovie_venomancer_venomous_gale"	"Launches venom that slows and poisons."
"DOTA_BroadcastFact_AbilityMovie_venomancer_poison_sting"	"Gli attacchi di base provocano danni da veleno e rallentano i nemici."
"[english]DOTA_BroadcastFact_AbilityMovie_venomancer_poison_sting"	"Adds poison damage to normal attacks. Slows."
"DOTA_BroadcastFact_AbilityMovie_venomancer_plague_ward"	"Evoca un guardiano in grado di attaccare nemici e strutture."
"[english]DOTA_BroadcastFact_AbilityMovie_venomancer_plague_ward"	"Summons a ward that can attack enemies and buildings."
"DOTA_BroadcastFact_AbilityMovie_venomancer_poison_nova"	"Spruzza un anello di veleno che danneggia i nemici con il passare del tempo, senza però poterli uccidere."
"[english]DOTA_BroadcastFact_AbilityMovie_venomancer_poison_nova"	"Sprays poison in a ring. Damages over time, but cannot kill enemies."
"DOTA_BroadcastFact_AbilityMovie_viper_poison_attack"	"Un potente veleno che rallenta e danneggia con il passare del tempo."
"[english]DOTA_BroadcastFact_AbilityMovie_viper_poison_attack"	"Powerful venom. Slows and damages over time."
"DOTA_BroadcastFact_AbilityMovie_viper_nethertoxin"	"Gli attacchi infliggono danni aggiuntivi in base alla salute mancante."
"[english]DOTA_BroadcastFact_AbilityMovie_viper_nethertoxin"	"Attacks deal bonus damage based on health missing."
"DOTA_BroadcastFact_AbilityMovie_viper_corrosive_skin"	"Danneggia e rallenta i nemici che attaccano <hc>Viper</hc>."
"[english]DOTA_BroadcastFact_AbilityMovie_viper_corrosive_skin"	"Damages and slows enemies that attack <hc>Viper</hc>."
"DOTA_BroadcastFact_AbilityMovie_viper_viper_strike"	"Rallenta il bersaglio e danneggia con il passare del tempo."
"[english]DOTA_BroadcastFact_AbilityMovie_viper_viper_strike"	"Slows the target and deals damage over time."
"DOTA_BroadcastFact_AbilityMovie_visage_grave_chill"	"Assorbe la velocità di movimento e la velocità di attacco del bersaglio."
"[english]DOTA_BroadcastFact_AbilityMovie_visage_grave_chill"	"Drains movement and attack speed from target."
"DOTA_BroadcastFact_AbilityMovie_visage_soul_assumption"	"Ottiene delle cariche quando i nemici subiscono danni."
"[english]DOTA_BroadcastFact_AbilityMovie_visage_soul_assumption"	"Gains charges when enemies take damage. "
"DOTA_BroadcastFact_AbilityMovie_visage_gravekeeper's_cloak"	"<hc>Visage</hc> crea delle barriere che lo proteggono dai danni."
"[english]DOTA_BroadcastFact_AbilityMovie_visage_gravekeeper's_cloak"	"Layered barriers protect <hc>Visage</hc> from damage."
"DOTA_BroadcastFact_AbilityMovie_visage_summon_familiars"	"Evoca due famigli volanti che combattono per <hc>Visage</hc>."
"[english]DOTA_BroadcastFact_AbilityMovie_visage_summon_familiars"	"Conjures two flying familiars to fight for <hc>Visage</hc>."
"DOTA_BroadcastFact_AbilityMovie_warlock_fatal_bonds"	"Crea un legame tra diverse Unità in modo che condividano i danni subiti."
"[english]DOTA_BroadcastFact_AbilityMovie_warlock_fatal_bonds"	"Binds units to share damage between one another."
"DOTA_BroadcastFact_AbilityMovie_warlock_shadow_word"	"Cura un'Unità alleata o danneggia un nemico con il passare del tempo."
"[english]DOTA_BroadcastFact_AbilityMovie_warlock_shadow_word"	"Heal a friendly unit or damage an enemy over time."
"DOTA_BroadcastFact_AbilityMovie_warlock_upheaval"	"Canalizza una corrente che rallenta tutti i nemici in una certa area."
"[english]DOTA_BroadcastFact_AbilityMovie_warlock_upheaval"	"Channels a current that slows all enemies in an area."
"DOTA_BroadcastFact_AbilityMovie_warlock_chaotic_offering"	"Evoca un grande e potente golem, stordendo i nemici vicini."
"[english]DOTA_BroadcastFact_AbilityMovie_warlock_chaotic_offering"	"Summons a mighty, fiery golem, stunning nearby enemies."
"DOTA_BroadcastFact_AbilityMovie_weaver_the_swarm"	"Libera degli insetti che danneggiano i nemici e riducono l'armatura."
"[english]DOTA_BroadcastFact_AbilityMovie_weaver_the_swarm"	"Releases bugs that hurt enemies and reduce armor."
"DOTA_BroadcastFact_AbilityMovie_weaver_shukuchi"	"Rende <hc>Weaver</hc> invisibile, aumenta la velocità di movimento e permette di danneggiare le Unità che tocca."
"[english]DOTA_BroadcastFact_AbilityMovie_weaver_shukuchi"	"Cloaks <hc>Weaver</hc> and boosts movespeed, damaging units touched."
"DOTA_BroadcastFact_AbilityMovie_weaver_geminate_attack"	"Permette all'Eroe di usare due attacchi alla volta."
"[english]DOTA_BroadcastFact_AbilityMovie_weaver_geminate_attack"	"Allows weaver to launch two attacks at once."
"DOTA_BroadcastFact_AbilityMovie_weaver_time_lapse"	"Permette di tornare indietro nel tempo, facendo recuperare a <hc>Weaver</hc> la salute e il mana persi."
"[english]DOTA_BroadcastFact_AbilityMovie_weaver_time_lapse"	"Rewind time, reverting any lost health and mana from <hc>Weaver</hc>."
"DOTA_BroadcastFact_AbilityMovie_windranger_shackleshot"	"Lega il bersaglio ad un nemico o ad un albero dietro di esso, stordendo entrambi."
"[english]DOTA_BroadcastFact_AbilityMovie_windranger_shackleshot"	"Binds the target to an enemy or tree behind it, stunning both."
"DOTA_BroadcastFact_AbilityMovie_windranger_powershot"	"Scocca una freccia che danneggia i nemici in linea retta."
"[english]DOTA_BroadcastFact_AbilityMovie_windranger_powershot"	"Fire an arrow that damages enemies in a line."
"DOTA_BroadcastFact_AbilityMovie_windranger_windrun"	"Aumenta la velocità di movimento e permette di schivare tutti gli attacchi fisici."
"[english]DOTA_BroadcastFact_AbilityMovie_windranger_windrun"	"Boosts move speed and adds evasion."
"DOTA_BroadcastFact_AbilityMovie_windranger_focus_fire"	"Lancia una scarica di frecce contro un bersaglio."
"[english]DOTA_BroadcastFact_AbilityMovie_windranger_focus_fire"	"Launches a continuous hail of arrows at one target."
"DOTA_BroadcastFact_AbilityMovie_winter_wyvern_arctic_burn"	"Permette all'Eroe di muoversi in volo. I suoi attacchi rallentano il bersaglio."
"[english]DOTA_BroadcastFact_AbilityMovie_winter_wyvern_arctic_burn"	"Grants flying movement. Adds slow to each attack."
"DOTA_BroadcastFact_AbilityMovie_winter_wyvern_splinter_blast"	"Una sfera di ghiaccio che si frantuma contro le Unità vicine, danneggiandole e rallentandole di conseguenza."
"[english]DOTA_BroadcastFact_AbilityMovie_winter_wyvern_splinter_blast"	"Splinters to nearby units, hurting and slowing them."
"DOTA_BroadcastFact_AbilityMovie_winter_wyvern_cold_embrace"	"Ricopre di ghiaccio un alleato per curarlo e proteggerlo dagli attacchi fisici."
"[english]DOTA_BroadcastFact_AbilityMovie_winter_wyvern_cold_embrace"	"Encases an ally in ice, healing and protecting them from physical attacks."
"DOTA_BroadcastFact_AbilityMovie_winter_wyvern_winter's_curse"	"Congela un nemico e obbliga i suoi alleati ad attaccarlo."
"[english]DOTA_BroadcastFact_AbilityMovie_winter_wyvern_winter's_curse"	"Freezes an enemy, forcing nearby enemy teammates to attack."
"DOTA_BroadcastFact_AbilityMovie_witch_doctor_paralyzing_cask"	"Rimbalza tra i nemici e li stordisce."
"[english]DOTA_BroadcastFact_AbilityMovie_witch_doctor_paralyzing_cask"	"Bounces between enemies, stunning them."
"DOTA_BroadcastFact_AbilityMovie_witch_doctor_voodoo_restoration"	"Cura gli alleati vicini."
"[english]DOTA_BroadcastFact_AbilityMovie_witch_doctor_voodoo_restoration"	"Heals nearby allies."
"DOTA_BroadcastFact_AbilityMovie_witch_doctor_maledict"	"Maledice una piccola area, danneggiando nel tempo chi era al suo interno."
"[english]DOTA_BroadcastFact_AbilityMovie_witch_doctor_maledict"	"Curses a small area, dealing damage over time."
"DOTA_BroadcastFact_AbilityMovie_witch_doctor_death_ward"	"Invoca un guardiano letale che danneggia i nemici vicini."
"[english]DOTA_BroadcastFact_AbilityMovie_witch_doctor_death_ward"	"Channels a deadly ward to destroy nearby enemies."
"DOTA_BroadcastFact_AbilityMovie_wraith_king_wraithfire_blast"	"Uno scoppio a distanza che stordisce e danneggia un nemico."
"[english]DOTA_BroadcastFact_AbilityMovie_wraith_king_wraithfire_blast"	"A ranged blast that stuns and damages an enemy."
"DOTA_BroadcastFact_AbilityMovie_wraith_king_vampiric_aura"	"Permette agli attacchi degli alleati vicini di prosciugare la salute dei nemici."
"[english]DOTA_BroadcastFact_AbilityMovie_wraith_king_vampiric_aura"	"Nearby allies gain lifesteal when attacking."
"DOTA_BroadcastFact_AbilityMovie_wraith_king_mortal_strike"	"Gli attacchi hanno una probabilità di infliggere danni aggiuntivi."
"[english]DOTA_BroadcastFact_AbilityMovie_wraith_king_mortal_strike"	"Attacks have a chance to deal bonus damage."
"DOTA_BroadcastFact_AbilityMovie_wraith_king_reincarnation"	"Resuscita <hc>Wraith King</hc> dopo la morte, rallentando le Unità vicine."
"[english]DOTA_BroadcastFact_AbilityMovie_wraith_king_reincarnation"	"Resurrects <hc>Wraith King</hc> upon death, slowing nearby units."
"DOTA_BroadcastFact_AbilityMovie_zeus_arc_lightning"	"Scaglia una saetta che si diffonde tra i nemici vicini."
"[english]DOTA_BroadcastFact_AbilityMovie_zeus_arc_lightning"	"Hurls lightning that leaps to nearby enemies."
"DOTA_BroadcastFact_AbilityMovie_zeus_lightning_bolt"	"Scaglia un fulmine che rivela le Unità invisibili."
"[english]DOTA_BroadcastFact_AbilityMovie_zeus_lightning_bolt"	"Calls down lightning. Reveals invisible units."
"DOTA_BroadcastFact_AbilityMovie_zeus_static_field"	"<hc>Zeus</hc> folgora i nemici vicini ogni volta che usa un incantesimo."
"[english]DOTA_BroadcastFact_AbilityMovie_zeus_static_field"	"<hc>Zeus</hc> shocks nearby enemies whenever he casts a spell."
"DOTA_BroadcastFact_AbilityMovie_zeus_thundergod's_wrath"	"Colpisce tutti i nemici sulla mappa con un fulmine."
"[english]DOTA_BroadcastFact_AbilityMovie_zeus_thundergod's_wrath"	"Strikes all enemies on the map with lightning."
}
}
