"hero_chat_wheel"
{
"dota_chatwheel_message_antimage_laugh"	"Ha ha ha ha ha ha ha ha ha ha ha ha!"
"[english]dota_chatwheel_message_antimage_laugh"	"Ha ha ha ha ha ha ha ha ha ha ha ha!"
"dota_chatwheel_label_antimage_laugh"	"[大笑]"
"[english]dota_chatwheel_label_antimage_laugh"	"Laugh"
"dota_chatwheel_message_antimage_thank"	"I'll give them a drubbing they'll not soon forget!"
"[english]dota_chatwheel_message_antimage_thank"	"I'll give them a drubbing they'll not soon forget!"
"dota_chatwheel_label_antimage_thank"	"I'll give them a drubbing..."
"[english]dota_chatwheel_label_antimage_thank"	"I'll give them a drubbing..."
"dota_chatwheel_message_antimage_deny"	"Are you even trying?"
"[english]dota_chatwheel_message_antimage_deny"	"Are you even trying?"
"dota_chatwheel_label_antimage_deny"	"Are you even trying?"
"[english]dota_chatwheel_label_antimage_deny"	"Are you even trying?"
"dota_chatwheel_message_antimage_1"	"Magic is an abomination."
"[english]dota_chatwheel_message_antimage_1"	"Magic is an abomination."
"dota_chatwheel_label_antimage_1"	"Magic is an abomination."
"[english]dota_chatwheel_label_antimage_1"	"Magic is an abomination."
"dota_chatwheel_message_antimage_2"	"A disappointment."
"[english]dota_chatwheel_message_antimage_2"	"A disappointment."
"dota_chatwheel_label_antimage_2"	"A disappointment."
"[english]dota_chatwheel_label_antimage_2"	"A disappointment."
"dota_chatwheel_message_antimage_3"	"Magic thyself out of that."
"[english]dota_chatwheel_message_antimage_3"	"Magic thyself out of that."
"dota_chatwheel_label_antimage_3"	"Magic thyself out of that."
"[english]dota_chatwheel_label_antimage_3"	"Magic thyself out of that."
"dota_chatwheel_message_antimage_4"	"Thou art damned!"
"[english]dota_chatwheel_message_antimage_4"	"Thou art damned!"
"dota_chatwheel_label_antimage_4"	"Thou art damned."
"[english]dota_chatwheel_label_antimage_4"	"Thou art damned."
"dota_chatwheel_message_antimage_5"	"Send thy Dead God's legions, I will put them all to death."
"[english]dota_chatwheel_message_antimage_5"	"Send thy Dead God's legions, I will put them all to death."
"dota_chatwheel_label_antimage_5"	"Send thy Dead God's legions..."
"[english]dota_chatwheel_label_antimage_5"	"Send thy Dead God's legions..."
"dota_chatwheel_message_axe_laugh"	"Ha ha ha ha ha ha!"
"[english]dota_chatwheel_message_axe_laugh"	"Ha ha ha ha ha ha!"
"dota_chatwheel_label_axe_laugh"	"[大笑]"
"[english]dota_chatwheel_label_axe_laugh"	"Laugh"
"dota_chatwheel_message_axe_thank"	"Axe likes this very much."
"[english]dota_chatwheel_message_axe_thank"	"Axe likes this very much."
"dota_chatwheel_label_axe_thank"	"Axe likes this very much."
"[english]dota_chatwheel_label_axe_thank"	"Axe likes this very much."
"dota_chatwheel_message_axe_deny"	"You deserve nothing!"
"[english]dota_chatwheel_message_axe_deny"	"You deserve nothing!"
"dota_chatwheel_label_axe_deny"	"You deserve nothing!"
"[english]dota_chatwheel_label_axe_deny"	"You deserve nothing!"
"dota_chatwheel_message_axe_1"	"You fought badly--died worse."
"[english]dota_chatwheel_message_axe_1"	"You fought badly--died worse."
"dota_chatwheel_label_axe_1"	"You fought badly"
"[english]dota_chatwheel_label_axe_1"	"You fought badly"
"dota_chatwheel_message_axe_2"	"I said good day, sir!"
"[english]dota_chatwheel_message_axe_2"	"I said good day, sir!"
"dota_chatwheel_label_axe_2"	"I said good day, sir!"
"[english]dota_chatwheel_label_axe_2"	"I said good day, sir!"
"dota_chatwheel_message_axe_3"	"Axe misjudged?"
"[english]dota_chatwheel_message_axe_3"	"Axe misjudged?"
"dota_chatwheel_label_axe_3"	"Axe misjudged?"
"[english]dota_chatwheel_label_axe_3"	"Axe misjudged?"
"dota_chatwheel_message_axe_4"	"Axe has no time for all this jibber-jabber."
"[english]dota_chatwheel_message_axe_4"	"Axe has no time for all this jibber-jabber."
"dota_chatwheel_label_axe_4"	"Axe has no time for all this jibber-jabber."
"[english]dota_chatwheel_label_axe_4"	"Axe has no time for all this jibber-jabber."
"dota_chatwheel_message_axe_5"	"What happened? Axe happened!"
"[english]dota_chatwheel_message_axe_5"	"What happened? Axe happened!"
"dota_chatwheel_label_axe_5"	"What happened? Axe happened!"
"[english]dota_chatwheel_label_axe_5"	"What happened? Axe happened!"
"dota_chatwheel_message_bane_laugh"	"Ha ha ha ha ha ha ha ha ha!"
"[english]dota_chatwheel_message_bane_laugh"	"Ha ha ha ha ha ha ha ha ha!"
"dota_chatwheel_label_bane_laugh"	"[大笑]"
"[english]dota_chatwheel_label_bane_laugh"	"Laugh"
"dota_chatwheel_message_bane_thank"	"You're so nice."
"[english]dota_chatwheel_message_bane_thank"	"You're so nice."
"dota_chatwheel_label_bane_thank"	"You're so nice."
"[english]dota_chatwheel_label_bane_thank"	"You're so nice."
"dota_chatwheel_message_bane_deny"	"Better luck next time."
"[english]dota_chatwheel_message_bane_deny"	"Better luck next time."
"dota_chatwheel_label_bane_deny"	"Better luck next time."
"[english]dota_chatwheel_label_bane_deny"	"Better luck next time."
"dota_chatwheel_message_bane_1"	"Bane of your existence."
"[english]dota_chatwheel_message_bane_1"	"Bane of your existence."
"dota_chatwheel_label_bane_1"	"Bane of your existence."
"[english]dota_chatwheel_label_bane_1"	"Bane of your existence."
"dota_chatwheel_message_bane_2"	"I've been dreaming of this moment."
"[english]dota_chatwheel_message_bane_2"	"I've been dreaming of this moment."
"dota_chatwheel_label_bane_2"	"I've been dreaming of this moment."
"[english]dota_chatwheel_label_bane_2"	"I've been dreaming of this moment."
"dota_chatwheel_message_bane_3"	"Fair exchange."
"[english]dota_chatwheel_message_bane_3"	"Fair exchange."
"dota_chatwheel_label_bane_3"	"Fair exchange."
"[english]dota_chatwheel_label_bane_3"	"Fair exchange."
"dota_chatwheel_message_bane_4"	"Now your nightmare lasts forever."
"[english]dota_chatwheel_message_bane_4"	"Now your nightmare lasts forever."
"dota_chatwheel_label_bane_4"	"Now your nightmare lasts forever."
"[english]dota_chatwheel_label_bane_4"	"Now your nightmare lasts forever."
"dota_chatwheel_message_bane_5"	"Ah ya ya ya ya ya yai eeyas!"
"[english]dota_chatwheel_message_bane_5"	"Ah ya ya ya ya ya yai eeyas!"
"dota_chatwheel_label_bane_5"	"Ah ya ya ya ya ya yai eeyas!"
"[english]dota_chatwheel_label_bane_5"	"Ah ya ya ya ya ya yai eeyas!"
"dota_chatwheel_message_bloodseeker_laugh"	"Hmm-heh-heh-heh-heh-ha!"
"[english]dota_chatwheel_message_bloodseeker_laugh"	"Hmm-heh-heh-heh-heh-ha!"
"dota_chatwheel_label_bloodseeker_laugh"	"[大笑]"
"[english]dota_chatwheel_label_bloodseeker_laugh"	"Laugh"
"dota_chatwheel_message_bloodseeker_thank"	"So much blood."
"[english]dota_chatwheel_message_bloodseeker_thank"	"So much blood."
"dota_chatwheel_label_bloodseeker_thank"	"So much blood."
"[english]dota_chatwheel_label_bloodseeker_thank"	"So much blood."
"dota_chatwheel_message_bloodseeker_deny"	"No blood for you."
"[english]dota_chatwheel_message_bloodseeker_deny"	"No blood for you."
"dota_chatwheel_label_bloodseeker_deny"	"No blood for you."
"[english]dota_chatwheel_label_bloodseeker_deny"	"No blood for you."
"dota_chatwheel_message_bloodseeker_1"	"I'm seeing red...and it's amazing!"
"[english]dota_chatwheel_message_bloodseeker_1"	"I'm seeing red...and it's amazing!"
"dota_chatwheel_label_bloodseeker_1"	"I'm seeing red...and it's amazing!"
"[english]dota_chatwheel_label_bloodseeker_1"	"I'm seeing red...and it's amazing!"
"dota_chatwheel_message_bloodseeker_2"	"Don't be negative...be positive."
"[english]dota_chatwheel_message_bloodseeker_2"	"Don't be negative...be positive."
"dota_chatwheel_label_bloodseeker_2"	"Don't be negative..."
"[english]dota_chatwheel_label_bloodseeker_2"	"Don't be negative..."
"dota_chatwheel_message_bloodseeker_3"	"Go ahead...run."
"[english]dota_chatwheel_message_bloodseeker_3"	"Go ahead...run."
"dota_chatwheel_label_bloodseeker_3"	"Go ahead...run."
"[english]dota_chatwheel_label_bloodseeker_3"	"Go ahead...run."
"dota_chatwheel_message_bloodseeker_4"	"Lie down...have a cookie."
"[english]dota_chatwheel_message_bloodseeker_4"	"Lie down...have a cookie."
"dota_chatwheel_label_bloodseeker_4"	"Lie down...have a cookie."
"[english]dota_chatwheel_label_bloodseeker_4"	"Lie down...have a cookie."
"dota_chatwheel_message_bloodseeker_5"	"Over the field of battle, the smell of blood rises like a promise."
"[english]dota_chatwheel_message_bloodseeker_5"	"Over the field of battle, the smell of blood rises like a promise."
"dota_chatwheel_label_bloodseeker_5"	"Over the field of battle..."
"[english]dota_chatwheel_label_bloodseeker_5"	"Over the field of battle..."
"dota_chatwheel_message_crystal_maiden_laugh"	"Ah ha ha ha ha ha."
"[english]dota_chatwheel_message_crystal_maiden_laugh"	"Ah ha ha ha ha ha."
"dota_chatwheel_label_crystal_maiden_laugh"	"[大笑]"
"[english]dota_chatwheel_label_crystal_maiden_laugh"	"Laugh"
"dota_chatwheel_message_crystal_maiden_thank"	"Very cool of you!"
"[english]dota_chatwheel_message_crystal_maiden_thank"	"Very cool of you!"
"dota_chatwheel_label_crystal_maiden_thank"	"Very cool of you!"
"[english]dota_chatwheel_label_crystal_maiden_thank"	"Very cool of you!"
"dota_chatwheel_message_crystal_maiden_deny"	"Now nobody wins!"
"[english]dota_chatwheel_message_crystal_maiden_deny"	"Now nobody wins!"
"dota_chatwheel_label_crystal_maiden_deny"	"Now nobody wins!"
"[english]dota_chatwheel_label_crystal_maiden_deny"	"Now nobody wins!"
"dota_chatwheel_message_crystal_maiden_1"	"You'll make a nice snow angel."
"[english]dota_chatwheel_message_crystal_maiden_1"	"You'll make a nice snow angel."
"dota_chatwheel_label_crystal_maiden_1"	"You'll make a nice snow angel."
"[english]dota_chatwheel_label_crystal_maiden_1"	"You'll make a nice snow angel."
"dota_chatwheel_message_crystal_maiden_2"	"I've got goosebumps!"
"[english]dota_chatwheel_message_crystal_maiden_2"	"I've got goosebumps!"
"dota_chatwheel_label_crystal_maiden_2"	"I've got goosebumps!"
"[english]dota_chatwheel_label_crystal_maiden_2"	"I've got goosebumps!"
"dota_chatwheel_message_crystal_maiden_3"	"I didn't see that coming."
"[english]dota_chatwheel_message_crystal_maiden_3"	"I didn't see that coming."
"dota_chatwheel_label_crystal_maiden_3"	"I didn't see that coming."
"[english]dota_chatwheel_label_crystal_maiden_3"	"I didn't see that coming."
"dota_chatwheel_message_crystal_maiden_4"	"It just keeps getting better."
"[english]dota_chatwheel_message_crystal_maiden_4"	"It just keeps getting better."
"dota_chatwheel_label_crystal_maiden_4"	"It just keeps getting better."
"[english]dota_chatwheel_label_crystal_maiden_4"	"It just keeps getting better."
"dota_chatwheel_message_crystal_maiden_5"	"Is it cold in here or is it just me?"
"[english]dota_chatwheel_message_crystal_maiden_5"	"Is it cold in here or is it just me?"
"dota_chatwheel_label_crystal_maiden_5"	"Is it cold in here or..."
"[english]dota_chatwheel_label_crystal_maiden_5"	"Is it cold in here or..."
"dota_chatwheel_message_drow_ranger_laugh"	"Ah ha ha ha ha ha ha ha ha ha ha ha ha ha!"
"[english]dota_chatwheel_message_drow_ranger_laugh"	"Ah ha ha ha ha ha ha ha ha ha ha ha ha ha!"
"dota_chatwheel_label_drow_ranger_laugh"	"[大笑]"
"[english]dota_chatwheel_label_drow_ranger_laugh"	"Laugh"
"dota_chatwheel_message_drow_ranger_thank"	"Another triumph!"
"[english]dota_chatwheel_message_drow_ranger_thank"	"Another triumph!"
"dota_chatwheel_label_drow_ranger_thank"	"Another triumph!"
"[english]dota_chatwheel_label_drow_ranger_thank"	"Another triumph!"
"dota_chatwheel_message_drow_ranger_deny"	"You'll have to do better than that!"
"[english]dota_chatwheel_message_drow_ranger_deny"	"You'll have to do better than that!"
"dota_chatwheel_label_drow_ranger_deny"	"You'll have to do better than that!"
"[english]dota_chatwheel_label_drow_ranger_deny"	"You'll have to do better than that!"
"dota_chatwheel_message_drow_ranger_1"	"You were too noisy to live."
"[english]dota_chatwheel_message_drow_ranger_1"	"You were too noisy to live."
"dota_chatwheel_label_drow_ranger_1"	"You were too noisy to live."
"[english]dota_chatwheel_label_drow_ranger_1"	"You were too noisy to live."
"dota_chatwheel_message_drow_ranger_2"	"Amateur."
"[english]dota_chatwheel_message_drow_ranger_2"	"Amateur."
"dota_chatwheel_label_drow_ranger_2"	"Amateur."
"[english]dota_chatwheel_label_drow_ranger_2"	"Amateur."
"dota_chatwheel_message_drow_ranger_3"	"You die alone."
"[english]dota_chatwheel_message_drow_ranger_3"	"You die alone."
"dota_chatwheel_label_drow_ranger_3"	"You die alone."
"[english]dota_chatwheel_label_drow_ranger_3"	"You die alone."
"dota_chatwheel_message_drow_ranger_4"	"This couldn't have ended any other way."
"[english]dota_chatwheel_message_drow_ranger_4"	"This couldn't have ended any other way."
"dota_chatwheel_label_drow_ranger_4"	"This couldn't have ended..."
"[english]dota_chatwheel_label_drow_ranger_4"	"This couldn't have ended..."
"dota_chatwheel_message_drow_ranger_5"	"Now that you're dead, I find it easy to respect you."
"[english]dota_chatwheel_message_drow_ranger_5"	"Now that you're dead, I find it easy to respect you."
"dota_chatwheel_label_drow_ranger_5"	"Now that you're dead..."
"[english]dota_chatwheel_label_drow_ranger_5"	"Now that you're dead..."
"dota_chatwheel_message_earthshaker_laugh"	"Ha ha ha ha ha ha ha ha ha."
"[english]dota_chatwheel_message_earthshaker_laugh"	"Ha ha ha ha ha ha ha ha ha."
"dota_chatwheel_label_earthshaker_laugh"	"[大笑]"
"[english]dota_chatwheel_label_earthshaker_laugh"	"Laugh"
"dota_chatwheel_message_earthshaker_thank"	"Let's shake things up!"
"[english]dota_chatwheel_message_earthshaker_thank"	"Let's shake things up!"
"dota_chatwheel_label_earthshaker_thank"	"Let's shake things up!"
"[english]dota_chatwheel_label_earthshaker_thank"	"Let's shake things up!"
"dota_chatwheel_message_earthshaker_deny"	"Shocking..."
"[english]dota_chatwheel_message_earthshaker_deny"	"Shocking..."
"dota_chatwheel_label_earthshaker_deny"	"Shocking..."
"[english]dota_chatwheel_label_earthshaker_deny"	"Shocking..."
"dota_chatwheel_message_earthshaker_1"	"It was your own damn fault."
"[english]dota_chatwheel_message_earthshaker_1"	"It was your own damn fault."
"dota_chatwheel_label_earthshaker_1"	"It was your own damn fault."
"[english]dota_chatwheel_label_earthshaker_1"	"It was your own damn fault."
"dota_chatwheel_message_earthshaker_2"	"Whoa... Aftershocks..."
"[english]dota_chatwheel_message_earthshaker_2"	"Whoa... Aftershocks..."
"dota_chatwheel_label_earthshaker_2"	"Whoa... Aftershocks..."
"[english]dota_chatwheel_label_earthshaker_2"	"Whoa... Aftershocks..."
"dota_chatwheel_message_earthshaker_3"	"Slammin'...?"
"[english]dota_chatwheel_message_earthshaker_3"	"Slammin'...?"
"dota_chatwheel_label_earthshaker_3"	"Slammin'...?"
"[english]dota_chatwheel_label_earthshaker_3"	"Slammin'...?"
"dota_chatwheel_message_earthshaker_4"	"It was getting far too crowded."
"[english]dota_chatwheel_message_earthshaker_4"	"It was getting far too crowded."
"dota_chatwheel_label_earthshaker_4"	"It was getting far too crowded."
"[english]dota_chatwheel_label_earthshaker_4"	"It was getting far too crowded."
"dota_chatwheel_message_earthshaker_5"	"There may be many earths, but there's only one Earthshaker."
"[english]dota_chatwheel_message_earthshaker_5"	"There may be many earths, but there's only one Earthshaker."
"dota_chatwheel_label_earthshaker_5"	"There may be many earths..."
"[english]dota_chatwheel_label_earthshaker_5"	"There may be many earths..."
"dota_chatwheel_message_juggernaut_laugh"	"Ha ha ha ha ha!"
"[english]dota_chatwheel_message_juggernaut_laugh"	"Ha ha ha ha ha!"
"dota_chatwheel_label_juggernaut_laugh"	"[大笑]"
"[english]dota_chatwheel_label_juggernaut_laugh"	"Laugh"
"dota_chatwheel_message_juggernaut_thank"	"Oh that's nice."
"[english]dota_chatwheel_message_juggernaut_thank"	"Oh that's nice."
"dota_chatwheel_label_juggernaut_thank"	"Oh that's nice."
"[english]dota_chatwheel_label_juggernaut_thank"	"Oh that's nice."
"dota_chatwheel_message_juggernaut_deny"	"Hm, looking good."
"[english]dota_chatwheel_message_juggernaut_deny"	"Hm, looking good."
"dota_chatwheel_label_juggernaut_deny"	"Hm, looking good."
"[english]dota_chatwheel_label_juggernaut_deny"	"Hm, looking good."
"dota_chatwheel_message_juggernaut_1"	"You will be forever alone."
"[english]dota_chatwheel_message_juggernaut_1"	"You will be forever alone."
"dota_chatwheel_label_juggernaut_1"	"You will be forever alone."
"[english]dota_chatwheel_label_juggernaut_1"	"You will be forever alone."
"dota_chatwheel_message_juggernaut_2"	"It's all falling into place."
"[english]dota_chatwheel_message_juggernaut_2"	"It's all falling into place."
"dota_chatwheel_label_juggernaut_2"	"It's all falling into place."
"[english]dota_chatwheel_label_juggernaut_2"	"It's all falling into place."
"dota_chatwheel_message_juggernaut_3"	"I'll be back to finish this later."
"[english]dota_chatwheel_message_juggernaut_3"	"I'll be back to finish this later."
"dota_chatwheel_label_juggernaut_3"	"I'll be back to finish this later."
"[english]dota_chatwheel_label_juggernaut_3"	"I'll be back to finish this later."
"dota_chatwheel_message_juggernaut_4"	"There's a fine line between bravery and stupidity."
"[english]dota_chatwheel_message_juggernaut_4"	"There's a fine line between bravery and stupidity."
"dota_chatwheel_label_juggernaut_4"	"There's a fine line..."
"[english]dota_chatwheel_label_juggernaut_4"	"There's a fine line..."
"dota_chatwheel_message_juggernaut_5"	"Mm, snazzy."
"[english]dota_chatwheel_message_juggernaut_5"	"Mm, snazzy."
"dota_chatwheel_label_juggernaut_5"	"Mm, snazzy."
"[english]dota_chatwheel_label_juggernaut_5"	"Mm, snazzy."
"dota_chatwheel_message_mirana_laugh"	"Ha ha ha ha ha ha!"
"[english]dota_chatwheel_message_mirana_laugh"	"Ha ha ha ha ha ha!"
"dota_chatwheel_label_mirana_laugh"	"[大笑]"
"[english]dota_chatwheel_label_mirana_laugh"	"Laugh"
"dota_chatwheel_message_mirana_thank"	"A gift from the night!"
"[english]dota_chatwheel_message_mirana_thank"	"A gift from the night!"
"dota_chatwheel_label_mirana_thank"	"A gift from the night!"
"[english]dota_chatwheel_label_mirana_thank"	"A gift from the night!"
"dota_chatwheel_message_mirana_deny"	"Catch us if you can!"
"[english]dota_chatwheel_message_mirana_deny"	"Catch us if you can!"
"dota_chatwheel_label_mirana_deny"	"Catch us if you can!"
"[english]dota_chatwheel_label_mirana_deny"	"Catch us if you can!"
"dota_chatwheel_message_mirana_1"	"You have learned nothing."
"[english]dota_chatwheel_message_mirana_1"	"You have learned nothing."
"dota_chatwheel_label_mirana_1"	"You have learned nothing."
"[english]dota_chatwheel_label_mirana_1"	"You have learned nothing."
"dota_chatwheel_message_mirana_2"	"Nicely done!"
"[english]dota_chatwheel_message_mirana_2"	"Nicely done!"
"dota_chatwheel_label_mirana_2"	"Nicely done!"
"[english]dota_chatwheel_label_mirana_2"	"Nicely done!"
"dota_chatwheel_message_mirana_3"	"Run like the dogs you are!"
"[english]dota_chatwheel_message_mirana_3"	"Run like the dogs you are!"
"dota_chatwheel_label_mirana_3"	"Run like the dogs you are!"
"[english]dota_chatwheel_label_mirana_3"	"Run like the dogs you are!"
"dota_chatwheel_message_mirana_4"	"Here, kitty-kitty-kitty...."
"[english]dota_chatwheel_message_mirana_4"	"Here, kitty-kitty-kitty...."
"dota_chatwheel_label_mirana_4"	"Here, kitty-kitty-kitty...."
"[english]dota_chatwheel_label_mirana_4"	"Here, kitty-kitty-kitty...."
"dota_chatwheel_message_mirana_5"	"It was not luck but skill!"
"[english]dota_chatwheel_message_mirana_5"	"It was not luck but skill!"
"dota_chatwheel_label_mirana_5"	"It was not luck but skill!"
"[english]dota_chatwheel_label_mirana_5"	"It was not luck but skill!"
"dota_chatwheel_message_morphling_laugh"	"Ha ha ha ha ha ha ha ha ha ha!"
"[english]dota_chatwheel_message_morphling_laugh"	"Ha ha ha ha ha ha ha ha ha ha!"
"dota_chatwheel_label_morphling_laugh"	"[大笑]"
"[english]dota_chatwheel_label_morphling_laugh"	"Laugh"
"dota_chatwheel_message_morphling_thank"	"I like what I see."
"[english]dota_chatwheel_message_morphling_thank"	"I like what I see."
"dota_chatwheel_label_morphling_thank"	"I like what I see."
"[english]dota_chatwheel_label_morphling_thank"	"I like what I see."
"dota_chatwheel_message_morphling_deny"	"You're in over your head."
"[english]dota_chatwheel_message_morphling_deny"	"You're in over your head."
"dota_chatwheel_label_morphling_deny"	"You're in over your head."
"[english]dota_chatwheel_label_morphling_deny"	"You're in over your head."
"dota_chatwheel_message_morphling_1"	"Boiling rage!"
"[english]dota_chatwheel_message_morphling_1"	"Boiling rage!"
"dota_chatwheel_label_morphling_1"	"Boiling rage!"
"[english]dota_chatwheel_label_morphling_1"	"Boiling rage!"
"dota_chatwheel_message_morphling_2"	"Always refreshing."
"[english]dota_chatwheel_message_morphling_2"	"Always refreshing."
"dota_chatwheel_label_morphling_2"	"Always refreshing."
"[english]dota_chatwheel_label_morphling_2"	"Always refreshing."
"dota_chatwheel_message_morphling_3"	"The tide has turned!"
"[english]dota_chatwheel_message_morphling_3"	"The tide has turned!"
"dota_chatwheel_label_morphling_3"	"The tide has turned!"
"[english]dota_chatwheel_label_morphling_3"	"The tide has turned!"
"dota_chatwheel_message_morphling_4"	"Didn't you see me waving?"
"[english]dota_chatwheel_message_morphling_4"	"Didn't you see me waving?"
"dota_chatwheel_label_morphling_4"	"Didn't you see me waving?"
"[english]dota_chatwheel_label_morphling_4"	"Didn't you see me waving?"
"dota_chatwheel_message_morphling_5"	"You're washed up!"
"[english]dota_chatwheel_message_morphling_5"	"You're washed up!"
"dota_chatwheel_label_morphling_5"	"You're washed up!"
"[english]dota_chatwheel_label_morphling_5"	"You're washed up!"
"dota_chatwheel_message_nevermore_laugh"	"Ah ha ha ha ha ha!"
"[english]dota_chatwheel_message_nevermore_laugh"	"Ah ha ha ha ha ha!"
"dota_chatwheel_label_nevermore_laugh"	"[大笑]"
"[english]dota_chatwheel_label_nevermore_laugh"	"Laugh"
"dota_chatwheel_message_nevermore_thank"	"Well bless your soul."
"[english]dota_chatwheel_message_nevermore_thank"	"Well bless your soul."
"dota_chatwheel_label_nevermore_thank"	"Well bless your soul."
"[english]dota_chatwheel_label_nevermore_thank"	"Well bless your soul."
"dota_chatwheel_message_nevermore_deny"	"Outplayed."
"[english]dota_chatwheel_message_nevermore_deny"	"Outplayed."
"dota_chatwheel_label_nevermore_deny"	"Outplayed."
"[english]dota_chatwheel_label_nevermore_deny"	"Outplayed."
"dota_chatwheel_message_nevermore_1"	"A beautiful soul for my collection."
"[english]dota_chatwheel_message_nevermore_1"	"A beautiful soul for my collection."
"dota_chatwheel_label_nevermore_1"	"A beautiful soul for my collection."
"[english]dota_chatwheel_label_nevermore_1"	"A beautiful soul for my collection."
"dota_chatwheel_message_nevermore_2"	"Fear my presence."
"[english]dota_chatwheel_message_nevermore_2"	"Fear my presence."
"dota_chatwheel_label_nevermore_2"	"Fear my presence."
"[english]dota_chatwheel_label_nevermore_2"	"Fear my presence."
"dota_chatwheel_message_nevermore_3"	"I'll take it."
"[english]dota_chatwheel_message_nevermore_3"	"I'll take it."
"dota_chatwheel_label_nevermore_3"	"I'll take it."
"[english]dota_chatwheel_label_nevermore_3"	"I'll take it."
"dota_chatwheel_message_nevermore_4"	"You can never hide!"
"[english]dota_chatwheel_message_nevermore_4"	"You can never hide!"
"dota_chatwheel_label_nevermore_4"	"You can never hide!"
"[english]dota_chatwheel_label_nevermore_4"	"You can never hide!"
"dota_chatwheel_message_nevermore_5"	"Ozh icha gluth izh sol."
"[english]dota_chatwheel_message_nevermore_5"	"Ozh icha gluth izh sol."
"dota_chatwheel_label_nevermore_5"	"Ozh icha gluth izh sol."
"[english]dota_chatwheel_label_nevermore_5"	"Ozh icha gluth izh sol."
"dota_chatwheel_message_phantom_lancer_laugh"	"Ha ha ha ha ha ha ha ha ha ha ha ha ha!"
"[english]dota_chatwheel_message_phantom_lancer_laugh"	"Ha ha ha ha ha ha ha ha ha ha ha ha ha!"
"dota_chatwheel_label_phantom_lancer_laugh"	"[大笑]"
"[english]dota_chatwheel_label_phantom_lancer_laugh"	"Laugh"
"dota_chatwheel_message_phantom_lancer_thank"	"What an amazing thing."
"[english]dota_chatwheel_message_phantom_lancer_thank"	"What an amazing thing."
"dota_chatwheel_label_phantom_lancer_thank"	"What an amazing thing."
"[english]dota_chatwheel_label_phantom_lancer_thank"	"What an amazing thing."
"dota_chatwheel_message_phantom_lancer_deny"	"Such simple minds."
"[english]dota_chatwheel_message_phantom_lancer_deny"	"Such simple minds."
"dota_chatwheel_label_phantom_lancer_deny"	"Such simple minds."
"[english]dota_chatwheel_label_phantom_lancer_deny"	"Such simple minds."
"dota_chatwheel_message_phantom_lancer_1"	"We come for you!"
"[english]dota_chatwheel_message_phantom_lancer_1"	"We come for you!"
"dota_chatwheel_label_phantom_lancer_1"	"We come for you!"
"[english]dota_chatwheel_label_phantom_lancer_1"	"We come for you!"
"dota_chatwheel_message_phantom_lancer_2"	"Now this is just silly."
"[english]dota_chatwheel_message_phantom_lancer_2"	"Now this is just silly."
"dota_chatwheel_label_phantom_lancer_2"	"Now this is just silly."
"[english]dota_chatwheel_label_phantom_lancer_2"	"Now this is just silly."
"dota_chatwheel_message_phantom_lancer_3"	"We have more where that came from."
"[english]dota_chatwheel_message_phantom_lancer_3"	"We have more where that came from."
"dota_chatwheel_label_phantom_lancer_3"	"We have more where that came from."
"[english]dota_chatwheel_label_phantom_lancer_3"	"We have more where that came from."
"dota_chatwheel_message_phantom_lancer_4"	"Numbers have accomplished what strategy alone could not."
"[english]dota_chatwheel_message_phantom_lancer_4"	"Numbers have accomplished what strategy alone could not."
"dota_chatwheel_label_phantom_lancer_4"	"Numbers have accomplished..."
"[english]dota_chatwheel_label_phantom_lancer_4"	"Numbers have accomplished..."
"dota_chatwheel_message_phantom_lancer_5"	"We outnumbered you. We outnumber them all!"
"[english]dota_chatwheel_message_phantom_lancer_5"	"We outnumbered you. We outnumber them all!"
"dota_chatwheel_label_phantom_lancer_5"	"We outnumbered you..."
"[english]dota_chatwheel_label_phantom_lancer_5"	"We outnumbered you..."
"dota_chatwheel_message_puck_laugh"	"Ha ha!"
"[english]dota_chatwheel_message_puck_laugh"	"Ha ha!"
"dota_chatwheel_label_puck_laugh"	"[大笑]"
"[english]dota_chatwheel_label_puck_laugh"	"Laugh"
"dota_chatwheel_message_puck_thank"	"Interesting."
"[english]dota_chatwheel_message_puck_thank"	"Interesting."
"dota_chatwheel_label_puck_thank"	"Interesting."
"[english]dota_chatwheel_label_puck_thank"	"Interesting."
"dota_chatwheel_message_puck_deny"	"You might wish to retract your last move."
"[english]dota_chatwheel_message_puck_deny"	"You might wish to retract your last move."
"dota_chatwheel_label_puck_deny"	"You might wish to retract..."
"[english]dota_chatwheel_label_puck_deny"	"You might wish to retract..."
"dota_chatwheel_message_puck_1"	"Greetings!"
"[english]dota_chatwheel_message_puck_1"	"Greetings!"
"dota_chatwheel_label_puck_1"	"Greetings!"
"[english]dota_chatwheel_label_puck_1"	"Greetings!"
"dota_chatwheel_message_puck_2"	"What is this, a game of some sort?"
"[english]dota_chatwheel_message_puck_2"	"What is this, a game of some sort?"
"dota_chatwheel_label_puck_2"	"What is this, a game of some sort?"
"[english]dota_chatwheel_label_puck_2"	"What is this, a game of some sort?"
"dota_chatwheel_message_puck_3"	"The greatest tragedy of our eon."
"[english]dota_chatwheel_message_puck_3"	"The greatest tragedy of our eon."
"dota_chatwheel_label_puck_3"	"The greatest tragedy of our eon."
"[english]dota_chatwheel_label_puck_3"	"The greatest tragedy of our eon."
"dota_chatwheel_message_puck_4"	"Was that smart?"
"[english]dota_chatwheel_message_puck_4"	"Was that smart?"
"dota_chatwheel_label_puck_4"	"Was that smart?"
"[english]dota_chatwheel_label_puck_4"	"Was that smart?"
"dota_chatwheel_message_puck_5"	"I am unfamiliar with this feeling. Is it joy?"
"[english]dota_chatwheel_message_puck_5"	"I am unfamiliar with this feeling. Is it joy?"
"dota_chatwheel_label_puck_5"	"I am unfamiliar with this feeling..."
"[english]dota_chatwheel_label_puck_5"	"I am unfamiliar with this feeling..."
"dota_chatwheel_message_pudge_laugh"	"Hm hm hm hm ha ha ha."
"[english]dota_chatwheel_message_pudge_laugh"	"Hm hm hm hm ha ha ha."
"dota_chatwheel_label_pudge_laugh"	"[大笑]"
"[english]dota_chatwheel_label_pudge_laugh"	"Laugh"
"dota_chatwheel_message_pudge_thank"	"That's a bit of all right."
"[english]dota_chatwheel_message_pudge_thank"	"That's a bit of all right."
"dota_chatwheel_label_pudge_thank"	"That's a bit of all right."
"[english]dota_chatwheel_label_pudge_thank"	"That's a bit of all right."
"dota_chatwheel_message_pudge_deny"	"Oops. Was that me?"
"[english]dota_chatwheel_message_pudge_deny"	"Oops. Was that me?"
"dota_chatwheel_label_pudge_deny"	"Oops. Was that me?"
"[english]dota_chatwheel_label_pudge_deny"	"Oops. Was that me?"
"dota_chatwheel_message_pudge_1"	"Time for a little butchery!"
"[english]dota_chatwheel_message_pudge_1"	"Time for a little butchery!"
"dota_chatwheel_label_pudge_1"	"Time for a little butchery!"
"[english]dota_chatwheel_label_pudge_1"	"Time for a little butchery!"
"dota_chatwheel_message_pudge_2"	"Nothing better than a nice raw liver."
"[english]dota_chatwheel_message_pudge_2"	"Nothing better than a nice raw liver."
"dota_chatwheel_label_pudge_2"	"Nothing better than a nice raw liver."
"[english]dota_chatwheel_label_pudge_2"	"Nothing better than a nice raw liver."
"dota_chatwheel_message_pudge_3"	"Whateva."
"[english]dota_chatwheel_message_pudge_3"	"Whateva."
"dota_chatwheel_label_pudge_3"	"Whateva."
"[english]dota_chatwheel_label_pudge_3"	"Whateva."
"dota_chatwheel_message_pudge_4"	"Delicious..."
"[english]dota_chatwheel_message_pudge_4"	"Delicious..."
"dota_chatwheel_label_pudge_4"	"Delicious..."
"[english]dota_chatwheel_label_pudge_4"	"Delicious..."
"dota_chatwheel_message_pudge_5"	"You'll look good with an apple in yer mouth!"
"[english]dota_chatwheel_message_pudge_5"	"You'll look good with an apple in yer mouth!"
"dota_chatwheel_label_pudge_5"	"You'll look good with..."
"[english]dota_chatwheel_label_pudge_5"	"You'll look good with..."
"dota_chatwheel_message_razor_laugh"	"Ah ha ha ha ha ha ha ha ha."
"[english]dota_chatwheel_message_razor_laugh"	"Ah ha ha ha ha ha ha ha ha."
"dota_chatwheel_label_razor_laugh"	"[大笑]"
"[english]dota_chatwheel_label_razor_laugh"	"Laugh"
"dota_chatwheel_message_razor_thank"	"I sense a connection between us!"
"[english]dota_chatwheel_message_razor_thank"	"I sense a connection between us!"
"dota_chatwheel_label_razor_thank"	"I sense a connection between us!"
"[english]dota_chatwheel_label_razor_thank"	"I sense a connection between us!"
"dota_chatwheel_message_razor_deny"	"You can run. You should run."
"[english]dota_chatwheel_message_razor_deny"	"You can run. You should run."
"dota_chatwheel_label_razor_deny"	"You can run. You should run."
"[english]dota_chatwheel_label_razor_deny"	"You can run. You should run."
"dota_chatwheel_message_razor_1"	"You are dead. Dead."
"[english]dota_chatwheel_message_razor_1"	"You are dead. Dead."
"dota_chatwheel_label_razor_1"	"You are dead. Dead."
"[english]dota_chatwheel_label_razor_1"	"You are dead. Dead."
"dota_chatwheel_message_razor_2"	"Your ashes will fall like rain."
"[english]dota_chatwheel_message_razor_2"	"Your ashes will fall like rain."
"dota_chatwheel_label_razor_2"	"Your ashes will fall like rain."
"[english]dota_chatwheel_label_razor_2"	"Your ashes will fall like rain."
"dota_chatwheel_message_razor_3"	"Shocking."
"[english]dota_chatwheel_message_razor_3"	"Shocking."
"dota_chatwheel_label_razor_3"	"Shocking."
"[english]dota_chatwheel_label_razor_3"	"Shocking."
"dota_chatwheel_message_razor_4"	"This will only hurt forever."
"[english]dota_chatwheel_message_razor_4"	"This will only hurt forever."
"dota_chatwheel_label_razor_4"	"This will only hurt forever."
"[english]dota_chatwheel_label_razor_4"	"This will only hurt forever."
"dota_chatwheel_message_razor_5"	"Zapped your ass!"
"[english]dota_chatwheel_message_razor_5"	"Zapped your ass!"
"dota_chatwheel_label_razor_5"	"Zapped your ass!"
"[english]dota_chatwheel_label_razor_5"	"Zapped your ass!"
"dota_chatwheel_message_sand_king_laugh"	"Ha ha ha ha ha ha ha!"
"[english]dota_chatwheel_message_sand_king_laugh"	"Ha ha ha ha ha ha ha!"
"dota_chatwheel_label_sand_king_laugh"	"[大笑]"
"[english]dota_chatwheel_label_sand_king_laugh"	"Laugh"
"dota_chatwheel_message_sand_king_thank"	"You have done a great service."
"[english]dota_chatwheel_message_sand_king_thank"	"You have done a great service."
"dota_chatwheel_label_sand_king_thank"	"You have done a great service."
"[english]dota_chatwheel_label_sand_king_thank"	"You have done a great service."
"dota_chatwheel_message_sand_king_deny"	"Stings, don't it?"
"[english]dota_chatwheel_message_sand_king_deny"	"Stings, don't it?"
"dota_chatwheel_label_sand_king_deny"	"Stings, don't it?"
"[english]dota_chatwheel_label_sand_king_deny"	"Stings, don't it?"
"dota_chatwheel_message_sand_king_1"	"Bow to your liege."
"[english]dota_chatwheel_message_sand_king_1"	"Bow to your liege."
"dota_chatwheel_label_sand_king_1"	"Bow to your liege."
"[english]dota_chatwheel_label_sand_king_1"	"Bow to your liege."
"dota_chatwheel_message_sand_king_2"	"A Sandy V-V-Victory!"
"[english]dota_chatwheel_message_sand_king_2"	"A Sandy V-V-Victory!"
"dota_chatwheel_label_sand_king_2"	"A Sandy V-V-Victory!"
"[english]dota_chatwheel_label_sand_king_2"	"A Sandy V-V-Victory!"
"dota_chatwheel_message_sand_king_3"	"Where do you think you're going?"
"[english]dota_chatwheel_message_sand_king_3"	"Where do you think you're going?"
"dota_chatwheel_label_sand_king_3"	"Where do you think you're going?"
"[english]dota_chatwheel_label_sand_king_3"	"Where do you think you're going?"
"dota_chatwheel_message_sand_king_4"	"You were expecting...Sandy Claws?"
"[english]dota_chatwheel_message_sand_king_4"	"You were expecting...Sandy Claws?"
"dota_chatwheel_label_sand_king_4"	"You were expecting Sandy Claws?"
"[english]dota_chatwheel_label_sand_king_4"	"You were expecting Sandy Claws?"
"dota_chatwheel_message_sand_king_5"	"It's good to be King!"
"[english]dota_chatwheel_message_sand_king_5"	"It's good to be King!"
"dota_chatwheel_label_sand_king_5"	"It's good to be King"
"[english]dota_chatwheel_label_sand_king_5"	"It's good to be King"
"dota_chatwheel_message_storm_spirit_laugh"	"Hm hm hm hm hee hee hee ha ha."
"[english]dota_chatwheel_message_storm_spirit_laugh"	"Hm hm hm hm hee hee hee ha ha."
"dota_chatwheel_label_storm_spirit_laugh"	"[大笑]"
"[english]dota_chatwheel_label_storm_spirit_laugh"	"Laugh"
"dota_chatwheel_message_storm_spirit_thank"	"That's the spirit!"
"[english]dota_chatwheel_message_storm_spirit_thank"	"That's the spirit!"
"dota_chatwheel_label_storm_spirit_thank"	"That's the spirit!"
"[english]dota_chatwheel_label_storm_spirit_thank"	"That's the spirit!"
"dota_chatwheel_message_storm_spirit_deny"	"You blew it!"
"[english]dota_chatwheel_message_storm_spirit_deny"	"You blew it!"
"dota_chatwheel_label_storm_spirit_deny"	"You blew it!"
"[english]dota_chatwheel_label_storm_spirit_deny"	"You blew it!"
"dota_chatwheel_message_storm_spirit_1"	"I love this part!"
"[english]dota_chatwheel_message_storm_spirit_1"	"I love this part!"
"dota_chatwheel_label_storm_spirit_1"	"I love this part!"
"[english]dota_chatwheel_label_storm_spirit_1"	"I love this part!"
"dota_chatwheel_message_storm_spirit_2"	"Lookin for me?"
"[english]dota_chatwheel_message_storm_spirit_2"	"Lookin for me?"
"dota_chatwheel_label_storm_spirit_2"	"Lookin for me?"
"[english]dota_chatwheel_label_storm_spirit_2"	"Lookin for me?"
"dota_chatwheel_message_storm_spirit_3"	"Told you a storm was coming!"
"[english]dota_chatwheel_message_storm_spirit_3"	"Told you a storm was coming!"
"dota_chatwheel_label_storm_spirit_3"	"Told you a storm was coming!"
"[english]dota_chatwheel_label_storm_spirit_3"	"Told you a storm was coming!"
"dota_chatwheel_message_storm_spirit_4"	"Looking good!"
"[english]dota_chatwheel_message_storm_spirit_4"	"Looking good!"
"dota_chatwheel_label_storm_spirit_4"	"Looking good!"
"[english]dota_chatwheel_label_storm_spirit_4"	"Looking good!"
"dota_chatwheel_message_storm_spirit_5"	"Glorious!"
"[english]dota_chatwheel_message_storm_spirit_5"	"Glorious!"
"dota_chatwheel_label_storm_spirit_5"	"Glorious!"
"[english]dota_chatwheel_label_storm_spirit_5"	"Glorious!"
"dota_chatwheel_message_sven_laugh"	"Ahh ha ha ha! Ha ha ha ha!"
"[english]dota_chatwheel_message_sven_laugh"	"Ahh ha ha ha! Ha ha ha ha!"
"dota_chatwheel_label_sven_laugh"	"[大笑]"
"[english]dota_chatwheel_label_sven_laugh"	"Laugh"
"dota_chatwheel_message_sven_thank"	"You are a true friend."
"[english]dota_chatwheel_message_sven_thank"	"You are a true friend."
"dota_chatwheel_label_sven_thank"	"You are a true friend."
"[english]dota_chatwheel_label_sven_thank"	"You are a true friend."
"dota_chatwheel_message_sven_deny"	"You look stunned."
"[english]dota_chatwheel_message_sven_deny"	"You look stunned."
"dota_chatwheel_label_sven_deny"	"You look stunned."
"[english]dota_chatwheel_label_sven_deny"	"You look stunned."
"dota_chatwheel_message_sven_1"	"Rogue Knight claims another."
"[english]dota_chatwheel_message_sven_1"	"Rogue Knight claims another."
"dota_chatwheel_label_sven_1"	"Rogue Knight claims another."
"[english]dota_chatwheel_label_sven_1"	"Rogue Knight claims another."
"dota_chatwheel_message_sven_2"	"You deserved it."
"[english]dota_chatwheel_message_sven_2"	"You deserved it."
"dota_chatwheel_label_sven_2"	"You deserved it."
"[english]dota_chatwheel_label_sven_2"	"You deserved it."
"dota_chatwheel_message_sven_3"	"My honor compels me...to gloat."
"[english]dota_chatwheel_message_sven_3"	"My honor compels me...to gloat."
"dota_chatwheel_label_sven_3"	"My honor compels me...to gloat."
"[english]dota_chatwheel_label_sven_3"	"My honor compels me...to gloat."
"dota_chatwheel_message_sven_4"	"An expected outcome."
"[english]dota_chatwheel_message_sven_4"	"An expected outcome."
"dota_chatwheel_label_sven_4"	"An expected outcome."
"[english]dota_chatwheel_label_sven_4"	"An expected outcome."
"dota_chatwheel_message_sven_5"	"Hm...now what do we learn from this."
"[english]dota_chatwheel_message_sven_5"	"Hm...now what do we learn from this."
"dota_chatwheel_label_sven_5"	"Hm...now what do we learn from this."
"[english]dota_chatwheel_label_sven_5"	"Hm...now what do we learn from this."
"dota_chatwheel_message_tiny_laugh"	"Hehehehehuhhehehe."
"[english]dota_chatwheel_message_tiny_laugh"	"Hehehehehuhhehehe."
"dota_chatwheel_label_tiny_laugh"	"[大笑]"
"[english]dota_chatwheel_label_tiny_laugh"	"Laugh"
"dota_chatwheel_message_tiny_thank"	"Are you ready to rubble?"
"[english]dota_chatwheel_message_tiny_thank"	"Are you ready to rubble?"
"dota_chatwheel_label_tiny_thank"	"Are you ready to rubble?"
"[english]dota_chatwheel_label_tiny_thank"	"Are you ready to rubble?"
"dota_chatwheel_message_tiny_deny"	"Well, look at that."
"[english]dota_chatwheel_message_tiny_deny"	"Well, look at that."
"dota_chatwheel_label_tiny_deny"	"Well, look at that."
"[english]dota_chatwheel_label_tiny_deny"	"Well, look at that."
"dota_chatwheel_message_tiny_1"	"Rock em, sock em!"
"[english]dota_chatwheel_message_tiny_1"	"Rock em, sock em!"
"dota_chatwheel_label_tiny_1"	"Rock em, sock em!"
"[english]dota_chatwheel_label_tiny_1"	"Rock em, sock em!"
"dota_chatwheel_message_tiny_2"	"You got rocks in your head."
"[english]dota_chatwheel_message_tiny_2"	"You got rocks in your head."
"dota_chatwheel_label_tiny_2"	"You got rocks in your head."
"[english]dota_chatwheel_label_tiny_2"	"You got rocks in your head."
"dota_chatwheel_message_tiny_3"	"My apologies."
"[english]dota_chatwheel_message_tiny_3"	"My apologies."
"dota_chatwheel_label_tiny_3"	"My apologies."
"[english]dota_chatwheel_label_tiny_3"	"My apologies."
"dota_chatwheel_message_tiny_4"	"You haven't got the stones."
"[english]dota_chatwheel_message_tiny_4"	"You haven't got the stones."
"dota_chatwheel_label_tiny_4"	"You haven't got the stones."
"[english]dota_chatwheel_label_tiny_4"	"You haven't got the stones."
"dota_chatwheel_message_tiny_5"	"It's hard to be this good."
"[english]dota_chatwheel_message_tiny_5"	"It's hard to be this good."
"dota_chatwheel_label_tiny_5"	"It's hard to be this good."
"[english]dota_chatwheel_label_tiny_5"	"It's hard to be this good."
"dota_chatwheel_message_vengefulspirit_laugh"	"Hm ha ha ha ha ha ha!"
"[english]dota_chatwheel_message_vengefulspirit_laugh"	"Hm ha ha ha ha ha ha!"
"dota_chatwheel_label_vengefulspirit_laugh"	"[大笑]"
"[english]dota_chatwheel_label_vengefulspirit_laugh"	"Laugh"
"dota_chatwheel_message_vengefulspirit_thank"	"So sweet..."
"[english]dota_chatwheel_message_vengefulspirit_thank"	"So sweet..."
"dota_chatwheel_label_vengefulspirit_thank"	"So sweet..."
"[english]dota_chatwheel_label_vengefulspirit_thank"	"So sweet..."
"dota_chatwheel_message_vengefulspirit_deny"	"What...?"
"[english]dota_chatwheel_message_vengefulspirit_deny"	"What...?"
"dota_chatwheel_label_vengefulspirit_deny"	"What...?"
"[english]dota_chatwheel_label_vengefulspirit_deny"	"What...?"
"dota_chatwheel_message_vengefulspirit_1"	"I feel better already."
"[english]dota_chatwheel_message_vengefulspirit_1"	"I feel better already."
"dota_chatwheel_label_vengefulspirit_1"	"I feel better already."
"[english]dota_chatwheel_label_vengefulspirit_1"	"I feel better already."
"dota_chatwheel_message_vengefulspirit_2"	"Swapsies!"
"[english]dota_chatwheel_message_vengefulspirit_2"	"Swapsies!"
"dota_chatwheel_label_vengefulspirit_2"	"Swapsies!"
"[english]dota_chatwheel_label_vengefulspirit_2"	"Swapsies!"
"dota_chatwheel_message_vengefulspirit_3"	"Mwahahhahahahahahaha!"
"[english]dota_chatwheel_message_vengefulspirit_3"	"Mwahahhahahahahahaha!"
"dota_chatwheel_label_vengefulspirit_3"	"Mwahahhahahahahahaha!"
"[english]dota_chatwheel_label_vengefulspirit_3"	"Mwahahhahahahahahaha!"
"dota_chatwheel_message_vengefulspirit_4"	"Prepare for the wave of terror: boo!"
"[english]dota_chatwheel_message_vengefulspirit_4"	"Prepare for the wave of terror: boo!"
"dota_chatwheel_label_vengefulspirit_4"	"Prepare for the wave of terror: boo!"
"[english]dota_chatwheel_label_vengefulspirit_4"	"Prepare for the wave of terror: boo!"
"dota_chatwheel_message_vengefulspirit_5"	"The pain of my enemies is the only pleasure left to me."
"[english]dota_chatwheel_message_vengefulspirit_5"	"The pain of my enemies is the only pleasure left to me."
"dota_chatwheel_label_vengefulspirit_5"	"The pain of my enemies..."
"[english]dota_chatwheel_label_vengefulspirit_5"	"The pain of my enemies..."
"dota_chatwheel_message_windrunner_laugh"	"Hah-ha-ha-ha-ha!"
"[english]dota_chatwheel_message_windrunner_laugh"	"Hah-ha-ha-ha-ha!"
"dota_chatwheel_label_windrunner_laugh"	"[大笑]"
"[english]dota_chatwheel_label_windrunner_laugh"	"Laugh"
"dota_chatwheel_message_windrunner_thank"	"Easy breezy"
"[english]dota_chatwheel_message_windrunner_thank"	"Easy breezy"
"dota_chatwheel_label_windrunner_thank"	"Easy breezy"
"[english]dota_chatwheel_label_windrunner_thank"	"Easy breezy"
"dota_chatwheel_message_windrunner_deny"	"I don't think so."
"[english]dota_chatwheel_message_windrunner_deny"	"I don't think so."
"dota_chatwheel_label_windrunner_deny"	"I don't think so."
"[english]dota_chatwheel_label_windrunner_deny"	"I don't think so."
"dota_chatwheel_message_windrunner_1"	"Could be worse. Oh, wait, no it couldn't."
"[english]dota_chatwheel_message_windrunner_1"	"Could be worse. Oh, wait, no it couldn't."
"dota_chatwheel_label_windrunner_1"	"Could be worse..."
"[english]dota_chatwheel_label_windrunner_1"	"Could be worse..."
"dota_chatwheel_message_windrunner_2"	"You're not going anywhere."
"[english]dota_chatwheel_message_windrunner_2"	"You're not going anywhere."
"dota_chatwheel_label_windrunner_2"	"You're not going anywhere."
"[english]dota_chatwheel_label_windrunner_2"	"You're not going anywhere."
"dota_chatwheel_message_windrunner_3"	"If you weren't so damned dead, I'd shoot you again."
"[english]dota_chatwheel_message_windrunner_3"	"If you weren't so damned dead, I'd shoot you again."
"dota_chatwheel_label_windrunner_3"	"If you weren't so damned dead..."
"[english]dota_chatwheel_label_windrunner_3"	"If you weren't so damned dead..."
"dota_chatwheel_message_windrunner_4"	"Tell me this did not just happen."
"[english]dota_chatwheel_message_windrunner_4"	"Tell me this did not just happen."
"dota_chatwheel_label_windrunner_4"	"Tell me this did not just happen."
"[english]dota_chatwheel_label_windrunner_4"	"Tell me this did not just happen."
"dota_chatwheel_message_windrunner_5"	"I blow you a kiss."
"[english]dota_chatwheel_message_windrunner_5"	"I blow you a kiss."
"dota_chatwheel_label_windrunner_5"	"I blow you a kiss."
"[english]dota_chatwheel_label_windrunner_5"	"I blow you a kiss."
"dota_chatwheel_message_zuus_laugh"	"Ha ha ha ha ha ha ha ha ha!"
"[english]dota_chatwheel_message_zuus_laugh"	"Ha ha ha ha ha ha ha ha ha!"
"dota_chatwheel_label_zuus_laugh"	"[大笑]"
"[english]dota_chatwheel_label_zuus_laugh"	"Laugh"
"dota_chatwheel_message_zuus_thank"	"By my whiskers, that's good stuff!"
"[english]dota_chatwheel_message_zuus_thank"	"By my whiskers, that's good stuff!"
"dota_chatwheel_label_zuus_thank"	"That's good stuff!"
"[english]dota_chatwheel_label_zuus_thank"	"That's good stuff!"
"dota_chatwheel_message_zuus_deny"	"Ha ha ha ha ha. Well what did you expect?"
"[english]dota_chatwheel_message_zuus_deny"	"Ha ha ha ha ha. Well what did you expect?"
"dota_chatwheel_label_zuus_deny"	"Well what did you expect?"
"[english]dota_chatwheel_label_zuus_deny"	"Well what did you expect?"
"dota_chatwheel_message_zuus_1"	"Wait for it!"
"[english]dota_chatwheel_message_zuus_1"	"Wait for it!"
"dota_chatwheel_label_zuus_1"	"Wait for it!"
"[english]dota_chatwheel_label_zuus_1"	"Wait for it!"
"dota_chatwheel_message_zuus_2"	"That's all it takes to kill you?"
"[english]dota_chatwheel_message_zuus_2"	"That's all it takes to kill you?"
"dota_chatwheel_label_zuus_2"	"That's all it takes..?"
"[english]dota_chatwheel_label_zuus_2"	"That's all it takes..?"
"dota_chatwheel_message_zuus_3"	"Oh...this can't be good."
"[english]dota_chatwheel_message_zuus_3"	"Oh...this can't be good."
"dota_chatwheel_label_zuus_3"	"This can't be good"
"[english]dota_chatwheel_label_zuus_3"	"This can't be good"
"dota_chatwheel_message_zuus_4"	"Thund'rous applause!"
"[english]dota_chatwheel_message_zuus_4"	"Thund'rous applause!"
"dota_chatwheel_label_zuus_4"	"Thund'rous applause!"
"[english]dota_chatwheel_label_zuus_4"	"Thund'rous applause!"
"dota_chatwheel_message_zuus_5"	"Did you think you could hide from a god?"
"[english]dota_chatwheel_message_zuus_5"	"Did you think you could hide from a god?"
"dota_chatwheel_label_zuus_5"	"Did you think you could hide?"
"[english]dota_chatwheel_label_zuus_5"	"Did you think you could hide?"
"dota_chatwheel_message_kunkka_laugh"	"He-hu-hu-hu-hu-huhhuha!"
"[english]dota_chatwheel_message_kunkka_laugh"	"He-hu-hu-hu-hu-huhhuha!"
"dota_chatwheel_label_kunkka_laugh"	"[大笑]"
"[english]dota_chatwheel_label_kunkka_laugh"	"Laugh"
"dota_chatwheel_message_kunkka_thank"	"You're a trusty mate!"
"[english]dota_chatwheel_message_kunkka_thank"	"You're a trusty mate!"
"dota_chatwheel_label_kunkka_thank"	"You're a trusty mate!"
"[english]dota_chatwheel_label_kunkka_thank"	"You're a trusty mate!"
"dota_chatwheel_message_kunkka_deny"	"Straight to the bottom with ya!"
"[english]dota_chatwheel_message_kunkka_deny"	"Straight to the bottom with ya!"
"dota_chatwheel_label_kunkka_deny"	"Straight to the bottom with ya!"
"[english]dota_chatwheel_label_kunkka_deny"	"Straight to the bottom with ya!"
"dota_chatwheel_message_kunkka_1"	"You don't have the sand."
"[english]dota_chatwheel_message_kunkka_1"	"You don't have the sand."
"dota_chatwheel_label_kunkka_1"	"You don't have the sand."
"[english]dota_chatwheel_label_kunkka_1"	"You don't have the sand."
"dota_chatwheel_message_kunkka_2"	"Heh! Man overboard!"
"[english]dota_chatwheel_message_kunkka_2"	"Heh! Man overboard!"
"dota_chatwheel_label_kunkka_2"	"Heh! Man overboard!"
"[english]dota_chatwheel_label_kunkka_2"	"Heh! Man overboard!"
"dota_chatwheel_message_kunkka_3"	"You're all washed up!"
"[english]dota_chatwheel_message_kunkka_3"	"You're all washed up!"
"dota_chatwheel_label_kunkka_3"	"You're all washed up!"
"[english]dota_chatwheel_label_kunkka_3"	"You're all washed up!"
"dota_chatwheel_message_kunkka_4"	"Just to be clear, if I call you mate, I don't mean it literally."
"[english]dota_chatwheel_message_kunkka_4"	"Just to be clear, if I call you mate, I don't mean it literally."
"dota_chatwheel_label_kunkka_4"	"Just to be clear..."
"[english]dota_chatwheel_label_kunkka_4"	"Just to be clear..."
"dota_chatwheel_message_kunkka_5"	"You set sail for fail."
"[english]dota_chatwheel_message_kunkka_5"	"You set sail for fail."
"dota_chatwheel_label_kunkka_5"	"You set sail for fail."
"[english]dota_chatwheel_label_kunkka_5"	"You set sail for fail."
"dota_chatwheel_message_lina_laugh"	"Ha ha ha ha ha ha ha!"
"[english]dota_chatwheel_message_lina_laugh"	"Ha ha ha ha ha ha ha!"
"dota_chatwheel_label_lina_laugh"	"[大笑]"
"[english]dota_chatwheel_label_lina_laugh"	"Laugh"
"dota_chatwheel_message_lina_thank"	"That was hot!"
"[english]dota_chatwheel_message_lina_thank"	"That was hot!"
"dota_chatwheel_label_lina_thank"	"That was hot!"
"[english]dota_chatwheel_label_lina_thank"	"That was hot!"
"dota_chatwheel_message_lina_deny"	"Burns, doesn't it?"
"[english]dota_chatwheel_message_lina_deny"	"Burns, doesn't it?"
"dota_chatwheel_label_lina_deny"	"Burns, doesn't it?"
"[english]dota_chatwheel_label_lina_deny"	"Burns, doesn't it?"
"dota_chatwheel_message_lina_1"	"That wasn't too bright."
"[english]dota_chatwheel_message_lina_1"	"That wasn't too bright."
"dota_chatwheel_label_lina_1"	"That wasn't too bright."
"[english]dota_chatwheel_label_lina_1"	"That wasn't too bright."
"dota_chatwheel_message_lina_2"	"Wanna play with fire?"
"[english]dota_chatwheel_message_lina_2"	"Wanna play with fire?"
"dota_chatwheel_label_lina_2"	"Wanna play with fire?"
"[english]dota_chatwheel_label_lina_2"	"Wanna play with fire?"
"dota_chatwheel_message_lina_3"	"What a punk."
"[english]dota_chatwheel_message_lina_3"	"What a punk."
"dota_chatwheel_label_lina_3"	"What a punk."
"[english]dota_chatwheel_label_lina_3"	"What a punk."
"dota_chatwheel_message_lina_4"	"What in the blazes?"
"[english]dota_chatwheel_message_lina_4"	"What in the blazes?"
"dota_chatwheel_label_lina_4"	"What in the blazes?"
"[english]dota_chatwheel_label_lina_4"	"What in the blazes?"
"dota_chatwheel_message_lina_5"	"Come to mama!"
"[english]dota_chatwheel_message_lina_5"	"Come to mama!"
"dota_chatwheel_label_lina_5"	"Come to mama!"
"[english]dota_chatwheel_label_lina_5"	"Come to mama!"
"dota_chatwheel_message_lion_laugh"	"Who-ha-ha-ha-ha-ha-ha-he-hawha!"
"[english]dota_chatwheel_message_lion_laugh"	"Who-ha-ha-ha-ha-ha-ha-he-hawha!"
"dota_chatwheel_label_lion_laugh"	"[大笑]"
"[english]dota_chatwheel_label_lion_laugh"	"Laugh"
"dota_chatwheel_message_lion_thank"	"Oh, hell yes."
"[english]dota_chatwheel_message_lion_thank"	"Oh, hell yes."
"dota_chatwheel_label_lion_thank"	"Oh, hell yes."
"[english]dota_chatwheel_label_lion_thank"	"Oh, hell yes."
"dota_chatwheel_message_lion_deny"	"Ah, sorry to disappoint you."
"[english]dota_chatwheel_message_lion_deny"	"Ah, sorry to disappoint you."
"dota_chatwheel_label_lion_deny"	"Ah, sorry to disappoint you."
"[english]dota_chatwheel_label_lion_deny"	"Ah, sorry to disappoint you."
"dota_chatwheel_message_lion_1"	"You thought to tame the lion?"
"[english]dota_chatwheel_message_lion_1"	"You thought to tame the lion?"
"dota_chatwheel_label_lion_1"	"You thought to tame the lion?"
"[english]dota_chatwheel_label_lion_1"	"You thought to tame the lion?"
"dota_chatwheel_message_lion_2"	"Feel the rage of a mage!"
"[english]dota_chatwheel_message_lion_2"	"Feel the rage of a mage!"
"dota_chatwheel_label_lion_2"	"Feel the rage of a mage!"
"[english]dota_chatwheel_label_lion_2"	"Feel the rage of a mage!"
"dota_chatwheel_message_lion_3"	"To hell with you!"
"[english]dota_chatwheel_message_lion_3"	"To hell with you!"
"dota_chatwheel_label_lion_3"	"To hell with you!"
"[english]dota_chatwheel_label_lion_3"	"To hell with you!"
"dota_chatwheel_message_lion_4"	"I've got the magic touch."
"[english]dota_chatwheel_message_lion_4"	"I've got the magic touch."
"dota_chatwheel_label_lion_4"	"I've got the magic touch."
"[english]dota_chatwheel_label_lion_4"	"I've got the magic touch."
"dota_chatwheel_message_lion_5"	"I've been to hell and back, and back to hell...and back."
"[english]dota_chatwheel_message_lion_5"	"I've been to hell and back, and back to hell...and back."
"dota_chatwheel_label_lion_5"	"I've been to hell and back..."
"[english]dota_chatwheel_label_lion_5"	"I've been to hell and back..."
"dota_chatwheel_message_shadow_shaman_laugh"	"Ha ha ha!"
"[english]dota_chatwheel_message_shadow_shaman_laugh"	"Ha ha ha!"
"dota_chatwheel_label_shadow_shaman_laugh"	"[大笑]"
"[english]dota_chatwheel_label_shadow_shaman_laugh"	"Laugh"
"dota_chatwheel_message_shadow_shaman_thank"	"My prayers are answered."
"[english]dota_chatwheel_message_shadow_shaman_thank"	"My prayers are answered."
"dota_chatwheel_label_shadow_shaman_thank"	"My prayers are answered."
"[english]dota_chatwheel_label_shadow_shaman_thank"	"My prayers are answered."
"dota_chatwheel_message_shadow_shaman_deny"	"Bukaw, bukaw!"
"[english]dota_chatwheel_message_shadow_shaman_deny"	"Bukaw, bukaw!"
"dota_chatwheel_label_shadow_shaman_deny"	"Bukaw, bukaw!"
"[english]dota_chatwheel_label_shadow_shaman_deny"	"Bukaw, bukaw!"
"dota_chatwheel_message_shadow_shaman_1"	"I see for you a future full of death!"
"[english]dota_chatwheel_message_shadow_shaman_1"	"I see for you a future full of death!"
"dota_chatwheel_label_shadow_shaman_1"	"I see for you a future..."
"[english]dota_chatwheel_label_shadow_shaman_1"	"I see for you a future..."
"dota_chatwheel_message_shadow_shaman_2"	"You're not going anywhere."
"[english]dota_chatwheel_message_shadow_shaman_2"	"You're not going anywhere."
"dota_chatwheel_label_shadow_shaman_2"	"You're not going anywhere."
"[english]dota_chatwheel_label_shadow_shaman_2"	"You're not going anywhere."
"dota_chatwheel_message_shadow_shaman_3"	"Heh ha ha hah, how refreshing!"
"[english]dota_chatwheel_message_shadow_shaman_3"	"Heh ha ha hah, how refreshing!"
"dota_chatwheel_label_shadow_shaman_3"	"Heh ha ha hah, how refreshing!"
"[english]dota_chatwheel_label_shadow_shaman_3"	"Heh ha ha hah, how refreshing!"
"dota_chatwheel_message_shadow_shaman_4"	"Tastes like chicken!"
"[english]dota_chatwheel_message_shadow_shaman_4"	"Tastes like chicken!"
"dota_chatwheel_label_shadow_shaman_4"	"Tastes like chicken!"
"[english]dota_chatwheel_label_shadow_shaman_4"	"Tastes like chicken!"
"dota_chatwheel_message_shadow_shaman_5"	"Au-mosu-atikanu!"
"[english]dota_chatwheel_message_shadow_shaman_5"	"Au-mosu-atikanu!"
"dota_chatwheel_label_shadow_shaman_5"	"Au-mosu-atikanu!"
"[english]dota_chatwheel_label_shadow_shaman_5"	"Au-mosu-atikanu!"
"dota_chatwheel_message_slardar_laugh"	"Heh heeh heh hah hah ha hah hah!"
"[english]dota_chatwheel_message_slardar_laugh"	"Heh heeh heh hah hah ha hah hah!"
"dota_chatwheel_label_slardar_laugh"	"[大笑]"
"[english]dota_chatwheel_label_slardar_laugh"	"Laugh"
"dota_chatwheel_message_slardar_thank"	"Total spawnage."
"[english]dota_chatwheel_message_slardar_thank"	"Total spawnage."
"dota_chatwheel_label_slardar_thank"	"Total spawnage."
"[english]dota_chatwheel_label_slardar_thank"	"Total spawnage."
"dota_chatwheel_message_slardar_deny"	"My deepest sympathies."
"[english]dota_chatwheel_message_slardar_deny"	"My deepest sympathies."
"dota_chatwheel_label_slardar_deny"	"My deepest sympathies."
"[english]dota_chatwheel_label_slardar_deny"	"My deepest sympathies."
"dota_chatwheel_message_slardar_1"	"I came a long way to see you die."
"[english]dota_chatwheel_message_slardar_1"	"I came a long way to see you die."
"dota_chatwheel_label_slardar_1"	"I came a long way..."
"[english]dota_chatwheel_label_slardar_1"	"I came a long way..."
"dota_chatwheel_message_slardar_2"	"You won't escape."
"[english]dota_chatwheel_message_slardar_2"	"You won't escape."
"dota_chatwheel_label_slardar_2"	"You won't escape."
"[english]dota_chatwheel_label_slardar_2"	"You won't escape."
"dota_chatwheel_message_slardar_3"	"Jig's up."
"[english]dota_chatwheel_message_slardar_3"	"Jig's up."
"dota_chatwheel_label_slardar_3"	"Jig's up."
"[english]dota_chatwheel_label_slardar_3"	"Jig's up."
"dota_chatwheel_message_slardar_4"	"You were out of your depth."
"[english]dota_chatwheel_message_slardar_4"	"You were out of your depth."
"dota_chatwheel_label_slardar_4"	"You were out of your depth."
"[english]dota_chatwheel_label_slardar_4"	"You were out of your depth."
"dota_chatwheel_message_slardar_5"	"Oh, how the deep ones will feast!"
"[english]dota_chatwheel_message_slardar_5"	"Oh, how the deep ones will feast!"
"dota_chatwheel_label_slardar_5"	"Oh, how the deep ones will feast!"
"[english]dota_chatwheel_label_slardar_5"	"Oh, how the deep ones will feast!"
"dota_chatwheel_message_tidehunter_laugh"	"Ah ha ha ha!"
"[english]dota_chatwheel_message_tidehunter_laugh"	"Ah ha ha ha!"
"dota_chatwheel_label_tidehunter_laugh"	"[大笑]"
"[english]dota_chatwheel_label_tidehunter_laugh"	"Laugh"
"dota_chatwheel_message_tidehunter_thank"	"We'll turn this tide to our advantage."
"[english]dota_chatwheel_message_tidehunter_thank"	"We'll turn this tide to our advantage."
"dota_chatwheel_label_tidehunter_thank"	"We'll turn this tide to our advantage."
"[english]dota_chatwheel_label_tidehunter_thank"	"We'll turn this tide to our advantage."
"dota_chatwheel_message_tidehunter_deny"	"You look ravaged."
"[english]dota_chatwheel_message_tidehunter_deny"	"You look ravaged."
"dota_chatwheel_label_tidehunter_deny"	"You look ravaged."
"[english]dota_chatwheel_label_tidehunter_deny"	"You look ravaged."
"dota_chatwheel_message_tidehunter_1"	"Ha ha ha ha ha ha, Now you're fish food."
"[english]dota_chatwheel_message_tidehunter_1"	"Ha ha ha ha ha ha, Now you're fish food."
"dota_chatwheel_label_tidehunter_1"	"Now you're fish food."
"[english]dota_chatwheel_label_tidehunter_1"	"Now you're fish food."
"dota_chatwheel_message_tidehunter_2"	"Ha ha I could eat a walrus."
"[english]dota_chatwheel_message_tidehunter_2"	"Ha ha I could eat a walrus."
"dota_chatwheel_label_tidehunter_2"	"Ha ha I could eat a walrus."
"[english]dota_chatwheel_label_tidehunter_2"	"Ha ha I could eat a walrus."
"dota_chatwheel_message_tidehunter_3"	"Put a cork in it."
"[english]dota_chatwheel_message_tidehunter_3"	"Put a cork in it."
"dota_chatwheel_label_tidehunter_3"	"Put a cork in it."
"[english]dota_chatwheel_label_tidehunter_3"	"Put a cork in it."
"dota_chatwheel_message_tidehunter_4"	"Did you think I'd blunder? You must have mistaken me for Kunkka."
"[english]dota_chatwheel_message_tidehunter_4"	"Did you think I'd blunder? You must have mistaken me for Kunkka."
"dota_chatwheel_label_tidehunter_4"	"Did you think I'd blunder?..."
"[english]dota_chatwheel_label_tidehunter_4"	"Did you think I'd blunder?..."
"dota_chatwheel_message_tidehunter_5"	"Who needs a big brain when you've got teeth like mine?"
"[english]dota_chatwheel_message_tidehunter_5"	"Who needs a big brain when you've got teeth like mine?"
"dota_chatwheel_label_tidehunter_5"	"Who needs a big brain...?"
"[english]dota_chatwheel_label_tidehunter_5"	"Who needs a big brain...?"
"dota_chatwheel_message_witch_doctor_laugh"	"Hoo hah hoo hoo hah."
"[english]dota_chatwheel_message_witch_doctor_laugh"	"Hoo hah hoo hoo hah."
"dota_chatwheel_label_witch_doctor_laugh"	"[大笑]"
"[english]dota_chatwheel_label_witch_doctor_laugh"	"Laugh"
"dota_chatwheel_message_witch_doctor_thank"	"Feeling good, man."
"[english]dota_chatwheel_message_witch_doctor_thank"	"Feeling good, man."
"dota_chatwheel_label_witch_doctor_thank"	"Feeling good, man."
"[english]dota_chatwheel_label_witch_doctor_thank"	"Feeling good, man."
"dota_chatwheel_message_witch_doctor_deny"	"Wait for it...wait for it..."
"[english]dota_chatwheel_message_witch_doctor_deny"	"Wait for it...wait for it..."
"dota_chatwheel_label_witch_doctor_deny"	"Wait for it...wait for it..."
"[english]dota_chatwheel_label_witch_doctor_deny"	"Wait for it...wait for it..."
"dota_chatwheel_message_witch_doctor_1"	"Dat make a big mess."
"[english]dota_chatwheel_message_witch_doctor_1"	"Dat make a big mess."
"dota_chatwheel_label_witch_doctor_1"	"Dat make a big mess."
"[english]dota_chatwheel_label_witch_doctor_1"	"Dat make a big mess."
"dota_chatwheel_message_witch_doctor_2"	"Someone call de doctor?"
"[english]dota_chatwheel_message_witch_doctor_2"	"Someone call de doctor?"
"dota_chatwheel_label_witch_doctor_2"	"Someone call de doctor?"
"[english]dota_chatwheel_label_witch_doctor_2"	"Someone call de doctor?"
"dota_chatwheel_message_witch_doctor_3"	"Oh, look at it go."
"[english]dota_chatwheel_message_witch_doctor_3"	"Oh, look at it go."
"dota_chatwheel_label_witch_doctor_3"	"Oh, look at it go."
"[english]dota_chatwheel_label_witch_doctor_3"	"Oh, look at it go."
"dota_chatwheel_message_witch_doctor_4"	"Stick a bone in it. You're done."
"[english]dota_chatwheel_message_witch_doctor_4"	"Stick a bone in it. You're done."
"dota_chatwheel_label_witch_doctor_4"	"Stick a bone in it. You're done."
"[english]dota_chatwheel_label_witch_doctor_4"	"Stick a bone in it. You're done."
"dota_chatwheel_message_witch_doctor_5"	"Oyeaaaaah."
"[english]dota_chatwheel_message_witch_doctor_5"	"Oyeaaaaah."
"dota_chatwheel_label_witch_doctor_5"	"Oyeaaaaah."
"[english]dota_chatwheel_label_witch_doctor_5"	"Oyeaaaaah."
"dota_chatwheel_message_lich_laugh"	"Ha ha ha ha ha ha ha ha!"
"[english]dota_chatwheel_message_lich_laugh"	"Ha ha ha ha ha ha ha ha!"
"dota_chatwheel_label_lich_laugh"	"[大笑]"
"[english]dota_chatwheel_label_lich_laugh"	"Laugh"
"dota_chatwheel_message_lich_thank"	"Stay frosty!"
"[english]dota_chatwheel_message_lich_thank"	"Stay frosty!"
"dota_chatwheel_label_lich_thank"	"Stay frosty!"
"[english]dota_chatwheel_label_lich_thank"	"Stay frosty!"
"dota_chatwheel_message_lich_deny"	"Watch your step, it's six feet down."
"[english]dota_chatwheel_message_lich_deny"	"Watch your step, it's six feet down."
"dota_chatwheel_label_lich_deny"	"Watch your step..."
"[english]dota_chatwheel_label_lich_deny"	"Watch your step..."
"dota_chatwheel_message_lich_1"	"Can't kill the dead."
"[english]dota_chatwheel_message_lich_1"	"Can't kill the dead."
"dota_chatwheel_label_lich_1"	"Can't kill the dead."
"[english]dota_chatwheel_label_lich_1"	"Can't kill the dead."
"dota_chatwheel_message_lich_2"	"Does it tingle?"
"[english]dota_chatwheel_message_lich_2"	"Does it tingle?"
"dota_chatwheel_label_lich_2"	"Does it tingle?"
"[english]dota_chatwheel_label_lich_2"	"Does it tingle?"
"dota_chatwheel_message_lich_3"	"Feel my cold embrace!"
"[english]dota_chatwheel_message_lich_3"	"Feel my cold embrace!"
"dota_chatwheel_label_lich_3"	"Feel my cold embrace!"
"[english]dota_chatwheel_label_lich_3"	"Feel my cold embrace!"
"dota_chatwheel_message_lich_4"	"Who's the number one now?"
"[english]dota_chatwheel_message_lich_4"	"Who's the number one now?"
"dota_chatwheel_label_lich_4"	"Who's the number one now?"
"[english]dota_chatwheel_label_lich_4"	"Who's the number one now?"
"dota_chatwheel_message_lich_5"	"Ah, Ice Frog!"
"[english]dota_chatwheel_message_lich_5"	"Ah, Ice Frog!"
"dota_chatwheel_label_lich_5"	"Ah, Ice Frog!"
"[english]dota_chatwheel_label_lich_5"	"Ah, Ice Frog!"
"dota_chatwheel_message_riki_laugh"	"hoo hoo hoo hoo hoo hoo hoo."
"[english]dota_chatwheel_message_riki_laugh"	"hoo hoo hoo hoo hoo hoo hoo."
"dota_chatwheel_label_riki_laugh"	"[大笑]"
"[english]dota_chatwheel_label_riki_laugh"	"Laugh"
"dota_chatwheel_message_riki_thank"	"Contract complete."
"[english]dota_chatwheel_message_riki_thank"	"Contract complete."
"dota_chatwheel_label_riki_thank"	"Contract complete."
"[english]dota_chatwheel_label_riki_thank"	"Contract complete."
"dota_chatwheel_message_riki_deny"	"Heh-ho, you didn't see that coming."
"[english]dota_chatwheel_message_riki_deny"	"Heh-ho, you didn't see that coming."
"dota_chatwheel_label_riki_deny"	"You didn't see that coming."
"[english]dota_chatwheel_label_riki_deny"	"You didn't see that coming."
"dota_chatwheel_message_riki_1"	"Why prolong the inevitable?"
"[english]dota_chatwheel_message_riki_1"	"Why prolong the inevitable?"
"dota_chatwheel_label_riki_1"	"Why prolong the inevitable?"
"[english]dota_chatwheel_label_riki_1"	"Why prolong the inevitable?"
"dota_chatwheel_message_riki_2"	"Peek-a-boo."
"[english]dota_chatwheel_message_riki_2"	"Peek-a-boo."
"dota_chatwheel_label_riki_2"	"Peek-aboo."
"[english]dota_chatwheel_label_riki_2"	"Peek-aboo."
"dota_chatwheel_message_riki_3"	"If you can see me, you're already dead."
"[english]dota_chatwheel_message_riki_3"	"If you can see me, you're already dead."
"dota_chatwheel_label_riki_3"	"If you can see me..."
"[english]dota_chatwheel_label_riki_3"	"If you can see me..."
"dota_chatwheel_message_riki_4"	"I've been here the whole time."
"[english]dota_chatwheel_message_riki_4"	"I've been here the whole time."
"dota_chatwheel_label_riki_4"	"I've been here the whole time."
"[english]dota_chatwheel_label_riki_4"	"I've been here the whole time."
"dota_chatwheel_message_riki_5"	"Oh you're dead. What a surprise."
"[english]dota_chatwheel_message_riki_5"	"Oh you're dead. What a surprise."
"dota_chatwheel_label_riki_5"	"Oh you're dead. What a surprise."
"[english]dota_chatwheel_label_riki_5"	"Oh you're dead. What a surprise."
"dota_chatwheel_message_enigma_laugh"	"He-he-huh-heh-heh."
"[english]dota_chatwheel_message_enigma_laugh"	"He-he-huh-heh-heh."
"dota_chatwheel_label_enigma_laugh"	"[大笑]"
"[english]dota_chatwheel_label_enigma_laugh"	"Laugh"
"dota_chatwheel_message_enigma_thank"	"Well, this is a paradox."
"[english]dota_chatwheel_message_enigma_thank"	"Well, this is a paradox."
"dota_chatwheel_label_enigma_thank"	"Well, this is a paradox."
"[english]dota_chatwheel_label_enigma_thank"	"Well, this is a paradox."
"dota_chatwheel_message_enigma_deny"	"An astronomical price."
"[english]dota_chatwheel_message_enigma_deny"	"An astronomical price."
"dota_chatwheel_label_enigma_deny"	"An astronomical price."
"[english]dota_chatwheel_label_enigma_deny"	"An astronomical price."
"dota_chatwheel_message_enigma_1"	"Stare into the abyss."
"[english]dota_chatwheel_message_enigma_1"	"Stare into the abyss."
"dota_chatwheel_label_enigma_1"	"Stare into the abyss."
"[english]dota_chatwheel_label_enigma_1"	"Stare into the abyss."
"dota_chatwheel_message_enigma_2"	"Silence is golden."
"[english]dota_chatwheel_message_enigma_2"	"Silence is golden."
"dota_chatwheel_label_enigma_2"	"Silence is golden."
"[english]dota_chatwheel_label_enigma_2"	"Silence is golden."
"dota_chatwheel_message_enigma_3"	"You are beneath me."
"[english]dota_chatwheel_message_enigma_3"	"You are beneath me."
"dota_chatwheel_label_enigma_3"	"You are beneath me."
"[english]dota_chatwheel_label_enigma_3"	"You are beneath me."
"dota_chatwheel_message_enigma_4"	"A welcome manifestation of randomness."
"[english]dota_chatwheel_message_enigma_4"	"A welcome manifestation of randomness."
"dota_chatwheel_label_enigma_4"	"A welcome manifestation of randomness."
"[english]dota_chatwheel_label_enigma_4"	"A welcome manifestation of randomness."
"dota_chatwheel_message_enigma_5"	"If light cannot escape me, what hope have you?"
"[english]dota_chatwheel_message_enigma_5"	"If light cannot escape me, what hope have you?"
"dota_chatwheel_label_enigma_5"	"If light cannot escape me..."
"[english]dota_chatwheel_label_enigma_5"	"If light cannot escape me..."
"dota_chatwheel_message_tinker_laugh"	"Ah ha ha ha ha!"
"[english]dota_chatwheel_message_tinker_laugh"	"Ah ha ha ha ha!"
"dota_chatwheel_label_tinker_laugh"	"[大笑]"
"[english]dota_chatwheel_label_tinker_laugh"	"Laugh"
"dota_chatwheel_message_tinker_thank"	"Your talents surpass your loveliness."
"[english]dota_chatwheel_message_tinker_thank"	"Your talents surpass your loveliness."
"dota_chatwheel_label_tinker_thank"	"Your talents surpass your loveliness."
"[english]dota_chatwheel_label_tinker_thank"	"Your talents surpass your loveliness."
"dota_chatwheel_message_tinker_deny"	"Well isn't that something!"
"[english]dota_chatwheel_message_tinker_deny"	"Well isn't that something!"
"dota_chatwheel_label_tinker_deny"	"Well isn't that something!"
"[english]dota_chatwheel_label_tinker_deny"	"Well isn't that something!"
"dota_chatwheel_message_tinker_1"	"Pew, pew, pew pew pew!"
"[english]dota_chatwheel_message_tinker_1"	"Pew, pew, pew pew pew!"
"dota_chatwheel_label_tinker_1"	"Pew, pew, pew pew pew!"
"[english]dota_chatwheel_label_tinker_1"	"Pew, pew, pew pew pew!"
"dota_chatwheel_message_tinker_2"	"I predicted all of this you know, all of it!"
"[english]dota_chatwheel_message_tinker_2"	"I predicted all of this you know, all of it!"
"dota_chatwheel_label_tinker_2"	"I predicted all of this you know..."
"[english]dota_chatwheel_label_tinker_2"	"I predicted all of this you know..."
"dota_chatwheel_message_tinker_3"	"That was genius!"
"[english]dota_chatwheel_message_tinker_3"	"That was genius!"
"dota_chatwheel_label_tinker_3"	"That was genius!"
"[english]dota_chatwheel_label_tinker_3"	"That was genius!"
"dota_chatwheel_message_tinker_4"	"I'm going to call that experiment, a failure."
"[english]dota_chatwheel_message_tinker_4"	"I'm going to call that experiment, a failure."
"dota_chatwheel_label_tinker_4"	"I'm going to call that experiment..."
"[english]dota_chatwheel_label_tinker_4"	"I'm going to call that experiment..."
"dota_chatwheel_message_tinker_5"	"You can keep your magic, I have laser beams!"
"[english]dota_chatwheel_message_tinker_5"	"You can keep your magic, I have laser beams!"
"dota_chatwheel_label_tinker_5"	"You can keep your magic..."
"[english]dota_chatwheel_label_tinker_5"	"You can keep your magic..."
"dota_chatwheel_message_sniper_laugh"	"Hee hee hee hee hee hee hee hee hee hee!"
"[english]dota_chatwheel_message_sniper_laugh"	"Hee hee hee hee hee hee hee hee hee hee!"
"dota_chatwheel_label_sniper_laugh"	"[大笑]"
"[english]dota_chatwheel_label_sniper_laugh"	"Laugh"
"dota_chatwheel_message_sniper_thank"	"Target practice, payin' off!"
"[english]dota_chatwheel_message_sniper_thank"	"Target practice, payin' off!"
"dota_chatwheel_label_sniper_thank"	"Target practice, payin' off!"
"[english]dota_chatwheel_label_sniper_thank"	"Target practice, payin' off!"
"dota_chatwheel_message_sniper_deny"	"What the---?"
"[english]dota_chatwheel_message_sniper_deny"	"What the---?"
"dota_chatwheel_label_sniper_deny"	"What the---?"
"[english]dota_chatwheel_label_sniper_deny"	"What the---?"
"dota_chatwheel_message_sniper_1"	"Say goodbye to your head!"
"[english]dota_chatwheel_message_sniper_1"	"Say goodbye to your head!"
"dota_chatwheel_label_sniper_1"	"Say goodbye to your head!"
"[english]dota_chatwheel_label_sniper_1"	"Say goodbye to your head!"
"dota_chatwheel_message_sniper_2"	"Dance! Ha ha ha ha! Dance!"
"[english]dota_chatwheel_message_sniper_2"	"Dance! Ha ha ha ha! Dance!"
"dota_chatwheel_label_sniper_2"	"Dance! Ha ha ha ha! Dance!"
"[english]dota_chatwheel_label_sniper_2"	"Dance! Ha ha ha ha! Dance!"
"dota_chatwheel_message_sniper_3"	"Why am I smiling? This is what trigger-happy looks like."
"[english]dota_chatwheel_message_sniper_3"	"Why am I smiling? This is what trigger-happy looks like."
"dota_chatwheel_label_sniper_3"	"Why am I smiling?..."
"[english]dota_chatwheel_label_sniper_3"	"Why am I smiling?..."
"dota_chatwheel_message_sniper_4"	"What a dum-dum!"
"[english]dota_chatwheel_message_sniper_4"	"What a dum-dum!"
"dota_chatwheel_label_sniper_4"	"What a dumb dumb"
"[english]dota_chatwheel_label_sniper_4"	"What a dumb dumb"
"dota_chatwheel_message_sniper_5"	"Ho ho ha ha!"
"[english]dota_chatwheel_message_sniper_5"	"Ho ho ha ha!"
"dota_chatwheel_label_sniper_5"	"Ho ho ha ha!"
"[english]dota_chatwheel_label_sniper_5"	"Ho ho ha ha!"
"dota_chatwheel_message_necrolyte_laugh"	"Ha ha ha ha ha ha ha ha ha ha ha ha!"
"[english]dota_chatwheel_message_necrolyte_laugh"	"Ha ha ha ha ha ha ha ha ha ha ha ha!"
"dota_chatwheel_label_necrolyte_laugh"	"[大笑]"
"[english]dota_chatwheel_label_necrolyte_laugh"	"Laugh"
"dota_chatwheel_message_necrolyte_thank"	"Breathe it in."
"[english]dota_chatwheel_message_necrolyte_thank"	"Breathe it in."
"dota_chatwheel_label_necrolyte_thank"	"Breathe it in."
"[english]dota_chatwheel_label_necrolyte_thank"	"Breathe it in."
"dota_chatwheel_message_necrolyte_deny"	"That was costly."
"[english]dota_chatwheel_message_necrolyte_deny"	"That was costly."
"dota_chatwheel_label_necrolyte_deny"	"That was costly."
"[english]dota_chatwheel_label_necrolyte_deny"	"That was costly."
"dota_chatwheel_message_necrolyte_1"	"The stench of death is upon you."
"[english]dota_chatwheel_message_necrolyte_1"	"The stench of death is upon you."
"dota_chatwheel_label_necrolyte_1"	"The stench of death is upon you."
"[english]dota_chatwheel_label_necrolyte_1"	"The stench of death is upon you."
"dota_chatwheel_message_necrolyte_2"	"What do you mean, cheer up? I'm quite cheerful."
"[english]dota_chatwheel_message_necrolyte_2"	"What do you mean, cheer up? I'm quite cheerful."
"dota_chatwheel_label_necrolyte_2"	"What do you mean, cheer up?..."
"[english]dota_chatwheel_label_necrolyte_2"	"What do you mean, cheer up?..."
"dota_chatwheel_message_necrolyte_3"	"It's all gone rotten."
"[english]dota_chatwheel_message_necrolyte_3"	"It's all gone rotten."
"dota_chatwheel_label_necrolyte_3"	"It's all gone rotten."
"[english]dota_chatwheel_label_necrolyte_3"	"It's all gone rotten."
"dota_chatwheel_message_necrolyte_4"	"To your health. Ha ha ha ha ha ha ha ha ha."
"[english]dota_chatwheel_message_necrolyte_4"	"To your health. Ha ha ha ha ha ha ha ha ha."
"dota_chatwheel_label_necrolyte_4"	"To your health..."
"[english]dota_chatwheel_label_necrolyte_4"	"To your health..."
"dota_chatwheel_message_necrolyte_5"	"I am the rotten apple that spoils the bunch."
"[english]dota_chatwheel_message_necrolyte_5"	"I am the rotten apple that spoils the bunch."
"dota_chatwheel_label_necrolyte_5"	"I am the rotten apple..."
"[english]dota_chatwheel_label_necrolyte_5"	"I am the rotten apple..."
"dota_chatwheel_message_warlock_laugh"	"Ho ha ha ha ha ha ha ha ha!"
"[english]dota_chatwheel_message_warlock_laugh"	"Ho ha ha ha ha ha ha ha ha!"
"dota_chatwheel_label_warlock_laugh"	"[大笑]"
"[english]dota_chatwheel_label_warlock_laugh"	"Laugh"
"dota_chatwheel_message_warlock_thank"	"Let chaos reign!"
"[english]dota_chatwheel_message_warlock_thank"	"Let chaos reign!"
"dota_chatwheel_label_warlock_thank"	"Let chaos reign!"
"[english]dota_chatwheel_label_warlock_thank"	"Let chaos reign!"
"dota_chatwheel_message_warlock_deny"	"Really? You just did that?"
"[english]dota_chatwheel_message_warlock_deny"	"Really? You just did that?"
"dota_chatwheel_label_warlock_deny"	"Really? You just did that?"
"[english]dota_chatwheel_label_warlock_deny"	"Really? You just did that?"
"dota_chatwheel_message_warlock_1"	"I feed you to my fiends."
"[english]dota_chatwheel_message_warlock_1"	"I feed you to my fiends."
"dota_chatwheel_label_warlock_1"	"I feed you to my fiends."
"[english]dota_chatwheel_label_warlock_1"	"I feed you to my fiends."
"dota_chatwheel_message_warlock_2"	"Zan korobos kor koramord!"
"[english]dota_chatwheel_message_warlock_2"	"Zan korobos kor koramord!"
"dota_chatwheel_label_warlock_2"	"Zan korobos kor koramord!"
"[english]dota_chatwheel_label_warlock_2"	"Zan korobos kor koramord!"
"dota_chatwheel_message_warlock_3"	"Another name in my grimoire."
"[english]dota_chatwheel_message_warlock_3"	"Another name in my grimoire."
"dota_chatwheel_label_warlock_3"	"Another name in my grimoire."
"[english]dota_chatwheel_label_warlock_3"	"Another name in my grimoire."
"dota_chatwheel_message_warlock_4"	"Pipsqueak."
"[english]dota_chatwheel_message_warlock_4"	"Pipsqueak."
"dota_chatwheel_label_warlock_4"	"Pipsqueak."
"[english]dota_chatwheel_label_warlock_4"	"Pipsqueak."
"dota_chatwheel_message_warlock_5"	"Can you believe this? Ah ha ha ha ha ha ha ha ha ha!"
"[english]dota_chatwheel_message_warlock_5"	"Can you believe this? Ah ha ha ha ha ha ha ha ha ha!"
"dota_chatwheel_label_warlock_5"	"Can you believe this?..."
"[english]dota_chatwheel_label_warlock_5"	"Can you believe this?..."
"dota_chatwheel_message_beastmaster_laugh"	"Howeh heh heh eh hah heh heh heh."
"[english]dota_chatwheel_message_beastmaster_laugh"	"Howeh heh heh eh hah heh heh heh."
"dota_chatwheel_label_beastmaster_laugh"	"[大笑]"
"[english]dota_chatwheel_label_beastmaster_laugh"	"Laugh"
"dota_chatwheel_message_beastmaster_thank"	"Sic 'em!"
"[english]dota_chatwheel_message_beastmaster_thank"	"Sic 'em!"
"dota_chatwheel_label_beastmaster_thank"	"Sic 'em!"
"[english]dota_chatwheel_label_beastmaster_thank"	"Sic 'em!"
"dota_chatwheel_message_beastmaster_deny"	"I'll be creeping while you are sleeping."
"[english]dota_chatwheel_message_beastmaster_deny"	"I'll be creeping while you are sleeping."
"dota_chatwheel_label_beastmaster_deny"	"I'll be creeping..."
"[english]dota_chatwheel_label_beastmaster_deny"	"I'll be creeping..."
"dota_chatwheel_message_beastmaster_1"	"The worms will have you."
"[english]dota_chatwheel_message_beastmaster_1"	"The worms will have you."
"dota_chatwheel_label_beastmaster_1"	"The worms will have you."
"[english]dota_chatwheel_label_beastmaster_1"	"The worms will have you."
"dota_chatwheel_message_beastmaster_2"	"A strict no-kill policy."
"[english]dota_chatwheel_message_beastmaster_2"	"A strict no-kill policy."
"dota_chatwheel_label_beastmaster_2"	"A strict no-kill policy."
"[english]dota_chatwheel_label_beastmaster_2"	"A strict no-kill policy."
"dota_chatwheel_message_beastmaster_3"	"Aroo arooew!"
"[english]dota_chatwheel_message_beastmaster_3"	"Aroo arooew!"
"dota_chatwheel_label_beastmaster_3"	"Aroo arooew!"
"[english]dota_chatwheel_label_beastmaster_3"	"Aroo arooew!"
"dota_chatwheel_message_beastmaster_4"	"Hmm, wish I'd learned how to read."
"[english]dota_chatwheel_message_beastmaster_4"	"Hmm, wish I'd learned how to read."
"dota_chatwheel_label_beastmaster_4"	"Hmm, wish I'd learned how to read."
"[english]dota_chatwheel_label_beastmaster_4"	"Hmm, wish I'd learned how to read."
"dota_chatwheel_message_beastmaster_5"	"Hoo hoo hoo."
"[english]dota_chatwheel_message_beastmaster_5"	"Hoo hoo hoo."
"dota_chatwheel_label_beastmaster_5"	"Hoo hoo hoo."
"[english]dota_chatwheel_label_beastmaster_5"	"Hoo hoo hoo."
"dota_chatwheel_message_queenofpain_laugh"	"Uh ha ha ha ha ha ha ha ha ha ha ha!"
"[english]dota_chatwheel_message_queenofpain_laugh"	"Uh ha ha ha ha ha ha ha ha ha ha ha!"
"dota_chatwheel_label_queenofpain_laugh"	"[大笑]"
"[english]dota_chatwheel_label_queenofpain_laugh"	"Laugh"
"dota_chatwheel_message_queenofpain_thank"	"There will be pain, there will be screaming."
"[english]dota_chatwheel_message_queenofpain_thank"	"There will be pain, there will be screaming."
"dota_chatwheel_label_queenofpain_thank"	"There will be pain..."
"[english]dota_chatwheel_label_queenofpain_thank"	"There will be pain..."
"dota_chatwheel_message_queenofpain_deny"	"You hurt the ones you love."
"[english]dota_chatwheel_message_queenofpain_deny"	"You hurt the ones you love."
"dota_chatwheel_label_queenofpain_deny"	"You hurt the ones you love."
"[english]dota_chatwheel_label_queenofpain_deny"	"You hurt the ones you love."
"dota_chatwheel_message_queenofpain_1"	"That was perfect."
"[english]dota_chatwheel_message_queenofpain_1"	"That was perfect."
"dota_chatwheel_label_queenofpain_1"	"That was perfect."
"[english]dota_chatwheel_label_queenofpain_1"	"That was perfect."
"dota_chatwheel_message_queenofpain_2"	"Does this hurt?"
"[english]dota_chatwheel_message_queenofpain_2"	"Does this hurt?"
"dota_chatwheel_label_queenofpain_2"	"Does this hurt?"
"[english]dota_chatwheel_label_queenofpain_2"	"Does this hurt?"
"dota_chatwheel_message_queenofpain_3"	"I love it when you resist."
"[english]dota_chatwheel_message_queenofpain_3"	"I love it when you resist."
"dota_chatwheel_label_queenofpain_3"	"I love it when you resist."
"[english]dota_chatwheel_label_queenofpain_3"	"I love it when you resist."
"dota_chatwheel_message_queenofpain_4"	"You want me? Come get me."
"[english]dota_chatwheel_message_queenofpain_4"	"You want me? Come get me."
"dota_chatwheel_label_queenofpain_4"	"You want me? Come get me."
"[english]dota_chatwheel_label_queenofpain_4"	"You want me? Come get me."
"dota_chatwheel_message_queenofpain_5"	"I know I'm a pain, but you love me anyway."
"[english]dota_chatwheel_message_queenofpain_5"	"I know I'm a pain, but you love me anyway."
"dota_chatwheel_label_queenofpain_5"	"I know I'm a pain..."
"[english]dota_chatwheel_label_queenofpain_5"	"I know I'm a pain..."
"dota_chatwheel_message_venomancer_laugh"	"Sss eh he he he he."
"[english]dota_chatwheel_message_venomancer_laugh"	"Sss eh he he he he."
"dota_chatwheel_label_venomancer_laugh"	"[大笑]"
"[english]dota_chatwheel_label_venomancer_laugh"	"Laugh"
"dota_chatwheel_message_venomancer_thank"	"Plague our enemies!"
"[english]dota_chatwheel_message_venomancer_thank"	"Plague our enemies!"
"dota_chatwheel_label_venomancer_thank"	"Plague our enemies!"
"[english]dota_chatwheel_label_venomancer_thank"	"Plague our enemies!"
"dota_chatwheel_message_venomancer_deny"	"Oh, costly."
"[english]dota_chatwheel_message_venomancer_deny"	"Oh, costly."
"dota_chatwheel_label_venomancer_deny"	"Oh, costly."
"[english]dota_chatwheel_label_venomancer_deny"	"Oh, costly."
"dota_chatwheel_message_venomancer_1"	"Nothing touches the heart like my venom."
"[english]dota_chatwheel_message_venomancer_1"	"Nothing touches the heart like my venom."
"dota_chatwheel_label_venomancer_1"	"Nothing touches the heart..."
"[english]dota_chatwheel_label_venomancer_1"	"Nothing touches the heart..."
"dota_chatwheel_message_venomancer_2"	"Ssss, that burns."
"[english]dota_chatwheel_message_venomancer_2"	"Ssss, that burns."
"dota_chatwheel_label_venomancer_2"	"Ssss, that burns."
"[english]dota_chatwheel_label_venomancer_2"	"Ssss, that burns."
"dota_chatwheel_message_venomancer_3"	"You can't run from the venomous one!"
"[english]dota_chatwheel_message_venomancer_3"	"You can't run from the venomous one!"
"dota_chatwheel_label_venomancer_3"	"You can't run..."
"[english]dota_chatwheel_label_venomancer_3"	"You can't run..."
"dota_chatwheel_message_venomancer_4"	"I owe it all to me."
"[english]dota_chatwheel_message_venomancer_4"	"I owe it all to me."
"dota_chatwheel_label_venomancer_4"	"I owe it all to me."
"[english]dota_chatwheel_label_venomancer_4"	"I owe it all to me."
"dota_chatwheel_message_venomancer_5"	"Ah, sweet toxicity!"
"[english]dota_chatwheel_message_venomancer_5"	"Ah, sweet toxicity!"
"dota_chatwheel_label_venomancer_5"	"Ah, sweet toxicity!"
"[english]dota_chatwheel_label_venomancer_5"	"Ah, sweet toxicity!"
"dota_chatwheel_message_faceless_void_laugh"	"Heh heh hah ha hah heh heah heh."
"[english]dota_chatwheel_message_faceless_void_laugh"	"Heh heh hah ha hah heh heah heh."
"dota_chatwheel_label_faceless_void_laugh"	"[大笑]"
"[english]dota_chatwheel_label_faceless_void_laugh"	"Laugh"
"dota_chatwheel_message_faceless_void_thank"	"Just as I envisaged!"
"[english]dota_chatwheel_message_faceless_void_thank"	"Just as I envisaged!"
"dota_chatwheel_label_faceless_void_thank"	"Just as I envisaged!"
"[english]dota_chatwheel_label_faceless_void_thank"	"Just as I envisaged!"
"dota_chatwheel_message_faceless_void_deny"	"Some things were just not meant to be."
"[english]dota_chatwheel_message_faceless_void_deny"	"Some things were just not meant to be."
"dota_chatwheel_label_faceless_void_deny"	"...just not meant to be."
"[english]dota_chatwheel_label_faceless_void_deny"	"...just not meant to be."
"dota_chatwheel_message_faceless_void_1"	"You lose face and life."
"[english]dota_chatwheel_message_faceless_void_1"	"You lose face and life."
"dota_chatwheel_label_faceless_void_1"	"You lose face and life."
"[english]dota_chatwheel_label_faceless_void_1"	"You lose face and life."
"dota_chatwheel_message_faceless_void_2"	"You've been voided."
"[english]dota_chatwheel_message_faceless_void_2"	"You've been voided."
"dota_chatwheel_label_faceless_void_2"	"You've been voided."
"[english]dota_chatwheel_label_faceless_void_2"	"You've been voided."
"dota_chatwheel_message_faceless_void_3"	"I can't bear to look."
"[english]dota_chatwheel_message_faceless_void_3"	"I can't bear to look."
"dota_chatwheel_label_faceless_void_3"	"I can't bear to look."
"[english]dota_chatwheel_label_faceless_void_3"	"I can't bear to look."
"dota_chatwheel_message_faceless_void_4"	"I may be faceless, but I'm not maceless."
"[english]dota_chatwheel_message_faceless_void_4"	"I may be faceless, but I'm not maceless."
"dota_chatwheel_label_faceless_void_4"	"I may be faceless, but..."
"[english]dota_chatwheel_label_faceless_void_4"	"I may be faceless, but..."
"dota_chatwheel_message_faceless_void_5"	"An eternity of embarrassment!"
"[english]dota_chatwheel_message_faceless_void_5"	"An eternity of embarrassment!"
"dota_chatwheel_label_faceless_void_5"	"An eternity of embarrassment!"
"[english]dota_chatwheel_label_faceless_void_5"	"An eternity of embarrassment!"
"dota_chatwheel_message_skeleton_king_laugh"	"AH HA HA HA HA!"
"[english]dota_chatwheel_message_skeleton_king_laugh"	"AH HA HA HA HA!"
"dota_chatwheel_label_skeleton_king_laugh"	"AH HA HA HA HA!"
"[english]dota_chatwheel_label_skeleton_king_laugh"	"AH HA HA HA HA!"
"dota_chatwheel_message_skeleton_king_thank"	"I'LL HELP MY WEAK AND PUNY ALLIES WHERE I CAN."
"[english]dota_chatwheel_message_skeleton_king_thank"	"I'LL HELP MY WEAK AND PUNY ALLIES WHERE I CAN."
"dota_chatwheel_label_skeleton_king_thank"	"...WEAK AND PUNY ALLIES..."
"[english]dota_chatwheel_label_skeleton_king_thank"	"...WEAK AND PUNY ALLIES..."
"dota_chatwheel_message_skeleton_king_deny"	"SO WHAT IF I SWAGGER?"
"[english]dota_chatwheel_message_skeleton_king_deny"	"SO WHAT IF I SWAGGER?"
"dota_chatwheel_label_skeleton_king_deny"	"SO WHAT IF I SWAGGER?"
"[english]dota_chatwheel_label_skeleton_king_deny"	"SO WHAT IF I SWAGGER?"
"dota_chatwheel_message_skeleton_king_1"	"TAKE A KNEE, PEASANT."
"[english]dota_chatwheel_message_skeleton_king_1"	"TAKE A KNEE, PEASANT."
"dota_chatwheel_label_skeleton_king_1"	"TAKE A KNEE, PEASANT."
"[english]dota_chatwheel_label_skeleton_king_1"	"TAKE A KNEE, PEASANT."
"dota_chatwheel_message_skeleton_king_2"	"VERY NICE."
"[english]dota_chatwheel_message_skeleton_king_2"	"VERY NICE."
"dota_chatwheel_label_skeleton_king_2"	"VERY NICE."
"[english]dota_chatwheel_label_skeleton_king_2"	"VERY NICE."
"dota_chatwheel_message_skeleton_king_3"	"I MISS MY BONES."
"[english]dota_chatwheel_message_skeleton_king_3"	"I MISS MY BONES."
"dota_chatwheel_label_skeleton_king_3"	"I MISS MY BONES."
"[english]dota_chatwheel_label_skeleton_king_3"	"I MISS MY BONES."
"dota_chatwheel_message_skeleton_king_4"	"I NOW HAVE ALL THE SEXY."
"[english]dota_chatwheel_message_skeleton_king_4"	"I NOW HAVE ALL THE SEXY."
"dota_chatwheel_label_skeleton_king_4"	"I NOW HAVE ALL THE SEXY."
"[english]dota_chatwheel_label_skeleton_king_4"	"I NOW HAVE ALL THE SEXY."
"dota_chatwheel_message_skeleton_king_5"	"WELCOME TO ALL MY NEW SUBJECTS. NOW LET'S GET TO KNOW EACH OTHER."
"[english]dota_chatwheel_message_skeleton_king_5"	"WELCOME TO ALL MY NEW SUBJECTS. NOW LET'S GET TO KNOW EACH OTHER."
"dota_chatwheel_label_skeleton_king_5"	"WELCOME TO ALL MY NEW SUBJECTS..."
"[english]dota_chatwheel_label_skeleton_king_5"	"WELCOME TO ALL MY NEW SUBJECTS..."
"dota_chatwheel_message_death_prophet_laugh"	"Oh ah ha ha ha ha ha ho ho haa! Ha ha ha ha ha ha!"
"[english]dota_chatwheel_message_death_prophet_laugh"	"Oh ah ha ha ha ha ha ho ho haa! Ha ha ha ha ha ha!"
"dota_chatwheel_label_death_prophet_laugh"	"[大笑]"
"[english]dota_chatwheel_label_death_prophet_laugh"	"Laugh"
"dota_chatwheel_message_death_prophet_thank"	"Well done, my beauties!"
"[english]dota_chatwheel_message_death_prophet_thank"	"Well done, my beauties!"
"dota_chatwheel_label_death_prophet_thank"	"Well done, my beauties!"
"[english]dota_chatwheel_label_death_prophet_thank"	"Well done, my beauties!"
"dota_chatwheel_message_death_prophet_deny"	"Not meant to be."
"[english]dota_chatwheel_message_death_prophet_deny"	"Not meant to be."
"dota_chatwheel_label_death_prophet_deny"	"Not meant to be."
"[english]dota_chatwheel_label_death_prophet_deny"	"Not meant to be."
"dota_chatwheel_message_death_prophet_1"	"Poor dear."
"[english]dota_chatwheel_message_death_prophet_1"	"Poor dear."
"dota_chatwheel_label_death_prophet_1"	"Poor dear."
"[english]dota_chatwheel_label_death_prophet_1"	"Poor dear."
"dota_chatwheel_message_death_prophet_2"	"How disappointing."
"[english]dota_chatwheel_message_death_prophet_2"	"How disappointing."
"dota_chatwheel_label_death_prophet_2"	"How disappointing."
"[english]dota_chatwheel_label_death_prophet_2"	"How disappointing."
"dota_chatwheel_message_death_prophet_3"	"Come back to me! Come back to me!"
"[english]dota_chatwheel_message_death_prophet_3"	"Come back to me! Come back to me!"
"dota_chatwheel_label_death_prophet_3"	"Come back to me!"
"[english]dota_chatwheel_label_death_prophet_3"	"Come back to me!"
"dota_chatwheel_message_death_prophet_4"	"It did not take a prophet to see that coming."
"[english]dota_chatwheel_message_death_prophet_4"	"It did not take a prophet to see that coming."
"dota_chatwheel_label_death_prophet_4"	"It did not take a prophet..."
"[english]dota_chatwheel_label_death_prophet_4"	"It did not take a prophet..."
"dota_chatwheel_message_death_prophet_5"	"I died a little just now."
"[english]dota_chatwheel_message_death_prophet_5"	"I died a little just now."
"dota_chatwheel_label_death_prophet_5"	"I died a little just now."
"[english]dota_chatwheel_label_death_prophet_5"	"I died a little just now."
"dota_chatwheel_message_phantom_assassin_laugh"	"Ho ho ho ho ho ha ha ha"
"[english]dota_chatwheel_message_phantom_assassin_laugh"	"Ho ho ho ho ho ha ha ha"
"dota_chatwheel_label_phantom_assassin_laugh"	"[大笑]"
"[english]dota_chatwheel_label_phantom_assassin_laugh"	"Laugh"
"dota_chatwheel_message_phantom_assassin_thank"	"Mmm, divine."
"[english]dota_chatwheel_message_phantom_assassin_thank"	"Mmm, divine."
"dota_chatwheel_label_phantom_assassin_thank"	"Mmm, divine."
"[english]dota_chatwheel_label_phantom_assassin_thank"	"Mmm, divine."
"dota_chatwheel_message_phantom_assassin_deny"	"All according to plan."
"[english]dota_chatwheel_message_phantom_assassin_deny"	"All according to plan."
"dota_chatwheel_label_phantom_assassin_deny"	"All according to plan."
"[english]dota_chatwheel_label_phantom_assassin_deny"	"All according to plan."
"dota_chatwheel_message_phantom_assassin_1"	"Death at my hands is an honor."
"[english]dota_chatwheel_message_phantom_assassin_1"	"Death at my hands is an honor."
"dota_chatwheel_label_phantom_assassin_1"	"Death at my hands is an honor."
"[english]dota_chatwheel_label_phantom_assassin_1"	"Death at my hands is an honor."
"dota_chatwheel_label_pugna_laugh"	"[大笑]"
"[english]dota_chatwheel_label_pugna_laugh"	"Laugh"
"dota_chatwheel_message_pugna_2"	"Anyone miss me?"
"[english]dota_chatwheel_message_pugna_2"	"Anyone miss me?"
"dota_chatwheel_label_pugna_2"	"Anyone miss me?"
"[english]dota_chatwheel_label_pugna_2"	"Anyone miss me?"
"dota_chatwheel_label_templar_assassin_laugh"	"[大笑]"
"[english]dota_chatwheel_label_templar_assassin_laugh"	"Laugh"
"dota_chatwheel_message_templar_assassin_thank"	"I'll take it."
"[english]dota_chatwheel_message_templar_assassin_thank"	"I'll take it."
"dota_chatwheel_label_templar_assassin_thank"	"I'll take it."
"[english]dota_chatwheel_label_templar_assassin_thank"	"I'll take it."
"dota_chatwheel_message_templar_assassin_2"	"It's a trap!"
"[english]dota_chatwheel_message_templar_assassin_2"	"It's a trap!"
"dota_chatwheel_label_templar_assassin_2"	"It's a trap!"
"[english]dota_chatwheel_label_templar_assassin_2"	"It's a trap!"
"dota_chatwheel_message_templar_assassin_4"	"Oh, snap!"
"[english]dota_chatwheel_message_templar_assassin_4"	"Oh, snap!"
"dota_chatwheel_label_templar_assassin_4"	"Oh, snap!"
"[english]dota_chatwheel_label_templar_assassin_4"	"Oh, snap!"
"dota_chatwheel_message_viper_laugh"	"Tehehehehar."
"[english]dota_chatwheel_message_viper_laugh"	"Tehehehehar."
"dota_chatwheel_label_viper_laugh"	"[大笑]"
"[english]dota_chatwheel_label_viper_laugh"	"Laugh"
"dota_chatwheel_label_luna_laugh"	"[大笑]"
"[english]dota_chatwheel_label_luna_laugh"	"Laugh"
"dota_chatwheel_message_luna_deny"	"Interesting!"
"[english]dota_chatwheel_message_luna_deny"	"Interesting!"
"dota_chatwheel_label_luna_deny"	"Interesting!"
"[english]dota_chatwheel_label_luna_deny"	"Interesting!"
"dota_chatwheel_label_dragon_knight_laugh"	"[大笑]"
"[english]dota_chatwheel_label_dragon_knight_laugh"	"Laugh"
"dota_chatwheel_message_dragon_knight_2"	"I'll take that."
"[english]dota_chatwheel_message_dragon_knight_2"	"I'll take that."
"dota_chatwheel_label_dragon_knight_2"	"I'll take that."
"[english]dota_chatwheel_label_dragon_knight_2"	"I'll take that."
"dota_chatwheel_message_dragon_knight_4"	"Of course."
"[english]dota_chatwheel_message_dragon_knight_4"	"Of course."
"dota_chatwheel_label_dragon_knight_4"	"Of course."
"[english]dota_chatwheel_label_dragon_knight_4"	"Of course."
"dota_chatwheel_label_dazzle_laugh"	"[大笑]"
"[english]dota_chatwheel_label_dazzle_laugh"	"Laugh"
"dota_chatwheel_message_dazzle_1"	"A dazzling death."
"[english]dota_chatwheel_message_dazzle_1"	"A dazzling death."
"dota_chatwheel_label_dazzle_1"	"A dazzling death."
"[english]dota_chatwheel_label_dazzle_1"	"A dazzling death."
"dota_chatwheel_message_dazzle_3"	"Jzap!"
"[english]dota_chatwheel_message_dazzle_3"	"Jzap!"
"dota_chatwheel_label_dazzle_3"	"Jzap!"
"[english]dota_chatwheel_label_dazzle_3"	"Jzap!"
"dota_chatwheel_message_dazzle_4"	"Tricked you."
"[english]dota_chatwheel_message_dazzle_4"	"Tricked you."
"dota_chatwheel_label_dazzle_4"	"Tricked you."
"[english]dota_chatwheel_label_dazzle_4"	"Tricked you."
"dota_chatwheel_label_rattletrap_laugh"	"[大笑]"
"[english]dota_chatwheel_label_rattletrap_laugh"	"Laugh"
"dota_chatwheel_message_rattletrap_3"	"Whoa!"
"[english]dota_chatwheel_message_rattletrap_3"	"Whoa!"
"dota_chatwheel_label_rattletrap_3"	"Whoa!"
"[english]dota_chatwheel_label_rattletrap_3"	"Whoa!"
"dota_chatwheel_label_leshrac_laugh"	"[大笑]"
"[english]dota_chatwheel_label_leshrac_laugh"	"Laugh"
"dota_chatwheel_message_leshrac_2"	"I'll take that."
"[english]dota_chatwheel_message_leshrac_2"	"I'll take that."
"dota_chatwheel_label_leshrac_2"	"I'll take that."
"[english]dota_chatwheel_label_leshrac_2"	"I'll take that."
"dota_chatwheel_label_furion_laugh"	"[大笑]"
"[english]dota_chatwheel_label_furion_laugh"	"Laugh"
"dota_chatwheel_message_furion_thank"	"Admirable."
"[english]dota_chatwheel_message_furion_thank"	"Admirable."
"dota_chatwheel_label_furion_thank"	"Admirable."
"[english]dota_chatwheel_label_furion_thank"	"Admirable."
"dota_chatwheel_message_furion_1"	"Feed the trees."
"[english]dota_chatwheel_message_furion_1"	"Feed the trees."
"dota_chatwheel_label_furion_1"	"Feed the trees."
"[english]dota_chatwheel_label_furion_1"	"Feed the trees."
"dota_chatwheel_message_furion_3"	"Very nice."
"[english]dota_chatwheel_message_furion_3"	"Very nice."
"dota_chatwheel_label_furion_3"	"Very nice."
"[english]dota_chatwheel_label_furion_3"	"Very nice."
"dota_chatwheel_message_furion_4"	"Aww, too bad."
"[english]dota_chatwheel_message_furion_4"	"Aww, too bad."
"dota_chatwheel_label_furion_4"	"Aww, too bad."
"[english]dota_chatwheel_label_furion_4"	"Aww, too bad."
"dota_chatwheel_message_life_stealer_laugh"	"Ha! Ha ha ha ha!"
"[english]dota_chatwheel_message_life_stealer_laugh"	"Ha! Ha ha ha ha!"
"dota_chatwheel_label_life_stealer_laugh"	"[大笑]"
"[english]dota_chatwheel_label_life_stealer_laugh"	"Laugh"
"dota_chatwheel_message_life_stealer_deny"	"Surprise!"
"[english]dota_chatwheel_message_life_stealer_deny"	"Surprise!"
"dota_chatwheel_label_life_stealer_deny"	"Surprise!"
"[english]dota_chatwheel_label_life_stealer_deny"	"Surprise!"
"dota_chatwheel_message_life_stealer_5"	"Ta-da!"
"[english]dota_chatwheel_message_life_stealer_5"	"Ta-da!"
"dota_chatwheel_label_life_stealer_5"	"Ta-da!"
"[english]dota_chatwheel_label_life_stealer_5"	"Ta-da!"
"dota_chatwheel_label_dark_seer_laugh"	"[大笑]"
"[english]dota_chatwheel_label_dark_seer_laugh"	"Laugh"
"dota_chatwheel_message_dark_seer_thank"	"Very good."
"[english]dota_chatwheel_message_dark_seer_thank"	"Very good."
"dota_chatwheel_label_dark_seer_thank"	"Very good."
"[english]dota_chatwheel_label_dark_seer_thank"	"Very good."
"dota_chatwheel_message_dark_seer_3"	"Hoooahahaaaheeh."
"[english]dota_chatwheel_message_dark_seer_3"	"Hoooahahaaaheeh."
"dota_chatwheel_label_dark_seer_3"	"Hoooahahaaaheeh."
"[english]dota_chatwheel_label_dark_seer_3"	"Hoooahahaaaheeh."
"dota_chatwheel_message_clinkz_laugh"	"Ah ha ha ha ha."
"[english]dota_chatwheel_message_clinkz_laugh"	"Ah ha ha ha ha."
"dota_chatwheel_label_clinkz_laugh"	"[大笑]"
"[english]dota_chatwheel_label_clinkz_laugh"	"Laugh"
"dota_chatwheel_message_clinkz_thank"	"Well done."
"[english]dota_chatwheel_message_clinkz_thank"	"Well done."
"dota_chatwheel_label_clinkz_thank"	"Well done."
"[english]dota_chatwheel_label_clinkz_thank"	"Well done."
"dota_chatwheel_message_clinkz_4"	"Yes!"
"[english]dota_chatwheel_message_clinkz_4"	"Yes!"
"dota_chatwheel_label_clinkz_4"	"Yes!"
"[english]dota_chatwheel_label_clinkz_4"	"Yes!"
"dota_chatwheel_label_omniknight_laugh"	"[大笑]"
"[english]dota_chatwheel_label_omniknight_laugh"	"Laugh"
"dota_chatwheel_message_omniknight_thank"	"Beautiful."
"[english]dota_chatwheel_message_omniknight_thank"	"Beautiful."
"dota_chatwheel_label_omniknight_thank"	"Beautiful."
"[english]dota_chatwheel_label_omniknight_thank"	"Beautiful."
"dota_chatwheel_message_omniknight_deny"	"Nailed it."
"[english]dota_chatwheel_message_omniknight_deny"	"Nailed it."
"dota_chatwheel_label_omniknight_deny"	"Nailed it."
"[english]dota_chatwheel_label_omniknight_deny"	"Nailed it."
"dota_chatwheel_label_enchantress_laugh"	"[大笑]"
"[english]dota_chatwheel_label_enchantress_laugh"	"Laugh"
"dota_chatwheel_message_enchantress_thank"	"I love winning!"
"[english]dota_chatwheel_message_enchantress_thank"	"I love winning!"
"dota_chatwheel_label_enchantress_thank"	"I love winning!"
"[english]dota_chatwheel_label_enchantress_thank"	"I love winning!"
"dota_chatwheel_message_enchantress_deny"	"Don't be mad."
"[english]dota_chatwheel_message_enchantress_deny"	"Don't be mad."
"dota_chatwheel_label_enchantress_deny"	"Don't be mad."
"[english]dota_chatwheel_label_enchantress_deny"	"Don't be mad."
"dota_chatwheel_message_enchantress_2"	"Hilarious."
"[english]dota_chatwheel_message_enchantress_2"	"Hilarious."
"dota_chatwheel_label_enchantress_2"	"Hilarious."
"[english]dota_chatwheel_label_enchantress_2"	"Hilarious."
"dota_chatwheel_message_enchantress_4"	"Sproink."
"[english]dota_chatwheel_message_enchantress_4"	"Sproink."
"dota_chatwheel_label_enchantress_4"	"Sproink."
"[english]dota_chatwheel_label_enchantress_4"	"Sproink."
"dota_chatwheel_message_huskar_laugh"	"Heh heh heeh."
"[english]dota_chatwheel_message_huskar_laugh"	"Heh heh heeh."
"dota_chatwheel_label_huskar_laugh"	"[大笑]"
"[english]dota_chatwheel_label_huskar_laugh"	"Laugh"
"dota_chatwheel_message_huskar_deny"	"Well worth it."
"[english]dota_chatwheel_message_huskar_deny"	"Well worth it."
"dota_chatwheel_label_huskar_deny"	"Well worth it."
"[english]dota_chatwheel_label_huskar_deny"	"Well worth it."
"dota_chatwheel_message_huskar_2"	"A fair trade!"
"[english]dota_chatwheel_message_huskar_2"	"A fair trade!"
"dota_chatwheel_label_huskar_2"	"A fair trade!"
"[english]dota_chatwheel_label_huskar_2"	"A fair trade!"
"dota_chatwheel_message_huskar_4"	"Is that all?"
"[english]dota_chatwheel_message_huskar_4"	"Is that all?"
"dota_chatwheel_label_huskar_4"	"Is that all?"
"[english]dota_chatwheel_label_huskar_4"	"Is that all?"
"dota_chatwheel_label_night_stalker_laugh"	"[大笑]"
"[english]dota_chatwheel_label_night_stalker_laugh"	"Laugh"
"dota_chatwheel_message_night_stalker_3"	"Darkness hungers."
"[english]dota_chatwheel_message_night_stalker_3"	"Darkness hungers."
"dota_chatwheel_label_night_stalker_3"	"Darkness hungers."
"[english]dota_chatwheel_label_night_stalker_3"	"Darkness hungers."
"dota_chatwheel_message_broodmother_laugh"	"Ha ha ha ha ha."
"[english]dota_chatwheel_message_broodmother_laugh"	"Ha ha ha ha ha."
"dota_chatwheel_label_broodmother_laugh"	"[大笑]"
"[english]dota_chatwheel_label_broodmother_laugh"	"Laugh"
"dota_chatwheel_label_broodmother_thank"	"A lovely brood."
"[english]dota_chatwheel_label_broodmother_thank"	"A lovely brood."
"dota_chatwheel_message_broodmother_1"	"Delicious."
"[english]dota_chatwheel_message_broodmother_1"	"Delicious."
"dota_chatwheel_label_broodmother_1"	"Delicious."
"[english]dota_chatwheel_label_broodmother_1"	"Delicious."
"dota_chatwheel_message_broodmother_4"	"Oh so beautiful."
"[english]dota_chatwheel_message_broodmother_4"	"Oh so beautiful."
"dota_chatwheel_message_broodmother_5"	"Sss-sss-ssslurp!"
"[english]dota_chatwheel_message_broodmother_5"	"Sss-sss-ssslurp!"
"dota_chatwheel_label_broodmother_5"	"Slurp."
"[english]dota_chatwheel_label_broodmother_5"	"Slurp."
"dota_chatwheel_label_bounty_hunter_laugh"	"[大笑]"
"[english]dota_chatwheel_label_bounty_hunter_laugh"	"Laugh"
"dota_chatwheel_label_bounty_hunter_1"	"Just business..."
"[english]dota_chatwheel_label_bounty_hunter_1"	"Just business..."
"dota_chatwheel_message_weaver_laugh"	"Hehehhehah!"
"[english]dota_chatwheel_message_weaver_laugh"	"Hehehhehah!"
"dota_chatwheel_label_weaver_laugh"	"[大笑]"
"[english]dota_chatwheel_label_weaver_laugh"	"Laugh"
"dota_chatwheel_message_weaver_5"	"Ho, snap!"
"[english]dota_chatwheel_message_weaver_5"	"Ho, snap!"
"dota_chatwheel_label_weaver_5"	"Ho, snap!"
"[english]dota_chatwheel_label_weaver_5"	"Ho, snap!"
"dota_chatwheel_label_jakiro_laugh"	"[大笑]"
"[english]dota_chatwheel_label_jakiro_laugh"	"Laugh"
"dota_chatwheel_message_jakiro_thank"	"Cheers."
"[english]dota_chatwheel_message_jakiro_thank"	"Cheers."
"dota_chatwheel_label_jakiro_thank"	"Cheers."
"[english]dota_chatwheel_label_jakiro_thank"	"Cheers."
"dota_chatwheel_message_jakiro_1"	"Burninated."
"[english]dota_chatwheel_message_jakiro_1"	"Burninated."
"dota_chatwheel_label_jakiro_1"	"Burninated!"
"[english]dota_chatwheel_label_jakiro_1"	"Burninated!"
"dota_chatwheel_message_batrider_laugh"	"He ha ha!"
"[english]dota_chatwheel_message_batrider_laugh"	"He ha ha!"
"dota_chatwheel_label_batrider_laugh"	"[大笑]"
"[english]dota_chatwheel_label_batrider_laugh"	"Laugh"
"dota_chatwheel_label_batrider_1"	"Into the sunset!"
"[english]dota_chatwheel_label_batrider_1"	"Into the sunset!"
"dota_chatwheel_message_batrider_4"	"Whoa, sick burn!"
"[english]dota_chatwheel_message_batrider_4"	"Whoa, sick burn!"
"dota_chatwheel_label_batrider_4"	"Sick burn!"
"[english]dota_chatwheel_label_batrider_4"	"Sick burn!"
"dota_chatwheel_message_batrider_5"	"That was lame."
"[english]dota_chatwheel_message_batrider_5"	"That was lame."
"dota_chatwheel_label_batrider_5"	"That was lame."
"[english]dota_chatwheel_label_batrider_5"	"That was lame."
"dota_chatwheel_message_chen_laugh"	"Hehehmehmehmmm."
"[english]dota_chatwheel_message_chen_laugh"	"Hehehmehmehmmm."
"dota_chatwheel_label_chen_laugh"	"[大笑]"
"[english]dota_chatwheel_label_chen_laugh"	"Laugh"
"dota_chatwheel_message_chen_thank"	"Oh, thank God."
"[english]dota_chatwheel_message_chen_thank"	"Oh, thank God."
"dota_chatwheel_label_chen_thank"	"Oh, thank God."
"[english]dota_chatwheel_label_chen_thank"	"Oh, thank God."
"dota_chatwheel_message_chen_1"	"Found unworthy."
"[english]dota_chatwheel_message_chen_1"	"Found unworthy."
"dota_chatwheel_label_chen_1"	"Found unworthy."
"[english]dota_chatwheel_label_chen_1"	"Found unworthy."
"dota_chatwheel_label_spectre_laugh"	"[大笑]"
"[english]dota_chatwheel_label_spectre_laugh"	"[Laugh]"
"dota_chatwheel_message_spectre_deny"	"Wrong."
"[english]dota_chatwheel_message_spectre_deny"	"Wrong."
"dota_chatwheel_label_spectre_deny"	"Wrong."
"[english]dota_chatwheel_label_spectre_deny"	"Wrong."
"dota_chatwheel_message_spectre_2"	"What is this?"
"[english]dota_chatwheel_message_spectre_2"	"What is this?"
"dota_chatwheel_label_spectre_2"	"What is this?"
"[english]dota_chatwheel_label_spectre_2"	"What is this?"
"dota_chatwheel_message_spectre_3"	"A useful skill."
"[english]dota_chatwheel_message_spectre_3"	"A useful skill."
"dota_chatwheel_label_spectre_3"	"A useful skill."
"[english]dota_chatwheel_label_spectre_3"	"A useful skill."
"dota_chatwheel_label_ancient_apparition_laugh"	"[大笑]"
"[english]dota_chatwheel_label_ancient_apparition_laugh"	"Laugh"
"dota_chatwheel_message_ancient_apparition_thank"	"Interesting."
"[english]dota_chatwheel_message_ancient_apparition_thank"	"Interesting."
"dota_chatwheel_label_ancient_apparition_thank"	"Interesting."
"[english]dota_chatwheel_label_ancient_apparition_thank"	"Interesting."
"dota_chatwheel_message_ancient_apparition_deny"	"A cold wind blows."
"[english]dota_chatwheel_message_ancient_apparition_deny"	"A cold wind blows."
"dota_chatwheel_label_ancient_apparition_deny"	"A cold wind blows."
"[english]dota_chatwheel_label_ancient_apparition_deny"	"A cold wind blows."
"dota_chatwheel_label_ancient_apparition_3"	"I waited ages..."
"[english]dota_chatwheel_label_ancient_apparition_3"	"I waited ages..."
"dota_chatwheel_label_ancient_apparition_4"	"Break the ice."
"[english]dota_chatwheel_label_ancient_apparition_4"	"Break the ice."
"dota_chatwheel_message_ancient_apparition_5"	"Icefog!"
"[english]dota_chatwheel_message_ancient_apparition_5"	"Icefog!"
"dota_chatwheel_label_ancient_apparition_5"	"Icefog!"
"[english]dota_chatwheel_label_ancient_apparition_5"	"Icefog!"
"dota_chatwheel_label_doom_bringer_laugh"	"[大笑]"
"[english]dota_chatwheel_label_doom_bringer_laugh"	"Laugh"
"dota_chatwheel_message_doom_bringer_thank"	"Oh, yes."
"[english]dota_chatwheel_message_doom_bringer_thank"	"Oh, yes."
"dota_chatwheel_label_doom_bringer_thank"	"Oh, yes."
"[english]dota_chatwheel_label_doom_bringer_thank"	"Oh, yes."
"dota_chatwheel_message_doom_bringer_3"	"Oh, crap."
"[english]dota_chatwheel_message_doom_bringer_3"	"Oh, crap."
"dota_chatwheel_label_doom_bringer_3"	"Oh, crap!"
"[english]dota_chatwheel_label_doom_bringer_3"	"Oh, crap!"
"dota_chatwheel_label_ursa_laugh"	"[大笑]"
"[english]dota_chatwheel_label_ursa_laugh"	"Laugh"
"dota_chatwheel_label_ursa_deny"	"A loss so small."
"[english]dota_chatwheel_label_ursa_deny"	"A loss so small."
"dota_chatwheel_message_ursa_1"	"A poor defense."
"[english]dota_chatwheel_message_ursa_1"	"A poor defense."
"dota_chatwheel_label_ursa_1"	"A poor defense."
"[english]dota_chatwheel_label_ursa_1"	"A poor defense."
"dota_chatwheel_message_ursa_2"	"Fuzzy Wuzzy!"
"[english]dota_chatwheel_message_ursa_2"	"Fuzzy Wuzzy!"
"dota_chatwheel_label_ursa_2"	"Fuzzy Wuzzy!"
"[english]dota_chatwheel_label_ursa_2"	"Fuzzy Wuzzy!"
"dota_chatwheel_message_ursa_4"	"Sweet as honey."
"[english]dota_chatwheel_message_ursa_4"	"Sweet as honey."
"dota_chatwheel_label_ursa_4"	"Sweet as honey."
"[english]dota_chatwheel_label_ursa_4"	"Sweet as honey."
"dota_chatwheel_label_ursa_5"	"Mm, not bad."
"[english]dota_chatwheel_label_ursa_5"	"Mm, not bad."
"dota_chatwheel_message_spirit_breaker_laugh"	"Whoheheheahahah."
"[english]dota_chatwheel_message_spirit_breaker_laugh"	"Whoheheheahahah."
"dota_chatwheel_label_spirit_breaker_laugh"	"[大笑]"
"[english]dota_chatwheel_label_spirit_breaker_laugh"	"Laugh"
"dota_chatwheel_label_gyrocopter_laugh"	"[大笑]"
"[english]dota_chatwheel_label_gyrocopter_laugh"	"Laugh"
"dota_chatwheel_message_gyrocopter_deny"	"Aaah phooey."
"[english]dota_chatwheel_message_gyrocopter_deny"	"Aaah phooey."
"dota_chatwheel_label_gyrocopter_deny"	"Aaah phooey!"
"[english]dota_chatwheel_label_gyrocopter_deny"	"Aaah phooey!"
"dota_chatwheel_message_gyrocopter_1"	"Lucky!"
"[english]dota_chatwheel_message_gyrocopter_1"	"Lucky!"
"dota_chatwheel_label_gyrocopter_1"	"Lucky!"
"[english]dota_chatwheel_label_gyrocopter_1"	"Lucky!"
"dota_chatwheel_message_gyrocopter_3"	"Get off my lawn!"
"[english]dota_chatwheel_message_gyrocopter_3"	"Get off my lawn!"
"dota_chatwheel_label_gyrocopter_3"	"Get off my lawn!"
"[english]dota_chatwheel_label_gyrocopter_3"	"Get off my lawn!"
"dota_chatwheel_message_alchemist_laugh"	"Ha ha ha ha ha!"
"[english]dota_chatwheel_message_alchemist_laugh"	"Ha ha ha ha ha!"
"dota_chatwheel_label_alchemist_laugh"	"[大笑]"
"[english]dota_chatwheel_label_alchemist_laugh"	"Laugh"
"dota_chatwheel_label_alchemist_thank"	"Good chemistry!"
"[english]dota_chatwheel_label_alchemist_thank"	"Good chemistry!"
"dota_chatwheel_message_alchemist_deny"	"That was genius!"
"[english]dota_chatwheel_message_alchemist_deny"	"That was genius!"
"dota_chatwheel_label_alchemist_deny"	"That was genius!"
"[english]dota_chatwheel_label_alchemist_deny"	"That was genius!"
"dota_chatwheel_message_alchemist_1"	"Hey, everybody!"
"[english]dota_chatwheel_message_alchemist_1"	"Hey, everybody!"
"dota_chatwheel_label_alchemist_1"	"Hey everybody."
"[english]dota_chatwheel_label_alchemist_1"	"Hey everybody."
"dota_chatwheel_message_alchemist_4"	"What a mess!"
"[english]dota_chatwheel_message_alchemist_4"	"What a mess!"
"dota_chatwheel_label_alchemist_4"	"What a mess!"
"[english]dota_chatwheel_label_alchemist_4"	"What a mess!"
"dota_chatwheel_label_invoker_laugh"	"[大笑]"
"[english]dota_chatwheel_label_invoker_laugh"	"Laugh"
"dota_chatwheel_message_invoker_2"	"Fight me!"
"[english]dota_chatwheel_message_invoker_2"	"Fight me!"
"dota_chatwheel_label_invoker_2"	"Fight me!"
"[english]dota_chatwheel_label_invoker_2"	"Fight me!"
"dota_chatwheel_label_invoker_5"	"Name of power."
"[english]dota_chatwheel_label_invoker_5"	"Name of power."
"dota_chatwheel_message_silencer_laugh"	"Ah ha ha."
"[english]dota_chatwheel_message_silencer_laugh"	"Ah ha ha."
"dota_chatwheel_label_silencer_laugh"	"[大笑]"
"[english]dota_chatwheel_label_silencer_laugh"	"Laugh"
"dota_chatwheel_message_silencer_1"	"Calm yourselves."
"[english]dota_chatwheel_message_silencer_1"	"Calm yourselves."
"dota_chatwheel_label_silencer_1"	"Calm yourselves"
"[english]dota_chatwheel_label_silencer_1"	"Calm yourselves"
"dota_chatwheel_message_silencer_2"	"What a racket."
"[english]dota_chatwheel_message_silencer_2"	"What a racket."
"dota_chatwheel_label_silencer_2"	"What a racket."
"[english]dota_chatwheel_label_silencer_2"	"What a racket."
"dota_chatwheel_message_silencer_3"	"Silence, fool!"
"[english]dota_chatwheel_message_silencer_3"	"Silence, fool!"
"dota_chatwheel_label_silencer_3"	"Silence, fool."
"[english]dota_chatwheel_label_silencer_3"	"Silence, fool."
"dota_chatwheel_message_silencer_4"	"All for naught."
"[english]dota_chatwheel_message_silencer_4"	"All for naught."
"dota_chatwheel_label_silencer_4"	"All for naught."
"[english]dota_chatwheel_label_silencer_4"	"All for naught."
"dota_chatwheel_message_silencer_5"	"Shhh, did you hear something?"
"[english]dota_chatwheel_message_silencer_5"	"Shhh, did you hear something?"
"dota_chatwheel_label_silencer_5"	"Shhh, did you hear something?"
"[english]dota_chatwheel_label_silencer_5"	"Shhh, did you hear something?"
"dota_chatwheel_message_obsidian_destroyer_laugh"	"Ha ha ha ha ha ha ha ha ha!"
"[english]dota_chatwheel_message_obsidian_destroyer_laugh"	"Ha ha ha ha ha ha ha ha ha!"
"dota_chatwheel_label_obsidian_destroyer_laugh"	"[大笑]"
"[english]dota_chatwheel_label_obsidian_destroyer_laugh"	"Laugh"
"dota_chatwheel_message_obsidian_destroyer_thank"	"I have solid intelligence on what is to come."
"[english]dota_chatwheel_message_obsidian_destroyer_thank"	"I have solid intelligence on what is to come."
"dota_chatwheel_label_obsidian_destroyer_thank"	"What is to come."
"[english]dota_chatwheel_label_obsidian_destroyer_thank"	"What is to come."
"dota_chatwheel_message_obsidian_destroyer_deny"	"My purpose fulfilled."
"[english]dota_chatwheel_message_obsidian_destroyer_deny"	"My purpose fulfilled."
"dota_chatwheel_label_obsidian_destroyer_deny"	"My purpose fulfilled."
"[english]dota_chatwheel_label_obsidian_destroyer_deny"	"My purpose fulfilled."
"dota_chatwheel_message_obsidian_destroyer_1"	"Your future is grim."
"[english]dota_chatwheel_message_obsidian_destroyer_1"	"Your future is grim."
"dota_chatwheel_label_obsidian_destroyer_1"	"Your future is grim."
"[english]dota_chatwheel_label_obsidian_destroyer_1"	"Your future is grim."
"dota_chatwheel_message_obsidian_destroyer_2"	"This changes nothing."
"[english]dota_chatwheel_message_obsidian_destroyer_2"	"This changes nothing."
"dota_chatwheel_label_obsidian_destroyer_2"	"This changes nothing."
"[english]dota_chatwheel_label_obsidian_destroyer_2"	"This changes nothing."
"dota_chatwheel_message_obsidian_destroyer_3"	"You let yourself get carried away."
"[english]dota_chatwheel_message_obsidian_destroyer_3"	"You let yourself get carried away."
"dota_chatwheel_label_obsidian_destroyer_3"	"You let yourself get carried away"
"[english]dota_chatwheel_label_obsidian_destroyer_3"	"You let yourself get carried away"
"dota_chatwheel_message_obsidian_destroyer_4"	"I am ill disposed towards you."
"[english]dota_chatwheel_message_obsidian_destroyer_4"	"I am ill disposed towards you."
"dota_chatwheel_label_obsidian_destroyer_4"	"I am ill disposed..."
"[english]dota_chatwheel_label_obsidian_destroyer_4"	"I am ill disposed..."
"dota_chatwheel_message_obsidian_destroyer_5"	"You're insane."
"[english]dota_chatwheel_message_obsidian_destroyer_5"	"You're insane."
"dota_chatwheel_label_obsidian_destroyer_5"	"You're insane."
"[english]dota_chatwheel_label_obsidian_destroyer_5"	"You're insane."
"dota_chatwheel_message_lycan_laugh"	"Ah ha ha ha ha ha ha ha."
"[english]dota_chatwheel_message_lycan_laugh"	"Ah ha ha ha ha ha ha ha."
"dota_chatwheel_label_lycan_laugh"	"[大笑]"
"[english]dota_chatwheel_label_lycan_laugh"	"Laugh"
"dota_chatwheel_message_lycan_thank"	"You fought well and true."
"[english]dota_chatwheel_message_lycan_thank"	"You fought well and true."
"dota_chatwheel_label_lycan_thank"	"You fought well and true."
"[english]dota_chatwheel_label_lycan_thank"	"You fought well and true."
"dota_chatwheel_message_lycan_deny"	"Go ahead, just try to kill me!"
"[english]dota_chatwheel_message_lycan_deny"	"Go ahead, just try to kill me!"
"dota_chatwheel_label_lycan_deny"	"Just try to kill me!"
"[english]dota_chatwheel_label_lycan_deny"	"Just try to kill me!"
"dota_chatwheel_message_lycan_1"	"Ha! That was a mauling."
"[english]dota_chatwheel_message_lycan_1"	"Ha! That was a mauling."
"dota_chatwheel_label_lycan_1"	"That was a mauling"
"[english]dota_chatwheel_label_lycan_1"	"That was a mauling"
"dota_chatwheel_message_lycan_2"	"I am the alpha wolf."
"[english]dota_chatwheel_message_lycan_2"	"I am the alpha wolf."
"dota_chatwheel_label_lycan_2"	"I am the alpha wolf"
"[english]dota_chatwheel_label_lycan_2"	"I am the alpha wolf"
"dota_chatwheel_message_lycan_3"	"The wolf is at your door."
"[english]dota_chatwheel_message_lycan_3"	"The wolf is at your door."
"dota_chatwheel_label_lycan_3"	"The wolf is at your door."
"[english]dota_chatwheel_label_lycan_3"	"The wolf is at your door."
"dota_chatwheel_message_lycan_4"	"Wolves need no armor."
"[english]dota_chatwheel_message_lycan_4"	"Wolves need no armor."
"dota_chatwheel_label_lycan_4"	"Wolves need no armor."
"[english]dota_chatwheel_label_lycan_4"	"Wolves need no armor."
"dota_chatwheel_message_lycan_5"	"I've taken a Lycan to you. Ha ha ha ha ha."
"[english]dota_chatwheel_message_lycan_5"	"I've taken a Lycan to you. Ha ha ha ha ha."
"dota_chatwheel_label_lycan_5"	"I've taken a Lycan..."
"[english]dota_chatwheel_label_lycan_5"	"I've taken a Lycan..."
"dota_chatwheel_message_brewmaster_laugh"	"Hehaahehah."
"[english]dota_chatwheel_message_brewmaster_laugh"	"Hehaahehah."
"dota_chatwheel_label_brewmaster_laugh"	"[大笑]"
"[english]dota_chatwheel_label_brewmaster_laugh"	"Laugh"
"dota_chatwheel_message_brewmaster_thank"	"Ah, I love you guys."
"[english]dota_chatwheel_message_brewmaster_thank"	"Ah, I love you guys."
"dota_chatwheel_label_brewmaster_thank"	"Love you guys."
"[english]dota_chatwheel_label_brewmaster_thank"	"Love you guys."
"dota_chatwheel_message_brewmaster_deny"	"Better luck next time."
"[english]dota_chatwheel_message_brewmaster_deny"	"Better luck next time."
"dota_chatwheel_label_brewmaster_deny"	"Better luck next time."
"[english]dota_chatwheel_label_brewmaster_deny"	"Better luck next time."
"dota_chatwheel_message_brewmaster_1"	"Now I'm feeling it."
"[english]dota_chatwheel_message_brewmaster_1"	"Now I'm feeling it."
"dota_chatwheel_label_brewmaster_1"	"Now I'm feeling it!"
"[english]dota_chatwheel_label_brewmaster_1"	"Now I'm feeling it!"
"dota_chatwheel_message_brewmaster_2"	"Oh, so bubbly!"
"[english]dota_chatwheel_message_brewmaster_2"	"Oh, so bubbly!"
"dota_chatwheel_label_brewmaster_2"	"Oh, so bubbly!"
"[english]dota_chatwheel_label_brewmaster_2"	"Oh, so bubbly!"
"dota_chatwheel_message_brewmaster_3"	"What's wrong? Can't hold your liquor?"
"[english]dota_chatwheel_message_brewmaster_3"	"What's wrong? Can't hold your liquor?"
"dota_chatwheel_label_brewmaster_3"	"What's wrong? Can't hold your liquor?"
"[english]dota_chatwheel_label_brewmaster_3"	"What's wrong? Can't hold your liquor?"
"dota_chatwheel_message_brewmaster_4"	"It's happy hour!"
"[english]dota_chatwheel_message_brewmaster_4"	"It's happy hour!"
"dota_chatwheel_label_brewmaster_4"	"It's happy hour!"
"[english]dota_chatwheel_label_brewmaster_4"	"It's happy hour!"
"dota_chatwheel_message_brewmaster_5"	"What kind of pub is this?"
"[english]dota_chatwheel_message_brewmaster_5"	"What kind of pub is this?"
"dota_chatwheel_label_brewmaster_5"	"What kind of pub is this?"
"[english]dota_chatwheel_label_brewmaster_5"	"What kind of pub is this?"
"dota_chatwheel_message_shadow_demon_laugh"	"Ha ha ha ha ha ha ha ha ha ha."
"[english]dota_chatwheel_message_shadow_demon_laugh"	"Ha ha ha ha ha ha ha ha ha ha."
"dota_chatwheel_label_shadow_demon_laugh"	"[大笑]"
"[english]dota_chatwheel_label_shadow_demon_laugh"	"Laugh"
"dota_chatwheel_message_shadow_demon_thank"	"And they thought it could get no darker."
"[english]dota_chatwheel_message_shadow_demon_thank"	"And they thought it could get no darker."
"dota_chatwheel_label_shadow_demon_thank"	"They thought..."
"[english]dota_chatwheel_label_shadow_demon_thank"	"They thought..."
"dota_chatwheel_message_shadow_demon_deny"	"You conspired against me."
"[english]dota_chatwheel_message_shadow_demon_deny"	"You conspired against me."
"dota_chatwheel_message_shadow_demon_2"	"Fall before me!"
"[english]dota_chatwheel_message_shadow_demon_2"	"Fall before me!"
"dota_chatwheel_label_shadow_demon_2"	"Fall before me."
"[english]dota_chatwheel_label_shadow_demon_2"	"Fall before me."
"dota_chatwheel_message_shadow_demon_4"	"Bow down."
"[english]dota_chatwheel_message_shadow_demon_4"	"Bow down."
"dota_chatwheel_label_shadow_demon_4"	"Bow down."
"[english]dota_chatwheel_label_shadow_demon_4"	"Bow down."
"dota_chatwheel_message_shadow_demon_5"	"Cry some more."
"[english]dota_chatwheel_message_shadow_demon_5"	"Cry some more."
"dota_chatwheel_label_shadow_demon_5"	"Cry some more."
"[english]dota_chatwheel_label_shadow_demon_5"	"Cry some more."
"dota_chatwheel_label_lone_druid_laugh"	"[大笑]"
"[english]dota_chatwheel_label_lone_druid_laugh"	"Laugh"
"dota_chatwheel_message_lone_druid_deny"	"Ah, my old self!"
"[english]dota_chatwheel_message_lone_druid_deny"	"Ah, my old self!"
"dota_chatwheel_label_lone_druid_deny"	"Ah, my old self!"
"[english]dota_chatwheel_label_lone_druid_deny"	"Ah, my old self!"
"dota_chatwheel_message_lone_druid_1"	"Synergy!"
"[english]dota_chatwheel_message_lone_druid_1"	"Synergy!"
"dota_chatwheel_label_lone_druid_1"	"Synergy!"
"[english]dota_chatwheel_label_lone_druid_1"	"Synergy!"
"dota_chatwheel_message_lone_druid_5"	"Auuuuuhhh!"
"[english]dota_chatwheel_message_lone_druid_5"	"Auuuuuhhh!"
"dota_chatwheel_label_lone_druid_5"	"Auuuuuhhh!"
"[english]dota_chatwheel_label_lone_druid_5"	"Auuuuuhhh!"
"dota_chatwheel_label_chaos_knight_laugh"	"[大笑]"
"[english]dota_chatwheel_label_chaos_knight_laugh"	"Laugh"
"dota_chatwheel_message_chaos_knight_thank"	"Yes. Yes!"
"[english]dota_chatwheel_message_chaos_knight_thank"	"Yes. Yes!"
"dota_chatwheel_label_chaos_knight_thank"	"Yes. Yes!"
"[english]dota_chatwheel_label_chaos_knight_thank"	"Yes. Yes!"
"dota_chatwheel_label_chaos_knight_deny"	"Consign to dust."
"[english]dota_chatwheel_label_chaos_knight_deny"	"Consign to dust."
"dota_chatwheel_label_meepo_laugh"	"[大笑]"
"[english]dota_chatwheel_label_meepo_laugh"	"Laugh"
"dota_chatwheel_message_meepo_deny"	"How ya doin?"
"[english]dota_chatwheel_message_meepo_deny"	"How ya doin?"
"dota_chatwheel_label_meepo_deny"	"How ya doin?"
"[english]dota_chatwheel_label_meepo_deny"	"How ya doin?"
"dota_chatwheel_label_meepo_4"	"I feel fine."
"[english]dota_chatwheel_label_meepo_4"	"I feel fine."
"dota_chatwheel_label_treant_laugh"	"[大笑]"
"[english]dota_chatwheel_label_treant_laugh"	"Laugh"
"dota_chatwheel_message_treant_1"	"Are you lost?"
"[english]dota_chatwheel_message_treant_1"	"Are you lost?"
"dota_chatwheel_label_treant_1"	"Are you lost?"
"[english]dota_chatwheel_label_treant_1"	"Are you lost?"
"dota_chatwheel_message_treant_2"	"Careful."
"[english]dota_chatwheel_message_treant_2"	"Careful."
"dota_chatwheel_label_treant_2"	"Careful."
"[english]dota_chatwheel_label_treant_2"	"Careful."
"dota_chatwheel_label_treant_5"	"What happened?"
"[english]dota_chatwheel_label_treant_5"	"What happened?"
"dota_chatwheel_label_ogre_magi_laugh"	"[大笑]"
"[english]dota_chatwheel_label_ogre_magi_laugh"	"Laugh"
"dota_chatwheel_label_ogre_magi_thank"	"Pure skill."
"[english]dota_chatwheel_label_ogre_magi_thank"	"Pure skill."
"dota_chatwheel_label_ogre_magi_1"	"Expertise from the experts."
"[english]dota_chatwheel_label_ogre_magi_1"	"Expertise from the experts."
"dota_chatwheel_message_ogre_magi_2"	"Good work. I thought that was you."
"[english]dota_chatwheel_message_ogre_magi_2"	"Good work. I thought that was you."
"dota_chatwheel_label_ogre_magi_2"	"Good work!"
"[english]dota_chatwheel_label_ogre_magi_2"	"Good work!"
"dota_chatwheel_message_ogre_magi_3"	"You need to work on your skill. Like us."
"[english]dota_chatwheel_message_ogre_magi_3"	"You need to work on your skill. Like us."
"dota_chatwheel_label_ogre_magi_3"	"You need to work on your skill."
"[english]dota_chatwheel_label_ogre_magi_3"	"You need to work on your skill."
"dota_chatwheel_message_ogre_magi_4"	"We gave you a head start!"
"[english]dota_chatwheel_message_ogre_magi_4"	"We gave you a head start!"
"dota_chatwheel_label_ogre_magi_4"	"We gave you a head start!"
"[english]dota_chatwheel_label_ogre_magi_4"	"We gave you a head start!"
"dota_chatwheel_message_ogre_magi_5"	"That had to hurt. I almost feel bad."
"[english]dota_chatwheel_message_ogre_magi_5"	"That had to hurt. I almost feel bad."
"dota_chatwheel_label_ogre_magi_5"	"That had to hurt."
"[english]dota_chatwheel_label_ogre_magi_5"	"That had to hurt."
"dota_chatwheel_message_undying_laugh"	"Heh heh heh heh ha ha ha ha ha ha ha ha ha ha!"
"[english]dota_chatwheel_message_undying_laugh"	"Heh heh heh heh ha ha ha ha ha ha ha ha ha ha!"
"dota_chatwheel_label_undying_laugh"	"[大笑]"
"[english]dota_chatwheel_label_undying_laugh"	"Laugh"
"dota_chatwheel_message_undying_thank"	"Tktktk sing your praises."
"[english]dota_chatwheel_message_undying_thank"	"Tktktk sing your praises."
"dota_chatwheel_label_undying_thank"	"Sing your praises"
"[english]dota_chatwheel_label_undying_thank"	"Sing your praises"
"dota_chatwheel_message_undying_deny"	"The maggots clean you."
"[english]dota_chatwheel_message_undying_deny"	"The maggots clean you."
"dota_chatwheel_label_undying_deny"	"The maggots clean you."
"[english]dota_chatwheel_label_undying_deny"	"The maggots clean you."
"dota_chatwheel_message_undying_1"	"I hate life."
"[english]dota_chatwheel_message_undying_1"	"I hate life."
"dota_chatwheel_label_undying_1"	"I hate life"
"[english]dota_chatwheel_label_undying_1"	"I hate life"
"dota_chatwheel_message_undying_2"	"I need… gummy vitamins."
"[english]dota_chatwheel_message_undying_2"	"I need… gummy vitamins."
"dota_chatwheel_label_undying_2"	"I need… gummy vitamins."
"[english]dota_chatwheel_label_undying_2"	"I need… gummy vitamins."
"dota_chatwheel_message_undying_3"	"No hells. No heavens. Only this."
"[english]dota_chatwheel_message_undying_3"	"No hells. No heavens. Only this."
"dota_chatwheel_label_undying_3"	"Only this."
"[english]dota_chatwheel_label_undying_3"	"Only this."
"dota_chatwheel_message_undying_4"	"Not feed."
"[english]dota_chatwheel_message_undying_4"	"Not feed."
"dota_chatwheel_label_undying_4"	"Not feed"
"[english]dota_chatwheel_label_undying_4"	"Not feed"
"dota_chatwheel_message_undying_5"	"No brains."
"[english]dota_chatwheel_message_undying_5"	"No brains."
"dota_chatwheel_label_undying_5"	"No brains."
"[english]dota_chatwheel_label_undying_5"	"No brains."
"dota_chatwheel_message_rubick_laugh"	"Ah ha ha! Eh he he he he he he he he he!"
"[english]dota_chatwheel_message_rubick_laugh"	"Ah ha ha! Eh he he he he he he he he he!"
"dota_chatwheel_label_rubick_laugh"	"[大笑]"
"[english]dota_chatwheel_label_rubick_laugh"	"Laugh"
"dota_chatwheel_message_rubick_thank"	"Excellent idea!"
"[english]dota_chatwheel_message_rubick_thank"	"Excellent idea!"
"dota_chatwheel_label_rubick_thank"	"Excellent idea!"
"[english]dota_chatwheel_label_rubick_thank"	"Excellent idea!"
"dota_chatwheel_message_rubick_deny"	"I almost feel bad."
"[english]dota_chatwheel_message_rubick_deny"	"I almost feel bad."
"dota_chatwheel_label_rubick_deny"	"I almost feel bad."
"[english]dota_chatwheel_label_rubick_deny"	"I almost feel bad."
"dota_chatwheel_message_rubick_1"	"That perked me up a bit!"
"[english]dota_chatwheel_message_rubick_1"	"That perked me up a bit!"
"dota_chatwheel_label_rubick_1"	"That perked me up!"
"[english]dota_chatwheel_label_rubick_1"	"That perked me up!"
"dota_chatwheel_message_rubick_2"	"Your name offends me."
"[english]dota_chatwheel_message_rubick_2"	"Your name offends me."
"dota_chatwheel_label_rubick_2"	"Your name offends me."
"[english]dota_chatwheel_label_rubick_2"	"Your name offends me."
"dota_chatwheel_message_rubick_3"	"What a surprise!"
"[english]dota_chatwheel_message_rubick_3"	"What a surprise!"
"dota_chatwheel_label_rubick_3"	"What a surprise!"
"[english]dota_chatwheel_label_rubick_3"	"What a surprise!"
"dota_chatwheel_message_rubick_4"	"Whoops!"
"[english]dota_chatwheel_message_rubick_4"	"Whoops!"
"dota_chatwheel_label_rubick_4"	"Whoops!"
"[english]dota_chatwheel_label_rubick_4"	"Whoops!"
"dota_chatwheel_message_rubick_5"	"Exquisite! Absolutely exquisite!"
"[english]dota_chatwheel_message_rubick_5"	"Exquisite! Absolutely exquisite!"
"dota_chatwheel_label_rubick_5"	"Exquisite!"
"[english]dota_chatwheel_label_rubick_5"	"Exquisite!"
"dota_chatwheel_message_disruptor_laugh"	"Heheha."
"[english]dota_chatwheel_message_disruptor_laugh"	"Heheha."
"dota_chatwheel_label_disruptor_laugh"	"[大笑]"
"[english]dota_chatwheel_label_disruptor_laugh"	"Laugh"
"dota_chatwheel_message_disruptor_thank"	"Now that's more like it."
"[english]dota_chatwheel_message_disruptor_thank"	"Now that's more like it."
"dota_chatwheel_label_disruptor_thank"	"Now that's more like it!"
"[english]dota_chatwheel_label_disruptor_thank"	"Now that's more like it!"
"dota_chatwheel_message_disruptor_deny"	"I'm ecstatic!"
"[english]dota_chatwheel_message_disruptor_deny"	"I'm ecstatic!"
"dota_chatwheel_label_disruptor_deny"	"I'm ecstatic!"
"[english]dota_chatwheel_label_disruptor_deny"	"I'm ecstatic!"
"dota_chatwheel_message_disruptor_1"	"What weathermancery is this?"
"[english]dota_chatwheel_message_disruptor_1"	"What weathermancery is this?"
"dota_chatwheel_label_disruptor_1"	"What weathermancery is this?"
"[english]dota_chatwheel_label_disruptor_1"	"What weathermancery is this?"
"dota_chatwheel_message_disruptor_2"	"You've been disrupted."
"[english]dota_chatwheel_message_disruptor_2"	"You've been disrupted."
"dota_chatwheel_label_disruptor_2"	"Disrupted"
"[english]dota_chatwheel_label_disruptor_2"	"Disrupted"
"dota_chatwheel_message_disruptor_3"	"They're trying to kill me."
"[english]dota_chatwheel_message_disruptor_3"	"They're trying to kill me."
"dota_chatwheel_label_disruptor_3"	"They're trying to kill me!"
"[english]dota_chatwheel_label_disruptor_3"	"They're trying to kill me!"
"dota_chatwheel_message_disruptor_4"	"I call down the thunder."
"[english]dota_chatwheel_message_disruptor_4"	"I call down the thunder."
"dota_chatwheel_label_disruptor_4"	"I call down the thunder."
"[english]dota_chatwheel_label_disruptor_4"	"I call down the thunder."
"dota_chatwheel_message_disruptor_5"	"Well, look at that."
"[english]dota_chatwheel_message_disruptor_5"	"Well, look at that."
"dota_chatwheel_label_disruptor_5"	"Look at that"
"[english]dota_chatwheel_label_disruptor_5"	"Look at that"
"dota_chatwheel_message_nyx_assassin_laugh"	"Heehehheh Nyx, Nyx."
"[english]dota_chatwheel_message_nyx_assassin_laugh"	"Heehehheh Nyx, Nyx."
"dota_chatwheel_label_nyx_assassin_laugh"	"[大笑]"
"[english]dota_chatwheel_label_nyx_assassin_laugh"	"Laugh"
"dota_chatwheel_message_nyx_assassin_thank"	"Nice."
"[english]dota_chatwheel_message_nyx_assassin_thank"	"Nice."
"dota_chatwheel_label_nyx_assassin_thank"	"Nice."
"[english]dota_chatwheel_label_nyx_assassin_thank"	"Nice."
"dota_chatwheel_message_nyx_assassin_deny"	"How did this happen?"
"[english]dota_chatwheel_message_nyx_assassin_deny"	"How did this happen?"
"dota_chatwheel_label_nyx_assassin_deny"	"How did this happen?"
"[english]dota_chatwheel_label_nyx_assassin_deny"	"How did this happen?"
"dota_chatwheel_message_nyx_assassin_1"	"Talentless."
"[english]dota_chatwheel_message_nyx_assassin_1"	"Talentless."
"dota_chatwheel_label_nyx_assassin_1"	"Talentless"
"[english]dota_chatwheel_label_nyx_assassin_1"	"Talentless"
"dota_chatwheel_message_nyx_assassin_2"	"Nyx chichcichcihcihchi."
"[english]dota_chatwheel_message_nyx_assassin_2"	"Nyx chichcichcihcihchi."
"dota_chatwheel_label_nyx_assassin_2"	"Nyx chichcichcihcihchi."
"[english]dota_chatwheel_label_nyx_assassin_2"	"Nyx chichcichcihcihchi."
"dota_chatwheel_message_nyx_assassin_3"	"I'm waiting for you."
"[english]dota_chatwheel_message_nyx_assassin_3"	"I'm waiting for you."
"dota_chatwheel_label_nyx_assassin_3"	"I'm waiting for you."
"[english]dota_chatwheel_label_nyx_assassin_3"	"I'm waiting for you.	"
"dota_chatwheel_message_nyx_assassin_4"	"Assassinated."
"[english]dota_chatwheel_message_nyx_assassin_4"	"Assassinated."
"dota_chatwheel_label_nyx_assassin_4"	"Assassinated."
"[english]dota_chatwheel_label_nyx_assassin_4"	"Assassinated."
"dota_chatwheel_message_nyx_assassin_5"	"Nyx, Nyx, Nyx, Nyx."
"[english]dota_chatwheel_message_nyx_assassin_5"	"Nyx, Nyx, Nyx, Nyx."
"dota_chatwheel_label_nyx_assassin_5"	"Nyx, Nyx, Nyx, Nyx."
"[english]dota_chatwheel_label_nyx_assassin_5"	"Nyx, Nyx, Nyx, Nyx."
"dota_chatwheel_message_naga_siren_laugh"	"Ahehehaheh."
"[english]dota_chatwheel_message_naga_siren_laugh"	"Ahehehaheh."
"dota_chatwheel_label_naga_siren_laugh"	"[大笑]"
"[english]dota_chatwheel_label_naga_siren_laugh"	"Laugh"
"dota_chatwheel_message_naga_siren_thank"	"That went swimmingly."
"[english]dota_chatwheel_message_naga_siren_thank"	"That went swimmingly."
"dota_chatwheel_label_naga_siren_thank"	"That went swimmingly."
"[english]dota_chatwheel_label_naga_siren_thank"	"That went swimmingly."
"dota_chatwheel_message_naga_siren_deny"	"A sour note."
"[english]dota_chatwheel_message_naga_siren_deny"	"A sour note."
"dota_chatwheel_label_naga_siren_deny"	"A sour note."
"[english]dota_chatwheel_label_naga_siren_deny"	"A sour note."
"dota_chatwheel_message_naga_siren_1"	"You're in deep now."
"[english]dota_chatwheel_message_naga_siren_1"	"You're in deep now."
"dota_chatwheel_label_naga_siren_1"	"You're in deep now."
"[english]dota_chatwheel_label_naga_siren_1"	"You're in deep now."
"dota_chatwheel_message_naga_siren_2"	"That's enough out of you."
"[english]dota_chatwheel_message_naga_siren_2"	"That's enough out of you."
"dota_chatwheel_label_naga_siren_2"	"That's enough out of you."
"[english]dota_chatwheel_label_naga_siren_2"	"That's enough out of you."
"dota_chatwheel_message_naga_siren_3"	"That's got to suck."
"[english]dota_chatwheel_message_naga_siren_3"	"That's got to suck."
"dota_chatwheel_label_naga_siren_3"	"That's got to suck."
"[english]dota_chatwheel_label_naga_siren_3"	"That's got to suck."
"dota_chatwheel_message_naga_siren_4"	"It had to be."
"[english]dota_chatwheel_message_naga_siren_4"	"It had to be."
"dota_chatwheel_label_naga_siren_4"	"It had to be."
"[english]dota_chatwheel_label_naga_siren_4"	"It had to be."
"dota_chatwheel_message_naga_siren_5"	"My legs! I can't feel my legs."
"[english]dota_chatwheel_message_naga_siren_5"	"My legs! I can't feel my legs."
"dota_chatwheel_label_naga_siren_5"	"My legs!"
"[english]dota_chatwheel_label_naga_siren_5"	"My legs!"
"dota_chatwheel_message_keeper_of_the_light_laugh"	"Eh hee hee hee hee hee."
"[english]dota_chatwheel_message_keeper_of_the_light_laugh"	"Eh hee hee hee hee hee."
"dota_chatwheel_label_keeper_of_the_light_laugh"	"[大笑]"
"[english]dota_chatwheel_label_keeper_of_the_light_laugh"	"Laugh"
"dota_chatwheel_message_keeper_of_the_light_thank"	"May the light keep you."
"[english]dota_chatwheel_message_keeper_of_the_light_thank"	"May the light keep you."
"dota_chatwheel_label_keeper_of_the_light_thank"	"May the light keep you."
"[english]dota_chatwheel_label_keeper_of_the_light_thank"	"May the light keep you."
"dota_chatwheel_message_keeper_of_the_light_deny"	"No mana."
"[english]dota_chatwheel_message_keeper_of_the_light_deny"	"No mana."
"dota_chatwheel_label_keeper_of_the_light_deny"	"No mana!"
"[english]dota_chatwheel_label_keeper_of_the_light_deny"	"No mana!"
"dota_chatwheel_message_keeper_of_the_light_1"	"Really now, you should have seen that coming."
"[english]dota_chatwheel_message_keeper_of_the_light_1"	"Really now, you should have seen that coming."
"dota_chatwheel_label_keeper_of_the_light_1"	"Should have seen that coming!"
"[english]dota_chatwheel_label_keeper_of_the_light_1"	"Should have seen that coming!"
"dota_chatwheel_message_keeper_of_the_light_2"	"Get off my lawn...eh, what's a lawn?"
"[english]dota_chatwheel_message_keeper_of_the_light_2"	"Get off my lawn...eh, what's a lawn?"
"dota_chatwheel_label_keeper_of_the_light_2"	"Get off my lawn...eh, what's a lawn?"
"[english]dota_chatwheel_label_keeper_of_the_light_2"	"Get off my lawn...eh, what's a lawn?"
"dota_chatwheel_message_keeper_of_the_light_3"	"My horse says nay and so do I."
"[english]dota_chatwheel_message_keeper_of_the_light_3"	"My horse says nay and so do I."
"dota_chatwheel_label_keeper_of_the_light_3"	"My horse says nay and so do I."
"[english]dota_chatwheel_label_keeper_of_the_light_3"	"My horse says nay and so do I."
"dota_chatwheel_message_keeper_of_the_light_4"	"Lights out for you."
"[english]dota_chatwheel_message_keeper_of_the_light_4"	"Lights out for you."
"dota_chatwheel_label_keeper_of_the_light_4"	"Lights out for you."
"[english]dota_chatwheel_label_keeper_of_the_light_4"	"Lights out for you."
"dota_chatwheel_message_keeper_of_the_light_5"	"Do not fear the light - fear me!"
"[english]dota_chatwheel_message_keeper_of_the_light_5"	"Do not fear the light - fear me!"
"dota_chatwheel_label_keeper_of_the_light_5"	"Do not fear the light..."
"[english]dota_chatwheel_label_keeper_of_the_light_5"	"Do not fear the light..."
"dota_chatwheel_message_wisp_laugh"	"Laughing Beeps"
"[english]dota_chatwheel_message_wisp_laugh"	"Laughing Beeps"
"dota_chatwheel_label_wisp_laugh"	"Laughing Beeps"
"[english]dota_chatwheel_label_wisp_laugh"	"Laughing Beeps"
"dota_chatwheel_message_wisp_thank"	"Thankful Beeps"
"[english]dota_chatwheel_message_wisp_thank"	"Thankful Beeps"
"dota_chatwheel_label_wisp_thank"	"Thankful Beeps"
"[english]dota_chatwheel_label_wisp_thank"	"Thankful Beeps"
"dota_chatwheel_message_wisp_deny"	"Denying Beeps"
"[english]dota_chatwheel_message_wisp_deny"	"Denying Beeps"
"dota_chatwheel_label_wisp_deny"	"Denying Beeps"
"[english]dota_chatwheel_label_wisp_deny"	"Denying Beeps"
"dota_chatwheel_message_wisp_1"	"Friendly Beeps"
"[english]dota_chatwheel_message_wisp_1"	"Friendly Beeps"
"dota_chatwheel_label_wisp_1"	"Friendly Beeps"
"[english]dota_chatwheel_label_wisp_1"	"Friendly Beeps"
"dota_chatwheel_message_wisp_2"	"Triumphant Beeps"
"[english]dota_chatwheel_message_wisp_2"	"Triumphant Beeps"
"dota_chatwheel_label_wisp_2"	"Triumphant Beeps"
"[english]dota_chatwheel_label_wisp_2"	"Triumphant Beeps"
"dota_chatwheel_message_wisp_3"	"Sorrowful Beeps"
"[english]dota_chatwheel_message_wisp_3"	"Sorrowful Beeps"
"dota_chatwheel_label_wisp_3"	"Sorrowful Beeps"
"[english]dota_chatwheel_label_wisp_3"	"Sorrowful Beeps"
"dota_chatwheel_message_wisp_4"	"Angry Beeps"
"[english]dota_chatwheel_message_wisp_4"	"Angry Beeps"
"dota_chatwheel_label_wisp_4"	"Angry Beeps"
"[english]dota_chatwheel_label_wisp_4"	"Angry Beeps"
"dota_chatwheel_message_wisp_5"	"Meditative Beeps"
"[english]dota_chatwheel_message_wisp_5"	"Meditative Beeps"
"dota_chatwheel_label_wisp_5"	"Meditative Beeps"
"[english]dota_chatwheel_label_wisp_5"	"Meditative Beeps"
"dota_chatwheel_message_visage_laugh"	"Ah ha ha ha ha ha ha ha ha!"
"[english]dota_chatwheel_message_visage_laugh"	"Ah ha ha ha ha ha ha ha ha!"
"dota_chatwheel_label_visage_laugh"	"[大笑]"
"[english]dota_chatwheel_label_visage_laugh"	"Laugh"
"dota_chatwheel_message_visage_thank"	"Visage like."
"[english]dota_chatwheel_message_visage_thank"	"Visage like."
"dota_chatwheel_label_visage_thank"	"Visage like."
"[english]dota_chatwheel_label_visage_thank"	"Visage like."
"dota_chatwheel_message_visage_deny"	"You again?"
"[english]dota_chatwheel_message_visage_deny"	"You again?"
"dota_chatwheel_label_visage_deny"	"You again?"
"[english]dota_chatwheel_label_visage_deny"	"You again?"
"dota_chatwheel_message_visage_1"	"And so you die."
"[english]dota_chatwheel_message_visage_1"	"And so you die."
"dota_chatwheel_label_visage_1"	"And so you die."
"[english]dota_chatwheel_label_visage_1"	"And so you die."
"dota_chatwheel_message_visage_2"	"I have failed."
"[english]dota_chatwheel_message_visage_2"	"I have failed."
"dota_chatwheel_label_visage_2"	"I have failed."
"[english]dota_chatwheel_label_visage_2"	"I have failed."
"dota_chatwheel_message_visage_3"	"You shall not pass!"
"[english]dota_chatwheel_message_visage_3"	"You shall not pass!"
"dota_chatwheel_label_visage_3"	"You shall not pass!"
"[english]dota_chatwheel_label_visage_3"	"You shall not pass!"
"dota_chatwheel_message_visage_4"	"Face of death."
"[english]dota_chatwheel_message_visage_4"	"Face of death."
"dota_chatwheel_label_visage_4"	"I am the unyielding face of death!"
"[english]dota_chatwheel_label_visage_4"	"I am the unyielding face of death!"
"dota_chatwheel_message_visage_5"	"Ahh this is much better."
"[english]dota_chatwheel_message_visage_5"	"Ahh this is much better."
"dota_chatwheel_label_visage_5"	"Much better"
"[english]dota_chatwheel_label_visage_5"	"Much better"
"dota_chatwheel_message_slark_laugh"	"Heh heh heh heh heh heh heh heh."
"[english]dota_chatwheel_message_slark_laugh"	"Heh heh heh heh heh heh heh heh."
"dota_chatwheel_label_slark_laugh"	"[大笑]"
"[english]dota_chatwheel_label_slark_laugh"	"Laugh"
"dota_chatwheel_message_slark_thank"	"I know I can trust you guys."
"[english]dota_chatwheel_message_slark_thank"	"I know I can trust you guys."
"dota_chatwheel_label_slark_thank"	"I can trust you guys."
"[english]dota_chatwheel_label_slark_thank"	"I can trust you guys."
"dota_chatwheel_message_slark_deny"	"On your belly and crawl."
"[english]dota_chatwheel_message_slark_deny"	"On your belly and crawl."
"dota_chatwheel_label_slark_deny"	"On your belly"
"[english]dota_chatwheel_label_slark_deny"	"On your belly"
"dota_chatwheel_message_slark_1"	"I can't hear you."
"[english]dota_chatwheel_message_slark_1"	"I can't hear you."
"dota_chatwheel_label_slark_1"	"I can't hear you."
"[english]dota_chatwheel_label_slark_1"	"I can't hear you."
"dota_chatwheel_message_slark_2"	"Well that went bad quickly."
"[english]dota_chatwheel_message_slark_2"	"Well that went bad quickly."
"dota_chatwheel_label_slark_2"	"Well that went bad quickly."
"[english]dota_chatwheel_label_slark_2"	"Well that went bad quickly."
"dota_chatwheel_message_slark_3"	"You took the bait."
"[english]dota_chatwheel_message_slark_3"	"You took the bait."
"dota_chatwheel_label_slark_3"	"You took the bait."
"[english]dota_chatwheel_label_slark_3"	"You took the bait."
"dota_chatwheel_message_slark_4"	"Oh this makes it all worthwhile."
"[english]dota_chatwheel_message_slark_4"	"Oh this makes it all worthwhile."
"dota_chatwheel_label_slark_4"	"All worth while."
"[english]dota_chatwheel_label_slark_4"	"All worth while."
"dota_chatwheel_message_slark_5"	"Oh that's very nice."
"[english]dota_chatwheel_message_slark_5"	"Oh that's very nice."
"dota_chatwheel_label_slark_5"	"Oh that's very nice."
"[english]dota_chatwheel_label_slark_5"	"Oh that's very nice."
"dota_chatwheel_message_medusa_laugh"	"Hmm hmm hmm ha ha ha ha ha!"
"[english]dota_chatwheel_message_medusa_laugh"	"Hmm hmm hmm ha ha ha ha ha!"
"dota_chatwheel_label_medusa_laugh"	"[大笑]"
"[english]dota_chatwheel_label_medusa_laugh"	"Laugh"
"dota_chatwheel_message_medusa_thank"	"Brilliant."
"[english]dota_chatwheel_message_medusa_thank"	"Brilliant."
"dota_chatwheel_label_medusa_thank"	"Brilliant."
"[english]dota_chatwheel_label_medusa_thank"	"Brilliant."
"dota_chatwheel_message_medusa_deny"	"In your face."
"[english]dota_chatwheel_message_medusa_deny"	"In your face."
"dota_chatwheel_label_medusa_deny"	"In your face."
"[english]dota_chatwheel_label_medusa_deny"	"In your face."
"dota_chatwheel_message_medusa_1"	"Don't resist the cobra, little bird."
"[english]dota_chatwheel_message_medusa_1"	"Don't resist the cobra, little bird."
"dota_chatwheel_label_medusa_1"	"Don't resist the cobra"
"[english]dota_chatwheel_label_medusa_1"	"Don't resist the cobra"
"dota_chatwheel_message_medusa_2"	"Oh, crap!"
"[english]dota_chatwheel_message_medusa_2"	"Oh, crap!"
"dota_chatwheel_label_medusa_2"	"Oh, crap."
"[english]dota_chatwheel_label_medusa_2"	"Oh, crap."
"dota_chatwheel_message_medusa_3"	"You knew I was cold-blooded."
"[english]dota_chatwheel_message_medusa_3"	"You knew I was cold-blooded."
"dota_chatwheel_label_medusa_3"	"You knew I was cold-blooded."
"[english]dota_chatwheel_label_medusa_3"	"You knew I was cold-blooded."
"dota_chatwheel_message_medusa_4"	"Gaze upon Medusa's beauty, and despair!"
"[english]dota_chatwheel_message_medusa_4"	"Gaze upon Medusa's beauty, and despair!"
"dota_chatwheel_label_medusa_4"	"Gaze upon Medusa's beauty..."
"[english]dota_chatwheel_label_medusa_4"	"Gaze upon Medusa's beauty..."
"dota_chatwheel_message_medusa_5"	"Nobody look at anybody!"
"[english]dota_chatwheel_message_medusa_5"	"Nobody look at anybody!"
"dota_chatwheel_label_medusa_5"	"Nobody look at anybody!"
"[english]dota_chatwheel_label_medusa_5"	"Nobody look at anybody!"
"dota_chatwheel_message_troll_warlord_laugh"	"Yaaahahahaahhah."
"[english]dota_chatwheel_message_troll_warlord_laugh"	"Yaaahahahaahhah."
"dota_chatwheel_label_troll_warlord_laugh"	"[大笑]"
"[english]dota_chatwheel_label_troll_warlord_laugh"	"Laugh"
"dota_chatwheel_message_troll_warlord_thank"	"Go crazy!"
"[english]dota_chatwheel_message_troll_warlord_thank"	"Go crazy!"
"dota_chatwheel_label_troll_warlord_thank"	"Go crazy!"
"[english]dota_chatwheel_label_troll_warlord_thank"	"Go crazy!"
"dota_chatwheel_message_troll_warlord_deny"	"Unfortunate."
"[english]dota_chatwheel_message_troll_warlord_deny"	"Unfortunate."
"dota_chatwheel_label_troll_warlord_deny"	"Unfortunate."
"[english]dota_chatwheel_label_troll_warlord_deny"	"Unfortunate."
"dota_chatwheel_message_troll_warlord_1"	"Come back and die again."
"[english]dota_chatwheel_message_troll_warlord_1"	"Come back and die again."
"dota_chatwheel_label_troll_warlord_1"	"Come back..."
"[english]dota_chatwheel_label_troll_warlord_1"	"Come back..."
"dota_chatwheel_message_troll_warlord_2"	"You've got to be kidding."
"[english]dota_chatwheel_message_troll_warlord_2"	"You've got to be kidding."
"dota_chatwheel_label_troll_warlord_2"	"You've gotta be kidding."
"[english]dota_chatwheel_label_troll_warlord_2"	"You've gotta be kidding."
"dota_chatwheel_message_troll_warlord_3"	"Try not to feed."
"[english]dota_chatwheel_message_troll_warlord_3"	"Try not to feed."
"dota_chatwheel_label_troll_warlord_3"	"Try not to feed."
"[english]dota_chatwheel_label_troll_warlord_3"	"Try not to feed."
"dota_chatwheel_message_troll_warlord_4"	"This can't be happening."
"[english]dota_chatwheel_message_troll_warlord_4"	"This can't be happening."
"dota_chatwheel_label_troll_warlord_4"	"This can't be happening."
"[english]dota_chatwheel_label_troll_warlord_4"	"This can't be happening."
"dota_chatwheel_message_troll_warlord_5"	"Why doesn't anybody like me?"
"[english]dota_chatwheel_message_troll_warlord_5"	"Why doesn't anybody like me?"
"dota_chatwheel_label_troll_warlord_5"	"Why doesn't anybody like me?"
"[english]dota_chatwheel_label_troll_warlord_5"	"Why doesn't anybody like me?"
"dota_chatwheel_message_centaur_laugh"	"Heheeeh hahah ehha."
"[english]dota_chatwheel_message_centaur_laugh"	"Heheeeh hahah ehha."
"dota_chatwheel_label_centaur_laugh"	"[大笑]"
"[english]dota_chatwheel_label_centaur_laugh"	"Laugh"
"dota_chatwheel_message_centaur_thank"	"I shall honor your name."
"[english]dota_chatwheel_message_centaur_thank"	"I shall honor your name."
"dota_chatwheel_label_centaur_thank"	"I shall honor your name."
"[english]dota_chatwheel_label_centaur_thank"	"I shall honor your name."
"dota_chatwheel_message_centaur_deny"	"Stomped."
"[english]dota_chatwheel_message_centaur_deny"	"Stomped."
"dota_chatwheel_label_centaur_deny"	"Stomped."
"[english]dota_chatwheel_label_centaur_deny"	"Stomped."
"dota_chatwheel_message_centaur_1"	"Mmmmm."
"[english]dota_chatwheel_message_centaur_1"	"Mmmmm."
"dota_chatwheel_label_centaur_1"	"Mmmmmm."
"[english]dota_chatwheel_label_centaur_1"	"Mmmmmm."
"dota_chatwheel_message_centaur_2"	"What a waste."
"[english]dota_chatwheel_message_centaur_2"	"What a waste."
"dota_chatwheel_label_centaur_2"	"What a waste."
"[english]dota_chatwheel_label_centaur_2"	"What a waste."
"dota_chatwheel_message_centaur_3"	"Back to hell with you."
"[english]dota_chatwheel_message_centaur_3"	"Back to hell with you."
"dota_chatwheel_label_centaur_3"	"Back to hell with you."
"[english]dota_chatwheel_label_centaur_3"	"Back to hell with you."
"dota_chatwheel_message_centaur_4"	"Oh, yes, fear my hoofbeats."
"[english]dota_chatwheel_message_centaur_4"	"Oh, yes, fear my hoofbeats."
"dota_chatwheel_label_centaur_4"	"Fear my hoofbeats"
"[english]dota_chatwheel_label_centaur_4"	"Fear my hoofbeats"
"dota_chatwheel_message_centaur_5"	"Hurts you more than it hurts me."
"[english]dota_chatwheel_message_centaur_5"	"Hurts you more than it hurts me."
"dota_chatwheel_label_centaur_5"	"Hurts you more than it hurts me."
"[english]dota_chatwheel_label_centaur_5"	"Hurts you more than it hurts me."
"dota_chatwheel_message_magnataur_laugh"	"Ah ha ha."
"[english]dota_chatwheel_message_magnataur_laugh"	"Ah ha ha."
"dota_chatwheel_label_magnataur_laugh"	"[大笑]"
"[english]dota_chatwheel_label_magnataur_laugh"	"Laugh"
"dota_chatwheel_message_magnataur_thank"	"Yes, this will do just fine."
"[english]dota_chatwheel_message_magnataur_thank"	"Yes, this will do just fine."
"dota_chatwheel_label_magnataur_thank"	"This will do just fine."
"[english]dota_chatwheel_label_magnataur_thank"	"This will do just fine."
"dota_chatwheel_message_magnataur_deny"	"This is bullshit!"
"[english]dota_chatwheel_message_magnataur_deny"	"This is bullshit!"
"dota_chatwheel_label_magnataur_deny"	"This is bullshit!"
"[english]dota_chatwheel_label_magnataur_deny"	"This is bullshit!"
"dota_chatwheel_message_magnataur_1"	"Ha ha ha ha! What did you expect?"
"[english]dota_chatwheel_message_magnataur_1"	"Ha ha ha ha! What did you expect?"
"dota_chatwheel_label_magnataur_1"	"What did you expect?"
"[english]dota_chatwheel_label_magnataur_1"	"What did you expect?"
"dota_chatwheel_message_magnataur_2"	"Are you kidding me?"
"[english]dota_chatwheel_message_magnataur_2"	"Are you kidding me?"
"dota_chatwheel_label_magnataur_2"	"Are you kidding me?"
"[english]dota_chatwheel_label_magnataur_2"	"Are you kidding me?"
"dota_chatwheel_message_magnataur_3"	"All in a day's work."
"[english]dota_chatwheel_message_magnataur_3"	"All in a day's work."
"dota_chatwheel_label_magnataur_3"	"All in a day's work."
"[english]dota_chatwheel_label_magnataur_3"	"All in a day's work."
"dota_chatwheel_message_magnataur_4"	"How shameful."
"[english]dota_chatwheel_message_magnataur_4"	"How shameful."
"dota_chatwheel_label_magnataur_4"	"How shameful."
"[english]dota_chatwheel_label_magnataur_4"	"How shameful."
"dota_chatwheel_message_magnataur_5"	"I tell you what. You touch my horn, I break your face."
"[english]dota_chatwheel_message_magnataur_5"	"I tell you what. You touch my horn, I break your face."
"dota_chatwheel_label_magnataur_5"	"Touch my horn, break your face."
"[english]dota_chatwheel_label_magnataur_5"	"Touch my horn, break your face."
"dota_chatwheel_message_shredder_laugh"	"He he he he he!"
"[english]dota_chatwheel_message_shredder_laugh"	"He he he he he!"
"dota_chatwheel_label_shredder_laugh"	"[大笑]"
"[english]dota_chatwheel_label_shredder_laugh"	"Laugh"
"dota_chatwheel_message_shredder_thank"	"I almost trust you."
"[english]dota_chatwheel_message_shredder_thank"	"I almost trust you."
"dota_chatwheel_label_shredder_thank"	"I almost trust you."
"[english]dota_chatwheel_label_shredder_thank"	"I almost trust you."
"dota_chatwheel_message_shredder_deny"	"You mad? Cuz I am!"
"[english]dota_chatwheel_message_shredder_deny"	"You mad? Cuz I am!"
"dota_chatwheel_label_shredder_deny"	"You mad?"
"[english]dota_chatwheel_label_shredder_deny"	"You mad?"
"dota_chatwheel_message_shredder_1"	"Oh yeah ha ha."
"[english]dota_chatwheel_message_shredder_1"	"Oh yeah ha ha."
"dota_chatwheel_label_shredder_1"	"Oh yeah ha ha."
"[english]dota_chatwheel_label_shredder_1"	"Oh yeah ha ha."
"dota_chatwheel_message_shredder_2"	"Oh! Oh! Oh-oh-you see this? You see? Oh this is what I've always wanted! Oh I'm so happy!"
"[english]dota_chatwheel_message_shredder_2"	"Oh! Oh! Oh-oh-you see this? You see? Oh this is what I've always wanted! Oh I'm so happy!"
"dota_chatwheel_label_shredder_2"	"What I've always wanted!"
"[english]dota_chatwheel_label_shredder_2"	"What I've always wanted!"
"dota_chatwheel_message_shredder_3"	"Oh god I think I'm going to be sick."
"[english]dota_chatwheel_message_shredder_3"	"Oh god I think I'm going to be sick."
"dota_chatwheel_label_shredder_3"	"Oh god I think I'm going to be sick."
"[english]dota_chatwheel_label_shredder_3"	"Oh god I think I'm going to be sick."
"dota_chatwheel_message_shredder_4"	"Saw that coming. Ha! Get it?"
"[english]dota_chatwheel_message_shredder_4"	"Saw that coming. Ha! Get it?"
"dota_chatwheel_label_shredder_4"	"Saw that coming!"
"[english]dota_chatwheel_label_shredder_4"	"Saw that coming!"
"dota_chatwheel_message_shredder_5"	"Run run run run runrunrunrunrunrunrunrunrunrunrunrunrunrunrunrunrunrun!"
"[english]dota_chatwheel_message_shredder_5"	"Run run run run runrunrunrunrunrunrunrunrunrunrunrunrunrunrunrunrunrun!"
"dota_chatwheel_label_shredder_5"	"Run run runrun runrunrun!"
"[english]dota_chatwheel_label_shredder_5"	"Run run runrun runrunrun!"
"dota_chatwheel_message_bristleback_laugh"	"Hehey hahaha."
"[english]dota_chatwheel_message_bristleback_laugh"	"Hehey hahaha."
"dota_chatwheel_label_bristleback_laugh"	"[大笑]"
"[english]dota_chatwheel_label_bristleback_laugh"	"Laugh"
"dota_chatwheel_message_bristleback_thank"	"Bright and breezy."
"[english]dota_chatwheel_message_bristleback_thank"	"Bright and breezy."
"dota_chatwheel_label_bristleback_thank"	"Bright and breezy."
"[english]dota_chatwheel_label_bristleback_thank"	"Bright and breezy."
"dota_chatwheel_message_bristleback_deny"	"Ah, now I feel better."
"[english]dota_chatwheel_message_bristleback_deny"	"Ah, now I feel better."
"dota_chatwheel_label_bristleback_deny"	"Now I feel better."
"[english]dota_chatwheel_label_bristleback_deny"	"Now I feel better."
"dota_chatwheel_message_bristleback_1"	"Oooh, that's lovely days."
"[english]dota_chatwheel_message_bristleback_1"	"Oooh, that's lovely days."
"dota_chatwheel_label_bristleback_1"	"That's lovely!"
"[english]dota_chatwheel_label_bristleback_1"	"That's lovely!"
"dota_chatwheel_message_bristleback_2"	"No way."
"[english]dota_chatwheel_message_bristleback_2"	"No way."
"dota_chatwheel_label_bristleback_2"	"No way."
"[english]dota_chatwheel_label_bristleback_2"	"No way."
"dota_chatwheel_message_bristleback_3"	"Oh, you want some of this… eh?"
"[english]dota_chatwheel_message_bristleback_3"	"Oh, you want some of this… eh?"
"dota_chatwheel_label_bristleback_3"	"You want some of this?"
"[english]dota_chatwheel_label_bristleback_3"	"You want some of this?"
"dota_chatwheel_message_bristleback_4"	"Who's squealing now, eh? Ha, aha ha heh."
"[english]dota_chatwheel_message_bristleback_4"	"Who's squealing now, eh? Ha, aha ha heh."
"dota_chatwheel_label_bristleback_4"	"Who's squealing now, eh?"
"[english]dota_chatwheel_label_bristleback_4"	"Who's squealing now, eh?"
"dota_chatwheel_message_bristleback_5"	"Well, what have we here."
"[english]dota_chatwheel_message_bristleback_5"	"Well, what have we here."
"dota_chatwheel_label_bristleback_5"	"What have we here."
"[english]dota_chatwheel_label_bristleback_5"	"What have we here."
"dota_chatwheel_message_tusk_laugh"	"Oh boy! Ha ha ha ha ha!"
"[english]dota_chatwheel_message_tusk_laugh"	"Oh boy! Ha ha ha ha ha!"
"dota_chatwheel_label_tusk_laugh"	"[大笑]"
"[english]dota_chatwheel_label_tusk_laugh"	"Laugh"
"dota_chatwheel_message_tusk_thank"	"Fist Bump."
"[english]dota_chatwheel_message_tusk_thank"	"Fist Bump."
"dota_chatwheel_label_tusk_thank"	"Fist Bump."
"[english]dota_chatwheel_label_tusk_thank"	"Fist Bump."
"dota_chatwheel_message_tusk_deny"	"Well I tried."
"[english]dota_chatwheel_message_tusk_deny"	"Well I tried."
"dota_chatwheel_label_tusk_deny"	"Well I tried."
"[english]dota_chatwheel_label_tusk_deny"	"Well I tried."
"dota_chatwheel_message_tusk_1"	"Are you okay?"
"[english]dota_chatwheel_message_tusk_1"	"Are you okay?"
"dota_chatwheel_label_tusk_1"	"Are you ok?"
"[english]dota_chatwheel_label_tusk_1"	"Are you ok?"
"dota_chatwheel_message_tusk_2"	"Dohmvzm!"
"[english]dota_chatwheel_message_tusk_2"	"Dohmvzm!"
"dota_chatwheel_label_tusk_2"	"Dohmvzm!"
"[english]dota_chatwheel_label_tusk_2"	"Dohmvzm!"
"dota_chatwheel_message_tusk_3"	"Tusky-duskie."
"[english]dota_chatwheel_message_tusk_3"	"Tusky-duskie."
"dota_chatwheel_label_tusk_3"	"Tusky-duskie."
"[english]dota_chatwheel_label_tusk_3"	"Tusky-duskie."
"dota_chatwheel_message_tusk_4"	"Oh, that had to hurt!"
"[english]dota_chatwheel_message_tusk_4"	"Oh, that had to hurt!"
"dota_chatwheel_label_tusk_4"	"Oh, that had to hurt!"
"[english]dota_chatwheel_label_tusk_4"	"Oh, that had to hurt!"
"dota_chatwheel_message_tusk_5"	"That was a big ball of failure."
"[english]dota_chatwheel_message_tusk_5"	"That was a big ball of failure."
"dota_chatwheel_label_tusk_5"	"Big ball of failure."
"[english]dota_chatwheel_label_tusk_5"	"Big ball of failure."
"dota_chatwheel_message_skywrath_mage_laugh"	"Ha ha!"
"[english]dota_chatwheel_message_skywrath_mage_laugh"	"Ha ha!"
"dota_chatwheel_label_skywrath_mage_laugh"	"[大笑]"
"[english]dota_chatwheel_label_skywrath_mage_laugh"	"Laugh"
"dota_chatwheel_message_skywrath_mage_thank"	"I shall not report you."
"[english]dota_chatwheel_message_skywrath_mage_thank"	"I shall not report you."
"dota_chatwheel_label_skywrath_mage_thank"	"I shall not report you."
"[english]dota_chatwheel_label_skywrath_mage_thank"	"I shall not report you."
"dota_chatwheel_message_skywrath_mage_deny"	"Down you go!"
"[english]dota_chatwheel_message_skywrath_mage_deny"	"Down you go!"
"dota_chatwheel_label_skywrath_mage_deny"	"Down you go!"
"[english]dota_chatwheel_label_skywrath_mage_deny"	"Down you go!"
"dota_chatwheel_message_skywrath_mage_1"	"Ai, me!"
"[english]dota_chatwheel_message_skywrath_mage_1"	"Ai, me!"
"dota_chatwheel_label_skywrath_mage_1"	"Ai, me!"
"[english]dota_chatwheel_label_skywrath_mage_1"	"Ai, me!"
"dota_chatwheel_message_skywrath_mage_2"	"That my friend was a mistake."
"[english]dota_chatwheel_message_skywrath_mage_2"	"That my friend was a mistake."
"dota_chatwheel_label_skywrath_mage_2"	"That was a mistake."
"[english]dota_chatwheel_label_skywrath_mage_2"	"That was a mistake."
"dota_chatwheel_message_skywrath_mage_3"	"Twas honorably done."
"[english]dota_chatwheel_message_skywrath_mage_3"	"Twas honorably done."
"dota_chatwheel_label_skywrath_mage_3"	"Twas honorably done!"
"[english]dota_chatwheel_label_skywrath_mage_3"	"Twas honorably done!"
"dota_chatwheel_message_skywrath_mage_4"	"From the Ghastly Eyrie I can see to the ends of the world, and from this vantage point I declare with utter certainty that this one is in the bag!"
"[english]dota_chatwheel_message_skywrath_mage_4"	"From the Ghastly Eyrie I can see to the ends of the world, and from this vantage point I declare with utter certainty that this one is in the bag!"
"dota_chatwheel_label_skywrath_mage_4"	"From the Ghastly Eyrie..."
"[english]dota_chatwheel_label_skywrath_mage_4"	"From the Ghastly Eyrie..."
"dota_chatwheel_message_skywrath_mage_5"	"The skies are dark with Skywrath power!"
"[english]dota_chatwheel_message_skywrath_mage_5"	"The skies are dark with Skywrath power!"
"dota_chatwheel_label_skywrath_mage_5"	"The skies are dark with Skywrath power!"
"[english]dota_chatwheel_label_skywrath_mage_5"	"The skies are dark with Skywrath power!"
"dota_chatwheel_message_abaddon_laugh"	"Ha ha ha ha ha ha ha ha ha."
"[english]dota_chatwheel_message_abaddon_laugh"	"Ha ha ha ha ha ha ha ha ha."
"dota_chatwheel_label_abaddon_laugh"	"[大笑]"
"[english]dota_chatwheel_label_abaddon_laugh"	"Laugh"
"dota_chatwheel_message_abaddon_thank"	"The House Avernus will disown me for that."
"[english]dota_chatwheel_message_abaddon_thank"	"The House Avernus will disown me for that."
"dota_chatwheel_label_abaddon_thank"	"I will be disowned."
"[english]dota_chatwheel_label_abaddon_thank"	"I will be disowned."
"dota_chatwheel_message_abaddon_deny"	"Never."
"[english]dota_chatwheel_message_abaddon_deny"	"Never."
"dota_chatwheel_label_abaddon_deny"	"Never."
"[english]dota_chatwheel_label_abaddon_deny"	"Never."
"dota_chatwheel_message_abaddon_1"	"Bow to your lord."
"[english]dota_chatwheel_message_abaddon_1"	"Bow to your lord."
"dota_chatwheel_label_abaddon_1"	"Bow to your lord."
"[english]dota_chatwheel_label_abaddon_1"	"Bow to your lord."
"dota_chatwheel_message_abaddon_2"	"How can such a thing be?"
"[english]dota_chatwheel_message_abaddon_2"	"How can such a thing be?"
"dota_chatwheel_label_abaddon_2"	"How can such..."
"[english]dota_chatwheel_label_abaddon_2"	"How can such..."
"dota_chatwheel_message_abaddon_3"	"In the mists of time you are but a blur."
"[english]dota_chatwheel_message_abaddon_3"	"In the mists of time you are but a blur."
"dota_chatwheel_label_abaddon_3"	"In the mists of time..."
"[english]dota_chatwheel_label_abaddon_3"	"In the mists of time..."
"dota_chatwheel_message_abaddon_4"	"By what right do you tread here?"
"[english]dota_chatwheel_message_abaddon_4"	"By what right do you tread here?"
"dota_chatwheel_label_abaddon_4"	"By what right..."
"[english]dota_chatwheel_label_abaddon_4"	"By what right..."
"dota_chatwheel_message_abaddon_5"	"The fog of war is no match for the mist of fate."
"[english]dota_chatwheel_message_abaddon_5"	"The fog of war is no match for the mist of fate."
"dota_chatwheel_label_abaddon_5"	"The fog of war..."
"[english]dota_chatwheel_label_abaddon_5"	"The fog of war..."
"dota_chatwheel_message_elder_titan_laugh"	"Eh ha ha ha ha ha."
"[english]dota_chatwheel_message_elder_titan_laugh"	"Eh ha ha ha ha ha."
"dota_chatwheel_label_elder_titan_laugh"	"[大笑]"
"[english]dota_chatwheel_label_elder_titan_laugh"	"Laugh"
"dota_chatwheel_message_elder_titan_thank"	"Now shall the battle turn."
"[english]dota_chatwheel_message_elder_titan_thank"	"Now shall the battle turn."
"dota_chatwheel_label_elder_titan_thank"	"Now shall the battle turn."
"[english]dota_chatwheel_label_elder_titan_thank"	"Now shall the battle turn."
"dota_chatwheel_message_elder_titan_deny"	"The Titan says no."
"[english]dota_chatwheel_message_elder_titan_deny"	"The Titan says no."
"dota_chatwheel_label_elder_titan_deny"	"The Titan says no."
"[english]dota_chatwheel_label_elder_titan_deny"	"The Titan says no."
"dota_chatwheel_message_elder_titan_1"	"Get off my lawn!"
"[english]dota_chatwheel_message_elder_titan_1"	"Get off my lawn!"
"dota_chatwheel_label_elder_titan_1"	"Get off my lawn."
"[english]dota_chatwheel_label_elder_titan_1"	"Get off my lawn."
"dota_chatwheel_message_elder_titan_2"	"What have I done now?"
"[english]dota_chatwheel_message_elder_titan_2"	"What have I done now?"
"dota_chatwheel_label_elder_titan_2"	"What have I done now?"
"[english]dota_chatwheel_label_elder_titan_2"	"What have I done now?"
"dota_chatwheel_message_elder_titan_3"	"This bodes well."
"[english]dota_chatwheel_message_elder_titan_3"	"This bodes well."
"dota_chatwheel_label_elder_titan_3"	"This bodes well."
"[english]dota_chatwheel_label_elder_titan_3"	"This bodes well."
"dota_chatwheel_message_elder_titan_4"	"A pitiable attempt."
"[english]dota_chatwheel_message_elder_titan_4"	"A pitiable attempt."
"dota_chatwheel_label_elder_titan_4"	"A pitiable attempt."
"[english]dota_chatwheel_label_elder_titan_4"	"A pitiable attempt."
"dota_chatwheel_message_elder_titan_5"	"You must learn respect for your elders."
"[english]dota_chatwheel_message_elder_titan_5"	"You must learn respect for your elders."
"dota_chatwheel_label_elder_titan_5"	"You must learn respect..."
"[english]dota_chatwheel_label_elder_titan_5"	"You must learn respect..."
"dota_chatwheel_message_legion_commander_laugh"	"Ah ha ha ha ha ha ha!"
"[english]dota_chatwheel_message_legion_commander_laugh"	"Ah ha ha ha ha ha ha!"
"dota_chatwheel_label_legion_commander_laugh"	"[大笑]"
"[english]dota_chatwheel_label_legion_commander_laugh"	"Laugh"
"dota_chatwheel_message_legion_commander_thank"	"Not bad at all!"
"[english]dota_chatwheel_message_legion_commander_thank"	"Not bad at all!"
"dota_chatwheel_label_legion_commander_thank"	"Not bad at all!"
"[english]dota_chatwheel_label_legion_commander_thank"	"Not bad at all!"
"dota_chatwheel_message_legion_commander_deny"	"Try harder."
"[english]dota_chatwheel_message_legion_commander_deny"	"Try harder."
"dota_chatwheel_label_legion_commander_deny"	"Try Harder."
"[english]dota_chatwheel_label_legion_commander_deny"	"Try Harder."
"dota_chatwheel_message_legion_commander_1"	"Sound strategy."
"[english]dota_chatwheel_message_legion_commander_1"	"Sound strategy."
"dota_chatwheel_label_legion_commander_1"	"Sound strategy."
"[english]dota_chatwheel_label_legion_commander_1"	"Sound strategy."
"dota_chatwheel_message_legion_commander_2"	"Nice mustache."
"[english]dota_chatwheel_message_legion_commander_2"	"Nice mustache."
"dota_chatwheel_label_legion_commander_2"	"Nice mustache."
"[english]dota_chatwheel_label_legion_commander_2"	"Nice mustache."
"dota_chatwheel_message_legion_commander_3"	"I will tear you apart!"
"[english]dota_chatwheel_message_legion_commander_3"	"I will tear you apart!"
"dota_chatwheel_label_legion_commander_3"	"I will tear you apart."
"[english]dota_chatwheel_label_legion_commander_3"	"I will tear you apart."
"dota_chatwheel_message_legion_commander_4"	"Son of a...!"
"[english]dota_chatwheel_message_legion_commander_4"	"Son of a...!"
"dota_chatwheel_label_legion_commander_4"	"Son of a..."
"[english]dota_chatwheel_label_legion_commander_4"	"Son of a..."
"dota_chatwheel_message_legion_commander_5"	"That escalated quickly!"
"[english]dota_chatwheel_message_legion_commander_5"	"That escalated quickly!"
"dota_chatwheel_label_legion_commander_5"	"That escalated quickly."
"[english]dota_chatwheel_label_legion_commander_5"	"That escalated quickly."
"dota_chatwheel_message_techies_laugh"	"He he he, hehe ah ha! Oh ho ho oh oh ha ha ha!"
"[english]dota_chatwheel_message_techies_laugh"	"He he he, hehe ah ha! Oh ho ho oh oh ha ha ha!"
"dota_chatwheel_label_techies_laugh"	"[大笑]"
"[english]dota_chatwheel_label_techies_laugh"	"Laugh"
"dota_chatwheel_message_techies_thank"	"Fun! Huhuhu!"
"[english]dota_chatwheel_message_techies_thank"	"Fun! Huhuhu!"
"dota_chatwheel_label_techies_thank"	"Fun!"
"[english]dota_chatwheel_label_techies_thank"	"Fun!"
"dota_chatwheel_message_techies_deny"	"I was told there'd be a mushroom cloud!"
"[english]dota_chatwheel_message_techies_deny"	"I was told there'd be a mushroom cloud!"
"dota_chatwheel_label_techies_deny"	"Mushroom cloud."
"[english]dota_chatwheel_label_techies_deny"	"Mushroom cloud."
"dota_chatwheel_message_techies_1"	"Oh crap!"
"[english]dota_chatwheel_message_techies_1"	"Oh crap!"
"dota_chatwheel_label_techies_1"	"Oh crap!"
"[english]dota_chatwheel_label_techies_1"	"Oh crap!"
"dota_chatwheel_message_techies_2"	"Where'd he go? Everywhere!"
"[english]dota_chatwheel_message_techies_2"	"Where'd he go? Everywhere!"
"dota_chatwheel_label_techies_2"	"Where'd he go? Everywhere!"
"[english]dota_chatwheel_label_techies_2"	"Where'd he go? Everywhere!"
"dota_chatwheel_message_techies_3"	"Gotcha!"
"[english]dota_chatwheel_message_techies_3"	"Gotcha!"
"dota_chatwheel_label_techies_3"	"Gotcha!"
"[english]dota_chatwheel_label_techies_3"	"Gotcha!"
"dota_chatwheel_message_techies_4"	"Just have a seat right over there. And let the smart people work."
"[english]dota_chatwheel_message_techies_4"	"Just have a seat right over there. And let the smart people work."
"dota_chatwheel_label_techies_4"	"Have a seat."
"[english]dota_chatwheel_label_techies_4"	"Have a seat."
"dota_chatwheel_message_techies_5"	"I can't believe that worked."
"[english]dota_chatwheel_message_techies_5"	"I can't believe that worked."
"dota_chatwheel_label_techies_5"	"I can't believe that worked."
"[english]dota_chatwheel_label_techies_5"	"I can't believe that worked."
"dota_chatwheel_message_ember_spirit_laugh"	"Eh he he he he he!"
"[english]dota_chatwheel_message_ember_spirit_laugh"	"Eh he he he he he!"
"dota_chatwheel_label_ember_spirit_laugh"	"[大笑]"
"[english]dota_chatwheel_label_ember_spirit_laugh"	"Laugh"
"dota_chatwheel_message_ember_spirit_thank"	"A flash of inspiration!"
"[english]dota_chatwheel_message_ember_spirit_thank"	"A flash of inspiration!"
"dota_chatwheel_label_ember_spirit_thank"	"A flash of inspiration!"
"[english]dota_chatwheel_label_ember_spirit_thank"	"A flash of inspiration!"
"dota_chatwheel_message_ember_spirit_deny"	"This reward transcends expectation!"
"[english]dota_chatwheel_message_ember_spirit_deny"	"This reward transcends expectation!"
"dota_chatwheel_label_ember_spirit_deny"	"This reward transcends expectation!"
"[english]dota_chatwheel_label_ember_spirit_deny"	"This reward transcends expectation!"
"dota_chatwheel_message_ember_spirit_1"	"Prepare for a lesson."
"[english]dota_chatwheel_message_ember_spirit_1"	"Prepare for a lesson."
"dota_chatwheel_label_ember_spirit_1"	"Prepare for a lesson."
"[english]dota_chatwheel_label_ember_spirit_1"	"Prepare for a lesson."
"dota_chatwheel_message_ember_spirit_2"	"What did you learn?"
"[english]dota_chatwheel_message_ember_spirit_2"	"What did you learn?"
"dota_chatwheel_label_ember_spirit_2"	"What did you learn?"
"[english]dota_chatwheel_label_ember_spirit_2"	"What did you learn?"
"dota_chatwheel_message_ember_spirit_3"	"Balance in all things."
"[english]dota_chatwheel_message_ember_spirit_3"	"Balance in all things."
"dota_chatwheel_label_ember_spirit_3"	"Balance in all things."
"[english]dota_chatwheel_label_ember_spirit_3"	"Balance in all things."
"dota_chatwheel_message_ember_spirit_4"	"Through anger lies failure."
"[english]dota_chatwheel_message_ember_spirit_4"	"Through anger lies failure."
"dota_chatwheel_label_ember_spirit_4"	"Through anger lies failure."
"[english]dota_chatwheel_label_ember_spirit_4"	"Through anger lies failure."
"dota_chatwheel_message_ember_spirit_5"	"Even a master falters."
"[english]dota_chatwheel_message_ember_spirit_5"	"Even a master falters."
"dota_chatwheel_label_ember_spirit_5"	"Even a master falters."
"[english]dota_chatwheel_label_ember_spirit_5"	"Even a master falters."
"dota_chatwheel_message_earth_spirit_laugh"	"Oh ho ho ha ha ha ha ha ha!"
"[english]dota_chatwheel_message_earth_spirit_laugh"	"Oh ho ho ha ha ha ha ha ha!"
"dota_chatwheel_label_earth_spirit_laugh"	"[大笑]"
"[english]dota_chatwheel_label_earth_spirit_laugh"	"Laugh"
"dota_chatwheel_message_earth_spirit_thank"	"You rock."
"[english]dota_chatwheel_message_earth_spirit_thank"	"You rock."
"dota_chatwheel_label_earth_spirit_thank"	"You rock."
"[english]dota_chatwheel_label_earth_spirit_thank"	"You rock."
"dota_chatwheel_message_earth_spirit_deny"	"Yes, I just did that."
"[english]dota_chatwheel_message_earth_spirit_deny"	"Yes, I just did that."
"dota_chatwheel_label_earth_spirit_deny"	"Yes, I just did that."
"[english]dota_chatwheel_label_earth_spirit_deny"	"Yes, I just did that."
"dota_chatwheel_message_earth_spirit_1"	"What?"
"[english]dota_chatwheel_message_earth_spirit_1"	"What?"
"dota_chatwheel_label_earth_spirit_1"	"What?"
"[english]dota_chatwheel_label_earth_spirit_1"	"What?"
"dota_chatwheel_message_earth_spirit_2"	"Where did I go?"
"[english]dota_chatwheel_message_earth_spirit_2"	"Where did I go?"
"dota_chatwheel_label_earth_spirit_2"	"Where did I go?"
"[english]dota_chatwheel_label_earth_spirit_2"	"Where did I go?"
"dota_chatwheel_message_earth_spirit_3"	"Perfect timing."
"[english]dota_chatwheel_message_earth_spirit_3"	"Perfect timing."
"dota_chatwheel_label_earth_spirit_3"	"Perfect Timing"
"[english]dota_chatwheel_label_earth_spirit_3"	"Perfect Timing"
"dota_chatwheel_message_earth_spirit_4"	"Really? Really?"
"[english]dota_chatwheel_message_earth_spirit_4"	"Really? Really?"
"dota_chatwheel_label_earth_spirit_4"	"Really? Really?"
"[english]dota_chatwheel_label_earth_spirit_4"	"Really? Really?"
"dota_chatwheel_message_earth_spirit_5"	"Who dares face me now."
"[english]dota_chatwheel_message_earth_spirit_5"	"Who dares face me now."
"dota_chatwheel_label_earth_spirit_5"	"Who dares face me now."
"[english]dota_chatwheel_label_earth_spirit_5"	"Who dares face me now."
"dota_chatwheel_message_abyssal_underlord_laugh"	"Ah ha ha ha ha ha ha ha ha!"
"[english]dota_chatwheel_message_abyssal_underlord_laugh"	"Ah ha ha ha ha ha ha ha ha!"
"dota_chatwheel_label_abyssal_underlord_laugh"	"[大笑]"
"[english]dota_chatwheel_label_abyssal_underlord_laugh"	"Laugh"
"dota_chatwheel_message_abyssal_underlord_thank"	"I do not thank."
"[english]dota_chatwheel_message_abyssal_underlord_thank"	"I do not thank."
"dota_chatwheel_label_abyssal_underlord_thank"	"I do not thank."
"[english]dota_chatwheel_label_abyssal_underlord_thank"	"I do not thank."
"dota_chatwheel_message_abyssal_underlord_deny"	"Curses!"
"[english]dota_chatwheel_message_abyssal_underlord_deny"	"Curses!"
"dota_chatwheel_label_abyssal_underlord_deny"	"Curses!"
"[english]dota_chatwheel_label_abyssal_underlord_deny"	"Curses!"
"dota_chatwheel_message_abyssal_underlord_1"	"Oh yes."
"[english]dota_chatwheel_message_abyssal_underlord_1"	"Oh yes."
"dota_chatwheel_label_abyssal_underlord_1"	"Oh yes."
"[english]dota_chatwheel_label_abyssal_underlord_1"	"Oh yes."
"dota_chatwheel_message_abyssal_underlord_2"	"Insignificant."
"[english]dota_chatwheel_message_abyssal_underlord_2"	"Insignificant."
"dota_chatwheel_label_abyssal_underlord_2"	"Insignificant!"
"[english]dota_chatwheel_label_abyssal_underlord_2"	"Insignificant!"
"dota_chatwheel_message_abyssal_underlord_3"	"Bow to your new lord."
"[english]dota_chatwheel_message_abyssal_underlord_3"	"Bow to your new lord."
"dota_chatwheel_label_abyssal_underlord_3"	"Bow to your new lord."
"[english]dota_chatwheel_label_abyssal_underlord_3"	"Bow to your new lord."
"dota_chatwheel_message_abyssal_underlord_4"	"There is no hope."
"[english]dota_chatwheel_message_abyssal_underlord_4"	"There is no hope."
"dota_chatwheel_label_abyssal_underlord_4"	"There is no hope."
"[english]dota_chatwheel_label_abyssal_underlord_4"	"There is no hope."
"dota_chatwheel_message_abyssal_underlord_5"	"Hold on to your butts."
"[english]dota_chatwheel_message_abyssal_underlord_5"	"Hold on to your butts."
"dota_chatwheel_label_abyssal_underlord_5"	"Hold on!"
"[english]dota_chatwheel_label_abyssal_underlord_5"	"Hold on!"
"dota_chatwheel_message_terrorblade_laugh"	"Hehahahahahh."
"[english]dota_chatwheel_message_terrorblade_laugh"	"Hehahahahahh."
"dota_chatwheel_label_terrorblade_laugh"	"[大笑]"
"[english]dota_chatwheel_label_terrorblade_laugh"	"Laugh"
"dota_chatwheel_message_terrorblade_thank"	"What a handsome devil."
"[english]dota_chatwheel_message_terrorblade_thank"	"What a handsome devil."
"dota_chatwheel_label_terrorblade_thank"	"What a handsome devil."
"[english]dota_chatwheel_label_terrorblade_thank"	"What a handsome devil."
"dota_chatwheel_message_terrorblade_deny"	"Oh, they're gonna hate me for this."
"[english]dota_chatwheel_message_terrorblade_deny"	"Oh, they're gonna hate me for this."
"dota_chatwheel_label_terrorblade_deny"	"They're gonna hate me for this."
"[english]dota_chatwheel_label_terrorblade_deny"	"They're gonna hate me for this."
"dota_chatwheel_message_terrorblade_1"	"Trick of the trade."
"[english]dota_chatwheel_message_terrorblade_1"	"Trick of the trade."
"dota_chatwheel_label_terrorblade_1"	"Trick of the trade."
"[english]dota_chatwheel_label_terrorblade_1"	"Trick of the trade."
"dota_chatwheel_message_terrorblade_2"	"Your own worst enemy."
"[english]dota_chatwheel_message_terrorblade_2"	"Your own worst enemy."
"dota_chatwheel_label_terrorblade_2"	"Your own worst enemy."
"[english]dota_chatwheel_label_terrorblade_2"	"Your own worst enemy."
"dota_chatwheel_message_terrorblade_3"	"Perhaps that wasn't wise."
"[english]dota_chatwheel_message_terrorblade_3"	"Perhaps that wasn't wise."
"dota_chatwheel_label_terrorblade_3"	"Perhaps that wasn't wise."
"[english]dota_chatwheel_label_terrorblade_3"	"Perhaps that wasn't wise."
"dota_chatwheel_message_terrorblade_4"	"A wise blade takes a fool's life."
"[english]dota_chatwheel_message_terrorblade_4"	"A wise blade takes a fool's life."
"dota_chatwheel_label_terrorblade_4"	"Wise blade."
"[english]dota_chatwheel_label_terrorblade_4"	"Wise blade."
"dota_chatwheel_message_terrorblade_5"	"Fight me, cowards!"
"[english]dota_chatwheel_message_terrorblade_5"	"Fight me, cowards!"
"dota_chatwheel_label_terrorblade_5"	"Fight me!"
"[english]dota_chatwheel_label_terrorblade_5"	"Fight me!"
"dota_chatwheel_message_phoenix_laugh"	"Laughing Squawk"
"[english]dota_chatwheel_message_phoenix_laugh"	"Laughing Squawk"
"dota_chatwheel_label_phoenix_laugh"	"Laughing Squawk"
"[english]dota_chatwheel_label_phoenix_laugh"	"Laughing Squawk"
"dota_chatwheel_message_phoenix_thank"	"Thankful Squawk"
"[english]dota_chatwheel_message_phoenix_thank"	"Thankful Squawk"
"dota_chatwheel_label_phoenix_thank"	"Thankful Squawk"
"[english]dota_chatwheel_label_phoenix_thank"	"Thankful Squawk"
"dota_chatwheel_message_phoenix_deny"	"Denying Squawk"
"[english]dota_chatwheel_message_phoenix_deny"	"Denying Squawk"
"dota_chatwheel_label_phoenix_deny"	"Denying Squawk"
"[english]dota_chatwheel_label_phoenix_deny"	"Denying Squawk"
"dota_chatwheel_message_phoenix_1"	"Triumphant Squawk"
"[english]dota_chatwheel_message_phoenix_1"	"Triumphant Squawk"
"dota_chatwheel_label_phoenix_1"	"Triumphant Squawk"
"[english]dota_chatwheel_label_phoenix_1"	"Triumphant Squawk"
"dota_chatwheel_message_phoenix_2"	"Sorrowful Squawk"
"[english]dota_chatwheel_message_phoenix_2"	"Sorrowful Squawk"
"dota_chatwheel_label_phoenix_2"	"Sorrowful Squawk"
"[english]dota_chatwheel_label_phoenix_2"	"Sorrowful Squawk"
"dota_chatwheel_message_phoenix_3"	"Taunting Squawk"
"[english]dota_chatwheel_message_phoenix_3"	"Taunting Squawk"
"dota_chatwheel_label_phoenix_3"	"Taunting Squawk"
"[english]dota_chatwheel_label_phoenix_3"	"Taunting Squawk"
"dota_chatwheel_message_phoenix_4"	"Angry Squawk"
"[english]dota_chatwheel_message_phoenix_4"	"Angry Squawk"
"dota_chatwheel_label_phoenix_4"	"Angry Squawk"
"[english]dota_chatwheel_label_phoenix_4"	"Angry Squawk"
"dota_chatwheel_message_phoenix_5"	"Contented Squawk"
"[english]dota_chatwheel_message_phoenix_5"	"Contented Squawk"
"dota_chatwheel_label_phoenix_5"	"Contented Squawk"
"[english]dota_chatwheel_label_phoenix_5"	"Contented Squawk"
"dota_chatwheel_message_oracle_laugh"	"He ha ha he ha ha!"
"[english]dota_chatwheel_message_oracle_laugh"	"He ha ha he ha ha!"
"dota_chatwheel_label_oracle_laugh"	"[大笑]"
"[english]dota_chatwheel_label_oracle_laugh"	"Laugh"
"dota_chatwheel_message_oracle_thank"	"Faith in fate restored."
"[english]dota_chatwheel_message_oracle_thank"	"Faith in fate restored."
"dota_chatwheel_label_oracle_thank"	"Faith in fate restored."
"[english]dota_chatwheel_label_oracle_thank"	"Faith in fate restored."
"dota_chatwheel_message_oracle_deny"	"I want to die."
"[english]dota_chatwheel_message_oracle_deny"	"I want to die."
"dota_chatwheel_label_oracle_deny"	"I want to die."
"[english]dota_chatwheel_label_oracle_deny"	"I want to die."
"dota_chatwheel_message_oracle_1"	"I saw that."
"[english]dota_chatwheel_message_oracle_1"	"I saw that."
"dota_chatwheel_label_oracle_1"	"I saw that."
"[english]dota_chatwheel_label_oracle_1"	"I saw that."
"dota_chatwheel_message_oracle_2"	"I am shocked. Shocked!"
"[english]dota_chatwheel_message_oracle_2"	"I am shocked. Shocked!"
"dota_chatwheel_label_oracle_2"	"I am shocked."
"[english]dota_chatwheel_label_oracle_2"	"I am shocked."
"dota_chatwheel_message_oracle_3"	"That was odd indeed!"
"[english]dota_chatwheel_message_oracle_3"	"That was odd indeed!"
"dota_chatwheel_label_oracle_3"	"That was odd indeed!"
"[english]dota_chatwheel_label_oracle_3"	"That was odd indeed!"
"dota_chatwheel_message_oracle_4"	"Even you should've seen that coming. But you didn't."
"[english]dota_chatwheel_message_oracle_4"	"Even you should've seen that coming. But you didn't."
"dota_chatwheel_label_oracle_4"	"You should've seen that coming."
"[english]dota_chatwheel_label_oracle_4"	"You should've seen that coming."
"dota_chatwheel_message_oracle_5"	"You will die in a house fire."
"[english]dota_chatwheel_message_oracle_5"	"You will die in a house fire."
"dota_chatwheel_label_oracle_5"	"You will die in a house fire."
"[english]dota_chatwheel_label_oracle_5"	"You will die in a house fire."
"dota_chatwheel_message_arc_warden_laugh"	"Hm hm hm hm hm hm hm hm hm hm hm hm hm hm hm."
"[english]dota_chatwheel_message_arc_warden_laugh"	"Hm hm hm hm hm hm hm hm hm hm hm hm hm hm hm."
"dota_chatwheel_label_arc_warden_laugh"	"[大笑]"
"[english]dota_chatwheel_label_arc_warden_laugh"	"Laugh"
"dota_chatwheel_message_arc_warden_thank"	"Your grace is noted."
"[english]dota_chatwheel_message_arc_warden_thank"	"Your grace is noted."
"dota_chatwheel_label_arc_warden_thank"	"Your grace is noted."
"[english]dota_chatwheel_label_arc_warden_thank"	"Your grace is noted."
"dota_chatwheel_message_arc_warden_deny"	"Do not be selfish."
"[english]dota_chatwheel_message_arc_warden_deny"	"Do not be selfish."
"dota_chatwheel_label_arc_warden_deny"	"Do not be selfish."
"[english]dota_chatwheel_label_arc_warden_deny"	"Do not be selfish."
"dota_chatwheel_message_arc_warden_1"	"Busted."
"[english]dota_chatwheel_message_arc_warden_1"	"Busted."
"dota_chatwheel_label_arc_warden_1"	"Busted."
"[english]dota_chatwheel_label_arc_warden_1"	"Busted."
"dota_chatwheel_message_arc_warden_2"	"What have you done?"
"[english]dota_chatwheel_message_arc_warden_2"	"What have you done?"
"dota_chatwheel_label_arc_warden_2"	"What have you done?"
"[english]dota_chatwheel_label_arc_warden_2"	"What have you done?"
"dota_chatwheel_message_arc_warden_3"	"A mere diversion."
"[english]dota_chatwheel_message_arc_warden_3"	"A mere diversion."
"dota_chatwheel_label_arc_warden_3"	"A mere diversion."
"[english]dota_chatwheel_label_arc_warden_3"	"A mere diversion."
"dota_chatwheel_message_arc_warden_4"	"Frowny face."
"[english]dota_chatwheel_message_arc_warden_4"	"Frowny face."
"dota_chatwheel_label_arc_warden_4"	"Frowny face."
"[english]dota_chatwheel_label_arc_warden_4"	"Frowny face."
"dota_chatwheel_message_arc_warden_5"	"You do not have to be mad."
"[english]dota_chatwheel_message_arc_warden_5"	"You do not have to be mad."
"dota_chatwheel_label_arc_warden_5"	"You do not have to be mad."
"[english]dota_chatwheel_label_arc_warden_5"	"You do not have to be mad."
"dota_chatwheel_message_winter_wyvern_laugh"	"Ah ha ha ha ha ha ha ha ha ha ha!"
"[english]dota_chatwheel_message_winter_wyvern_laugh"	"Ah ha ha ha ha ha ha ha ha ha ha!"
"dota_chatwheel_label_winter_wyvern_laugh"	"[大笑]"
"[english]dota_chatwheel_label_winter_wyvern_laugh"	"Laugh"
"dota_chatwheel_message_winter_wyvern_thank"	"Wonderful!"
"[english]dota_chatwheel_message_winter_wyvern_thank"	"Wonderful!"
"dota_chatwheel_label_winter_wyvern_thank"	"Wonderful."
"[english]dota_chatwheel_label_winter_wyvern_thank"	"Wonderful."
"dota_chatwheel_message_winter_wyvern_deny"	"Chill, baby."
"[english]dota_chatwheel_message_winter_wyvern_deny"	"Chill, baby."
"dota_chatwheel_label_winter_wyvern_deny"	"Chill, baby."
"[english]dota_chatwheel_label_winter_wyvern_deny"	"Chill, baby."
"dota_chatwheel_message_winter_wyvern_1"	"That was not wise!"
"[english]dota_chatwheel_message_winter_wyvern_1"	"That was not wise!"
"dota_chatwheel_label_winter_wyvern_1"	"That was not wise."
"[english]dota_chatwheel_label_winter_wyvern_1"	"That was not wise."
"dota_chatwheel_message_winter_wyvern_2"	"Poor dear."
"[english]dota_chatwheel_message_winter_wyvern_2"	"Poor dear."
"dota_chatwheel_label_winter_wyvern_2"	"Poor dear."
"[english]dota_chatwheel_label_winter_wyvern_2"	"Poor dear."
"dota_chatwheel_message_winter_wyvern_3"	"Never ask a wyvern why."
"[english]dota_chatwheel_message_winter_wyvern_3"	"Never ask a wyvern why."
"dota_chatwheel_label_winter_wyvern_3"	"Never ask a wyvern why."
"[english]dota_chatwheel_label_winter_wyvern_3"	"Never ask a wyvern why."
"dota_chatwheel_message_winter_wyvern_4"	"Well deserved!"
"[english]dota_chatwheel_message_winter_wyvern_4"	"Well deserved!"
"dota_chatwheel_label_winter_wyvern_4"	"Well deserved."
"[english]dota_chatwheel_label_winter_wyvern_4"	"Well deserved."
"dota_chatwheel_message_winter_wyvern_5"	"Ah, I've never felt this good! Ah ha ha ha ha!"
"[english]dota_chatwheel_message_winter_wyvern_5"	"Ah, I've never felt this good! Ah ha ha ha ha!"
"dota_chatwheel_label_winter_wyvern_5"	"Never felt this good!"
"[english]dota_chatwheel_label_winter_wyvern_5"	"Never felt this good!"
"dota_chatwheel_message_monkey_king_laugh"	"Ah ha ha ha ha ha. Woohoohoohoo. Ohhh heee."
"[english]dota_chatwheel_message_monkey_king_laugh"	"Ah ha ha ha ha ha. Woohoohoohoo. Ohhh heee."
"dota_chatwheel_label_monkey_king_laugh"	"[大笑]"
"[english]dota_chatwheel_label_monkey_king_laugh"	"Laugh"
"dota_chatwheel_message_monkey_king_thank"	"This'll work."
"[english]dota_chatwheel_message_monkey_king_thank"	"This'll work."
"dota_chatwheel_label_monkey_king_thank"	"This'll work."
"[english]dota_chatwheel_label_monkey_king_thank"	"This'll work."
"dota_chatwheel_message_monkey_king_deny"	"I feel better already."
"[english]dota_chatwheel_message_monkey_king_deny"	"I feel better already."
"dota_chatwheel_label_monkey_king_deny"	"I feel better already."
"[english]dota_chatwheel_label_monkey_king_deny"	"I feel better already."
"dota_chatwheel_message_monkey_king_1"	"Ohh, I'll be signing autographs out front."
"[english]dota_chatwheel_message_monkey_king_1"	"Ohh, I'll be signing autographs out front."
"dota_chatwheel_label_monkey_king_1"	"Signing autographs"
"[english]dota_chatwheel_label_monkey_king_1"	"Signing autographs"
"dota_chatwheel_message_monkey_king_2"	"Ok, that was unexpected."
"[english]dota_chatwheel_message_monkey_king_2"	"Ok, that was unexpected."
"dota_chatwheel_label_monkey_king_2"	"Ok, that was unexpected.."
"[english]dota_chatwheel_label_monkey_king_2"	"Ok, that was unexpected.."
"dota_chatwheel_message_monkey_king_3"	"Alright."
"[english]dota_chatwheel_message_monkey_king_3"	"Alright."
"dota_chatwheel_label_monkey_king_3"	"Alright."
"[english]dota_chatwheel_label_monkey_king_3"	"Alright."
"dota_chatwheel_message_monkey_king_4"	"I'll pretend I didn't enjoy this."
"[english]dota_chatwheel_message_monkey_king_4"	"I'll pretend I didn't enjoy this."
"dota_chatwheel_label_monkey_king_4"	"I'll pretend I didn't enjoy this."
"[english]dota_chatwheel_label_monkey_king_4"	"I'll pretend I didn't enjoy this."
"dota_chatwheel_message_monkey_king_5"	"This was over before it started."
"[english]dota_chatwheel_message_monkey_king_5"	"This was over before it started."
"dota_chatwheel_label_monkey_king_5"	"Over before it started."
"[english]dota_chatwheel_label_monkey_king_5"	"Over before it started."
"dota_chatwheel_message_dark_willow_laugh"	"Hahaha ahaha ahaha ahhahahahahaa!"
"[english]dota_chatwheel_message_dark_willow_laugh"	"Hahaha ahaha ahaha ahhahahahahaa!"
"dota_chatwheel_label_dark_willow_laugh"	"[大笑]"
"[english]dota_chatwheel_label_dark_willow_laugh"	"Laugh"
"dota_chatwheel_message_dark_willow_thank"	"Just what I was waiting for."
"[english]dota_chatwheel_message_dark_willow_thank"	"Just what I was waiting for."
"dota_chatwheel_label_dark_willow_thank"	"Just what I was waiting for."
"[english]dota_chatwheel_label_dark_willow_thank"	"Just what I was waiting for."
"dota_chatwheel_message_dark_willow_deny"	"I won't lie, that was unexpected..."
"[english]dota_chatwheel_message_dark_willow_deny"	"I won't lie, that was unexpected..."
"dota_chatwheel_label_dark_willow_deny"	"That was unexpected"
"[english]dota_chatwheel_label_dark_willow_deny"	"That was unexpected"
"dota_chatwheel_message_dark_willow_1"	"No. Just... no."
"[english]dota_chatwheel_message_dark_willow_1"	"No. Just... no."
"dota_chatwheel_label_dark_willow_1"	"No. Just... no."
"[english]dota_chatwheel_label_dark_willow_1"	"No. Just... no."
"dota_chatwheel_message_dark_willow_2"	"Never had a chance..."
"[english]dota_chatwheel_message_dark_willow_2"	"Never had a chance..."
"dota_chatwheel_label_dark_willow_2"	"Never had a chance."
"[english]dota_chatwheel_label_dark_willow_2"	"Never had a chance."
"dota_chatwheel_message_dark_willow_3"	"Oh-ho. Don't mind me. Just a wee fairy going about her business."
"[english]dota_chatwheel_message_dark_willow_3"	"Oh-ho. Don't mind me. Just a wee fairy going about her business."
"dota_chatwheel_label_dark_willow_3"	"Don't mind me."
"[english]dota_chatwheel_label_dark_willow_3"	"Don't mind me."
"dota_chatwheel_message_dark_willow_4"	"I don't know what I was expecting."
"[english]dota_chatwheel_message_dark_willow_4"	"I don't know what I was expecting."
"dota_chatwheel_label_dark_willow_4"	"Don't know what I was expecting."
"[english]dota_chatwheel_label_dark_willow_4"	"Don't know what I was expecting."
"dota_chatwheel_message_dark_willow_5"	"This makes absolutely no sense."
"[english]dota_chatwheel_message_dark_willow_5"	"This makes absolutely no sense."
"dota_chatwheel_label_dark_willow_5"	"Makes no sense."
"[english]dota_chatwheel_label_dark_willow_5"	"Makes no sense."
"dota_chatwheel_message_pangolier_laugh"	"Aaaah ha hahahaha hahahaaa huu."
"[english]dota_chatwheel_message_pangolier_laugh"	"Aaaah ha hahahaha hahahaaa huu."
"dota_chatwheel_label_pangolier_laugh"	"[大笑]"
"[english]dota_chatwheel_label_pangolier_laugh"	"Laugh"
"dota_chatwheel_message_pangolier_thank"	"Was that intentional? It looked intentional."
"[english]dota_chatwheel_message_pangolier_thank"	"Was that intentional? It looked intentional."
"dota_chatwheel_label_pangolier_thank"	"Was that intentional?"
"[english]dota_chatwheel_label_pangolier_thank"	"Was that intentional?"
"dota_chatwheel_message_pangolier_deny"	"Were you watching? That's how it's done."
"[english]dota_chatwheel_message_pangolier_deny"	"Were you watching? That's how it's done."
"dota_chatwheel_label_pangolier_deny"	"How it's done."
"[english]dota_chatwheel_label_pangolier_deny"	"How it's done."
"dota_chatwheel_message_pangolier_1"	"Try a bit harder next time..."
"[english]dota_chatwheel_message_pangolier_1"	"Try a bit harder next time..."
"dota_chatwheel_label_pangolier_1"	"Try Harder"
"[english]dota_chatwheel_label_pangolier_1"	"Try Harder"
"dota_chatwheel_message_pangolier_2"	"That does not look good."
"[english]dota_chatwheel_message_pangolier_2"	"That does not look good."
"dota_chatwheel_label_pangolier_2"	"Not look good"
"[english]dota_chatwheel_label_pangolier_2"	"Not look good"
"dota_chatwheel_message_pangolier_3"	"Beep Beep!"
"[english]dota_chatwheel_message_pangolier_3"	"Beep Beep!"
"dota_chatwheel_label_pangolier_3"	"Beep Beep!"
"[english]dota_chatwheel_label_pangolier_3"	"Beep Beep!"
"dota_chatwheel_message_pangolier_4"	"Now it's just unfair."
"[english]dota_chatwheel_message_pangolier_4"	"Now it's just unfair."
"dota_chatwheel_label_pangolier_4"	"Now it's just unfair."
"[english]dota_chatwheel_label_pangolier_4"	"Now it's just unfair."
"dota_chatwheel_message_pangolier_5"	"So this whole mess is all your fault?"
"[english]dota_chatwheel_message_pangolier_5"	"So this whole mess is all your fault?"
"dota_chatwheel_label_pangolier_5"	"All your fault?"
"[english]dota_chatwheel_label_pangolier_5"	"All your fault?"
"dota_chatwheel_message_grimstroke_laugh"	"Huh huh ha ha ha ha ha ha ha haaa!"
"[english]dota_chatwheel_message_grimstroke_laugh"	"Huh huh ha ha ha ha ha ha ha haaa!"
"dota_chatwheel_label_grimstroke_laugh"	"[大笑]"
"[english]dota_chatwheel_label_grimstroke_laugh"	"Laugh"
"dota_chatwheel_message_grimstroke_thank"	"Oh, that is too good!"
"[english]dota_chatwheel_message_grimstroke_thank"	"Oh, that is too good!"
"dota_chatwheel_label_grimstroke_thank"	"Oh, that is too good!"
"[english]dota_chatwheel_label_grimstroke_thank"	"Oh, that is too good!"
"dota_chatwheel_message_grimstroke_deny"	"You die, yet your failure lives on..."
"[english]dota_chatwheel_message_grimstroke_deny"	"You die, yet your failure lives on..."
"dota_chatwheel_label_grimstroke_deny"	"You die, yet your failure..."
"[english]dota_chatwheel_label_grimstroke_deny"	"You die, yet your failure..."
"dota_chatwheel_message_grimstroke_1"	"You should have known better..."
"[english]dota_chatwheel_message_grimstroke_1"	"You should have known better..."
"dota_chatwheel_label_grimstroke_1"	"You should have known better..."
"[english]dota_chatwheel_label_grimstroke_1"	"You should have known better..."
"dota_chatwheel_message_grimstroke_2"	"These wretched fools have no idea..."
"[english]dota_chatwheel_message_grimstroke_2"	"These wretched fools have no idea..."
"dota_chatwheel_label_grimstroke_2"	"These wretched fools..."
"[english]dota_chatwheel_label_grimstroke_2"	"These wretched fools..."
"dota_chatwheel_message_grimstroke_3"	"Know your place."
"[english]dota_chatwheel_message_grimstroke_3"	"Know your place."
"dota_chatwheel_label_grimstroke_3"	"Know your place."
"[english]dota_chatwheel_label_grimstroke_3"	"Know your place."
"dota_chatwheel_message_grimstroke_4"	"You've a mind like a child!"
"[english]dota_chatwheel_message_grimstroke_4"	"You've a mind like a child!"
"dota_chatwheel_label_grimstroke_4"	"You've a mind like a child!"
"[english]dota_chatwheel_label_grimstroke_4"	"You've a mind like a child!"
"dota_chatwheel_message_grimstroke_5"	"Watch the master at work."
"[english]dota_chatwheel_message_grimstroke_5"	"Watch the master at work."
"dota_chatwheel_label_grimstroke_5"	"Watch the master at work."
"[english]dota_chatwheel_label_grimstroke_5"	"Watch the master at work."
"dota_chatwheel_message_mars_laugh"	"Huh huh ha ha ha ha ha ha ha haaa!"
"[english]dota_chatwheel_message_mars_laugh"	"Huh huh ha ha ha ha ha ha ha haaa!"
"dota_chatwheel_label_mars_laugh"	"[大笑]"
"[english]dota_chatwheel_label_mars_laugh"	"Laugh"
"dota_chatwheel_message_mars_thank"	"My thanks will come later, when you least expect it!"
"[english]dota_chatwheel_message_mars_thank"	"My thanks will come later, when you least expect it!"
"dota_chatwheel_label_mars_thank"	"My thanks will come later..."
"[english]dota_chatwheel_label_mars_thank"	"My thanks will come later..."
"dota_chatwheel_message_mars_deny"	"Ohh, that's no good."
"[english]dota_chatwheel_message_mars_deny"	"Ohh, that's no good."
"dota_chatwheel_label_mars_deny"	"Ohh, that's no good."
"[english]dota_chatwheel_label_mars_deny"	"Ohh, that's no good."
"dota_chatwheel_message_mars_1"	"I'll always remember how foolish you looked."
"[english]dota_chatwheel_message_mars_1"	"I'll always remember how foolish you looked."
"dota_chatwheel_label_mars_1"	"...How foolish you looked."
"[english]dota_chatwheel_label_mars_1"	"...How foolish you looked."
"dota_chatwheel_message_mars_2"	"The only one surprised by this is you."
"[english]dota_chatwheel_message_mars_2"	"The only one surprised by this is you."
"dota_chatwheel_label_mars_2"	"The only one surprised..."
"[english]dota_chatwheel_label_mars_2"	"The only one surprised..."
"dota_chatwheel_message_mars_3"	"Fight me!"
"[english]dota_chatwheel_message_mars_3"	"Fight me!"
"dota_chatwheel_label_mars_3"	"Fight me!"
"[english]dota_chatwheel_label_mars_3"	"Fight me!"
"dota_chatwheel_message_mars_4"	"DADADA DA DA DA-DA-DA!"
"[english]dota_chatwheel_message_mars_4"	"DADADA DA DA DA-DA-DA!"
"dota_chatwheel_label_mars_4"	"DADADA DA DA DA-DA-DA!"
"[english]dota_chatwheel_label_mars_4"	"DADADA DA DA DA-DA-DA!"
"dota_chatwheel_message_mars_5"	"THIS IS DOOOOTAAAAA!"
"[english]dota_chatwheel_message_mars_5"	"THIS IS DOOOOTAAAAA!"
"dota_chatwheel_label_mars_5"	"THIS IS DOOOOTAAAAA!"
"[english]dota_chatwheel_label_mars_5"	"THIS IS DOOOOTAAAAA!"
"dota_chatwheel_label_snapfire_laugh"	"大笑"
"[english]dota_chatwheel_label_snapfire_laugh"	"Laugh"
"dota_chatwheel_message_snapfire_thank"	"感謝您！"
"[english]dota_chatwheel_message_snapfire_thank"	"Why thank you!"
"dota_chatwheel_label_snapfire_thank"	"感謝您！"
"[english]dota_chatwheel_label_snapfire_thank"	"Why thank you!"
"dota_chatwheel_message_snapfire_deny"	"Yeee-haw!"
"[english]dota_chatwheel_message_snapfire_deny"	"Yeee-haw!"
"dota_chatwheel_label_snapfire_deny"	"Yeee-haw!"
"[english]dota_chatwheel_label_snapfire_deny"	"Yeee-haw!"
}
