"leagues"
{
"league_name_17"	"G-1 Champions League - 5ª Temporada"
"[english]league_name_17"	"G-1 Champions League Season 5"
"league_description_17"	"Um torneio internacional de Dota 2 organizado na China com o maior prémio total do país."
"[english]league_description_17"	"International DOTA2 tournament held by Chinese with the highest prizepool in China"
"league_name_32"	"WePlay Dota 2"
"[english]league_name_32"	"WePlay Dota 2"
"league_description_32"	"A WePlay.TV apresenta a WePlay Dota 2 League, patrocinada por Logitech, Western Digital e Inno3D! A partir de março, 32 das melhores equipas ocidentais vão dar o seu melhor por um prémio de $20000 em dinheiro e periféricos, com o comentário de Beyond the Summit e WePlay.TV."
"[english]league_description_32"	"WePlay.TV proudly presents the WePlay Dota 2 League, brought to you by Logitech, Western Digital, and Inno3D! Beginning this March, thirty-two of Western Dota’s best will duke it out online for $20,000 in cash & gear prizes with professional commentary from Beyond the Summit and WePlay.TV. "
"league_name_36"	"Netolic Pro League - 2ª Edição"
"[english]league_name_36"	"Netolic Pro League 2nd edition"
"league_description_36"	"16 equipas serão selecionadas para participar no torneio: oito equipas convidadas e oito equipas vindas das eliminatórias."
"[english]league_description_36"	"A total of 16 teams will be selected to participate in the tournament - eight invited teams and eight teams from the qualifiers."
"league_name_38"	"E2Max L33T Championship"
"[english]league_name_38"	"E2Max L33T Championship"
"league_description_38"	"O E2Max L33T Championship (ELC) terá um prémio de 13.000 SGD. As eliminatórias são desde maio até julho e as grandes finais a 7 de julho na E2Max, em Cineleisure, Singapura! Apresentado por Cathay, organizado pela Rapture Gaming Network e com o apoio de e-Club e CM Storm."
"[english]league_description_38"	"The inaugural E2Max L33T Championship (ELC) will feature a prize pool of SGD13,000 cash. online and LAN qualifiers from May to July, with the Grand Finals on 7th July at E2Max, Cineleisure, Singapore!  ELC is presented by Cathay, hosted by Rapture Gaming Network, supported by e-Club and CM Storm."
"league_name_39"	"GEST Dota 2 (abril e maio)"
"[english]league_name_39"	"GEST Dota 2 - April and May"
"league_description_39"	"O Gigabyte E-Sports Tournament é patrocinado por Gigabyte e organizado por DotaTalk. Os vencedores de 8 eliminatórias do sudeste da Ásia irão competir entre si por um prémio de 1500$. Os vencedores irão depois competir contra as melhores equipas chinesas por mais 1500$."
"[english]league_description_39"	"The Gigabyte E-sports tournament is sponsored by Gigabyte and hosted by DotaTalk. The winneres of 8 GMPGL Qualifiers from South-East Asia will compete against one another for another cash prize of $1500. The winners will then compete against the Top Chinese Teams for another $1500."
"league_name_40"	"AMD Dota2 Premier League"
"[english]league_name_40"	"AMD Dota2 Premier League"
"league_description_40"	"É com orgulho que a AMD e o DotaTalk te trazem a AMD Premier League. O torneio conta com as melhores equipas do sudeste da Ásia, onde irão competir pelo prémio total de $5000. Dois meses de ação intensa que incluem os comentários de GoDz, LD, Luminous e Blaze em BeyondthesummitTV."
"[english]league_description_40"	"AMD, in partnership with DotaTalk, proudly brings you the AMD Premier League. The tournament features SEA’s finest teams as they compete for a total prize pool of $5,000. Two months of intense action will be commentated by GoDz, LD, Luminous and Blaze on BeyondthesummitTV."
"league_name_41"	"Curse Dota 2 Invitational"
"[english]league_name_41"	"Curse Dota 2 Invitational"
"league_description_41"	"Um torneio de 3 fins de semana com um prémio total de 10.000$, patrocinado por Alienware."
"[english]league_description_41"	"3 Weekend $10,000 Tournament Sponsored by Ailenware"
"league_name_43"	"PGF Summer Assembly"
"[english]league_name_43"	"PGF Summer Assembly"
"league_description_43"	"De 11 a 12 de maio, equipas internacionais vão invadir Manila para competir com equipas filipinas por um prémio total de 1750$ e mais! Neolution.Orange, Neolution.International e PMS|Asterisk* vão enfrentar 5 equipas filipinas no evento Pinoy Gaming Festival Summer Assembly 2013."
"[english]league_description_43"	"Coming May 11-12, we see foreign invasion in Manila to challenge the Filipino teams for a total coveted cash prize of USD$1,750 & more! Its Neolution.Orange, Neolution.International & PMS|Asterisk* up against 5 Filipino teams over at the Pinoy Gaming Festival Summer Assembly 2013. "
"league_name_44"	"Rapture Gaming Network League"
"[english]league_name_44"	"Rapture Gaming Network League"
"league_description_44"	"O bilhete da Rapture Gaming Network League 2013/2014 dá-te acesso a 198 partidas durante 9 meses entre as 10 melhores equipas da Ásia. Com um prémio de 19000 SGD, esta é das maiores ligas de Dota 2 na Ásia! Comentário em inglês, filipino, tailandês e vietnamita, proporcionado por RGN."
"[english]league_description_44"	"Rapture Gaming Network League 2013/2014 ticket gives you access to 198 matches over 9 months of the 10 premier teams in Asia vying for a prize pool of SGD19,000 cash, this is one of the biggest DOTA 2 leagues in Asia! Commentary in English, Filipino, Thai, and Vietnamese will be provided by RGN."
"league_name_45"	"Premier League - 5ª Temporada"
"[english]league_name_45"	"Premier League Season 5 "
"league_description_45"	"NOVO FORMATO: A liga irá seguir um programa de 1 torneio por semana durante 7 semanas (aos domingos e segundas). As 4 melhores equipas ganham pontos. No fim da temporada, depois dos 7 torneios, as 4 equipas com mais pontos vão jogar na Supercup e competir por um prémio de 15.000$."
"[english]league_description_45"	"NEW FORMAT:  The league will follow a schedule of 1 cup every week during 7 weeks (Sunday & Monday).  The teams ending cups from position 1 to 4 will gain points. At the end of the season, after the 7 cups are played, the top 4 in the ranking will  join the Supercup and fight for a prize of $15,000."
"league_name_61"	"Electronic Sports World Cup 2013"
"[english]league_name_61"	"Electronic Sports World Cup 2013"
"league_description_61"	"A temporada de Dota 2 da ESWC 2013 irá contar com eliminatórias regionais online de maio a setembro de 2013 e uma grande final em Paris com as equipas campeãs de cada região, de 30 de outubro a 3 de novembro de 2013."
"[english]league_description_61"	"ESWC 2013 season on Dota 2 will feature regional online qualifying tournaments from May to September 2013, and a Grand Final tournament gathering all the selected champions in Paris from October 30 to November 3, 2013."
"league_name_137"	"SDL 2014 - 1ª Temporada"
"[english]league_name_137"	"SDL 2014 Season 1"
"league_description_137"	"A SDL consiste em 3 ligas amadoras e 1 profissional. No fim da temporada, as equipas irão competir pelo prémio total de 2500 reais, sendo 500 reais referentes a cada liga amadora e 1000 reais à profissional."
"[english]league_description_137"	"3 amateur leagues and 1 professional south american at the end of season aproximadely 150 teams giving their best to get the prize of R$ 2500,00 (R$ 500,00 each amateur and R$ 1000,00 pro league)"
"league_name_146"	"AsianCyberGames Dota 2 Championship 2013"
"[english]league_name_146"	"AsianCyberGames Dota 2 Championship 2013"
"league_description_146"	"Um torneio no formato de partida única com eliminação dupla, e melhor de três nas quatro fases finais."
"[english]league_description_146"	"Double Elimination Format BO1, Top 4 BO3"
"league_name_148"	"Dota2.fr League"
"[english]league_name_148"	"Dota2.fr League"
"league_description_148"	"As melhores equipas francesas competem todas as semanas na liga principal francesa."
"[english]league_description_148"	"The best french teams compete every week in the major french League"
"league_name_149"	"Macedonian Dota 2 Cup #2"
"[english]league_name_149"	"Macedonian Dota 2 Cup #2"
"league_description_149"	"Um torneio macedónio onde as melhores equipas do país competem por um prémio!"
"[english]league_description_149"	"A Macedonian tournament including all Macedonian teams where best teams compete for a prize."
"league_name_157"	"AD2L Playoffs - 1ª Temporada"
"[english]league_name_157"	"AD2L Season 1 Playoffs"
"league_description_157"	"Para aquelas equipas que não são tão boas como a [A]lliance."
"[english]league_description_157"	"For those of us not as good as [A]lliance"
"league_name_158"	"AD2L - 2ª Temporada"
"[english]league_name_158"	"AD2L Season 2"
"league_description_158"	"Para aquelas equipas que não são tão boas como a [A]lliance."
"[english]league_description_158"	"For those of us not as good as [A]lliance"
"league_name_164"	"Doteirão League - 5ª Temporada"
"[english]league_name_164"	"DoteirÃ£o League Season 5"
"league_description_164"	"As 8 melhores equipas brasileiras competem por um prémio de 1000 reais durante dois meses de campeonato."
"[english]league_description_164"	"As 8 melhores equipes brasileiras disputando uma premiaÃ§Ã£o de R$1000,00 em dois meses de campeonato."
"league_name_174"	"AsianCyberGames SEA Invitational - BEST OF THE BEST"
"[english]league_name_174"	"AsianCyberGames SEA Invitational - BEST OF THE BEST"
"league_description_174"	"Fase de grupos seguida de melhor de 3 em eliminação única"
"[english]league_description_174"	"Group stage which leads into Single Elimination BO3"
"league_name_175"	"Macedonian Elite League"
"[english]league_name_175"	"Macedonian Elite League"
"league_description_175"	"Uma liga onde os melhores jogadores da Macedónia em 2 divisões diferentes competem por um prémio."
"[english]league_description_175"	"A League where top players from Macedonia in 2 Diffrent Divisions compete for a prize."
"league_name_176"	"Netolic Pro League 5 - West"
"[english]league_name_176"	"Netolic Pro League 5 - West"
"league_description_176"	"A Netolic Pro League West 5 convida as melhores equipas da Europa e das Américas para uma competição. Inclui um conjunto exclusivo para o Pugna"
"[english]league_description_176"	"Netolic Pro League West 5  Inviting the best teams and rivalries from Europe and the Americas to fight it out it includes an exclusive Pugna set"
"league_name_177"	"Netolic Pro League 5 - East"
"[english]league_name_177"	"Netolic Pro League 5 - East"
"league_description_177"	"A Netolic Pro League East 5 convida as melhores equipas da Ásia para uma competição em torneio. Inclui um conjunto para o Chaos Knight"
"[english]league_description_177"	"Netolic Pro League East 5  Inviting the best teams from Asia to fight it out in this tournament. It includes a CK set"
"league_name_181"	"joinDOTA League"
"[english]league_name_181"	"joinDOTA League"
"league_description_181"	"A liga de Dota 2 global para toda a gente. Inclui pelo menos 75% das partidas da primeira divisão e algumas partidas das outras divisões."
"[english]league_description_181"	"The global Dota 2 league for everyone. Featured are at least 75% of the matches from the premier divison, as well as a few games from lower divisions."
"league_name_184"	"MLG T.K.O."
"[english]league_name_184"	"MLG T.K.O."
"league_description_184"	"8 equipas europeias e 8 equipas americanas prestigiadas competem por 60.000$ no formato inovador de knockout."
"[english]league_description_184"	"8 European and 8 American topteams compete for 60,000 USD in the innovative knockout format."
"league_name_186"	"1ª Copa BoraDota"
"[english]league_name_186"	"1ª Copa BoraDota"
"league_description_186"	"Uma liga amadora brasileira no formato do Mundial que conta com a participação de 32 equipas, assim como um prémio de 600 reais e outras surpresas."
"[english]league_description_186"	"Amateur Brazilian league with 32 teams in the World Cup format. Award of R$ 600,00 with additional bonuses."
"league_name_189"	"Oscar Cup Tournament - 3ª Temporada"
"[english]league_name_189"	"Oscar.Cup Tournament Season 3"
"league_description_189"	"Um torneio onde equipas das séries Star, Pro, Semi e AM competem por um prémio de 200$."
"[english]league_description_189"	"Турнир проходит среди команд Star, Pro, Semi, AM серии, которые сражаются за призовой фонд в 200$. "
"league_name_190"	"ESPL - 1ª Temporada"
"[english]league_name_190"	"ESPL Season 1"
"league_description_190"	"A Electronic Sports Professionals League é um evento de 3 meses, onde equipas amadoras competirão todas as semanas por 100$ e pontos na liga. A temporada concluirá com 2 equipas profissionais e as 6 melhores equipas amadoras a competir pelo prémio total de 5900$."
"[english]league_description_190"	"The Electronic Sports Professionals League Season ONE is a 3 month long League & Tournament where Amateur teams will compete every week for $100 plus League Points. The season will conclude with a Finale, comprising of two Professional Teams and the top 6 Amateur teams, all for a $5900 prize pool."
"league_name_191"	"AOC Pro Cup - 1ª Temporada"
"[english]league_name_191"	"AOC Pro Cup - Season 1"
"league_description_191"	"A AOC Pro Cup terá as melhores equipas de Dota 2 do Sudeste Asiático, Coreia do Sul, Japão e Oceânia a enfrentar-se por um prémio de 2000$!"
"[english]league_description_191"	"AOC Pro Cup features the best Dota2 teams in SEA, Korea, Japan and Oceania competing for a cash prize of 2000USD."
"league_name_192"	"Orena Dota 2 Cup"
"[english]league_name_192"	"Orena Dota 2 Cup"
"league_description_192"	"Orena Dota 2 Cup - Patrocinado por SteelSeries e NAG Magazine"
"[english]league_description_192"	"Orena Dota 2 Cup - Sponsored by SteelSeries & NAG Magazine"
"league_name_194"	"King of the North"
"[english]league_name_194"	"King of the North"
"league_description_194"	"Temos o prazer de anunciar o King of the North, um torneio de eSports para o Dota 2, que terá lugar na Universidade de Manchester a 19 de março de 2014."
"[english]league_description_194"	"We are pleased to announce the King of the North eSports Tournament for DOTA 2! Taking place at the University of Manchester on the 19th March 2014."
"league_name_195"	"Ladder Dota2Chile.net - 1ª Temporada"
"[english]league_name_195"	"Ladder Dota2Chile.net Season #1"
"league_description_195"	"Equipas da América do Sul enfrentar-se-ão durante 8 semanas, culminando num torneio de eliminação dupla entre 8 equipas! 100% das receitas dos bilhetes vão diretamente para o prémio total."
"[english]league_description_195"	"The teams in South America compete for 8 weeks culminating in a 8-team double elimination tournament. 100% of ticket profits go straight to the prize pool."
"league_name_196"	"Dota 2 Champions League"
"[english]league_name_196"	"Dota 2 Champions League"
"league_description_196"	"A segunda temporada da Champions League contará com as 10 melhores equipas europeias e norte-americanas a competir por 50.000$!"
"[english]league_description_196"	"Champions League Season 2 will feature 10 top teams from Europe and North America fighting for $50,000! "
"league_name_197"	"KDL - 1ª Temporada"
"[english]league_name_197"	"KDL Season 1"
"league_description_197"	"A KDL começa a sua 1ª temporada com um novo sistema de divisões. A KDL durará 4 temporadas com um total de 6,5 milhões de wons coreanos em prémios. O novo sistema dá mais incentivo aos jogadores, já que o prémio se acumula de acordo com o número de vitórias."
"[english]league_description_197"	"The KDL launches its first season featuring all new Tier system. The KDL spans four seasons with a total of KRW 6.5million(USD 60,861,423) worth of prize funding. The new Winner system creates more incentive for players to win since prize money accumulates based on the number of wins."
"league_name_201"	"MPGL Presented by Gigabyte - 6ª Temporada, Eliminatórias do Sudeste Asiático"
"[english]league_name_201"	"MPGL Presented by Gigabyte Season 6 SEA Qualifiers"
"league_description_201"	"As melhores equipas do Sudeste Asiático dão tudo por tudo neste prelúdio da mais antecipada das ligas do Sudeste Asiático."
"[english]league_description_201"	"Non-stop action from SEA countries in it's sixth season. The prelude  to the most anticipated SEA league is here"
"league_name_202"	"D2RO V - Spring Cup"
"[english]league_name_202"	"D2RO V - Spring Cup"
"league_description_202"	"A D2RO está de volta com a Spring Cup! A 5ª edição terá a participação das equipas mais populares da Europa a competir por um prémio total de 1000$."
"[english]league_description_202"	"D2RO is back with The Spring Cup! The 5th edition features some of the most popular teams in Europe competing for a total prize of $1000 in cash. This ticket includes a unique Dragon Knight set!"
"league_name_203"	"DotaCinema Presents: The XMG Captains Draft Invitational"
"[english]league_name_203"	"DotaCinema Presents: The XMG Captains Draft Invitational"
"league_description_203"	"O XMG Captains Draft Invitational é o primeiro torneio de Dota 2 no modo de Seleção dos Capitães! Entre as equipas estão Alliance, Na`Vi, Fnatic, RoX.KIS, Sigma.int e Team Liquid, que irão competir por 20.000$ + 25% das receitas dos bilhetes vendidos do DotaCinema!"
"[english]league_description_203"	"The XMG Captains Draft Invitational is the first Dota 2 tournament in the Captains Draft mode, featuring Alliance, Na`Vi, Fnatic, RoX.KIS, Sigma.int and Team Liquid. The teams battle for $20,000 + 25% of DotaCinema's ticket revenue per ticket sold. The ticket is bundled with two Legion Commander ite"
"league_name_205"	"Zotac Starleague 2014"
"[english]league_name_205"	"Zotac Starleague 2014"
"league_description_205"	"Patrocinado por Zotac, organizado por Shigueo e com o apoio de Play4Dota, este é o maior torneio brasileiro de Dota 2 de sempre, com o maior prémio total na história do Dota no Brasil (10.000 reais). Após duas eliminatórias, 32 equipas de elite da América do Sul vão competir pelo prémio e pela honra."
"[english]league_description_205"	"Sponsored by Zotac and brought to you by Play4Dota and Organized by Shigueo, here's the biggest Brazilian Dota 2 Tournament ever, with the biggest prize pool of the history of Brazilian Dota (R$ 10.000,00) after 2 Qualifys, the 32 Elite Teams of South America will fight for the prize and the honor."
"league_name_207"	"SDL 2014 - 1ª Temporada, Finale"
"[english]league_name_207"	"SDL 2014 Season One Finale"
"league_description_207"	"Após três ligas amadoras, temos as 16 melhores equipas brasileiras a lutar pelo troféu e R$1.000,00 da SDL, uma das maiores Ligas da América do Sul."
"[english]league_description_207"	"After three Amateur Leagues we have the Top 16 Brazilian Teams fighting for the Trophy and R$ 1000,00 of SDL, one of the biggest Leagues of South America"
"league_name_208"	"Netolic Amateur League - 1ª Temporada"
"[english]league_name_208"	"Netolic Amateur League - Season 1"
"league_description_208"	"Um torneio aberto a todas as equipas do mundo, sem custo de inscrição! Cada temporada consiste em 4 fins de semana e o prémio total base desta liga é de 1100$ por mês, que pode aumentar dependendo das vendas dos bilhetes do torneio. 25% do valor de cada bilhete comprado serão adicionados ao prémio total."
"[english]league_description_208"	"It is an open tournament and teams from all around the world are welcome to join for free! Each season will consist in 4 weekends, the base prize pool for this League is $1,100.00 USD monthly which can increase depending on the sales of the tournament tickets, each ticket will contribute 25% "
"league_name_209"	"deafESL Dota2 League - 2ª Temporada"
"[english]league_name_209"	"deafESL Dota2 League Season 2"
"league_description_209"	"A deafESL apresenta a segunda temporada de um torneio dedicado à comunidade surda. Serão transmitidas partidas de duas divisões compostas de equipas do mundo inteiro."
"[english]league_description_209"	"The deafESL behind the second season in a tournament made ​​for the deaf community, bringing games two divisions composed of teams from around the world."
"league_name_212"	"Dota 2 Vietnam Champion League"
"[english]league_name_212"	"Dota 2 Vietnam Champion League"
"league_description_212"	"A primeira liga profissional para jogadores do Vietname, onde as equipas competem para treinar e melhorar as suas habilidades. A comunidade competitiva de Dota no Vietname foi fenomenal no passado, e queremos trazer de volta os tempos de glória que ficaram perdidos na históra."
"[english]league_description_212"	"The first professional League for Vietnam players, teams to compete to practice, to improve and be better. Vietnam Dota was great, once again we want that history to shine."
"league_name_214"	"GamerSportPeru"
"[english]league_name_214"	"GamerSportPeru"
"league_description_214"	"Liga Latinoamericana de Dota 2"
"[english]league_description_214"	"Liga Latinoamericana de Dota 2"
"league_name_215"	"MSI 'Beat It' Gaming League"
"[english]league_name_215"	"MSI 'Beat It' Gaming League"
"league_description_215"	"Uma competição de Dota 2 com um prémio total de 3000$."
"[english]league_description_215"	"Dota 2 Competiton with Total Prize $3.000"
"league_name_217"	"Brunei Dota League 2014"
"[english]league_name_217"	"Brunei Dota League 2014"
"league_description_217"	"Uma liga amadora de Dota 2 que promove a cena competitiva local e o Dota 2 à comunidade do Brunei."
"[english]league_description_217"	"Amateur Dota 2 League to boost the competitive scene locally and to promote the game of Dota 2 to the Brunei community."
"league_name_218"	"Thursday Evening Cup Series - 2ª Temporada"
"[english]league_name_218"	"Thursday Evening Cup Series Season 2"
"league_description_218"	"O Thursday Evening Cup Series (TECS) é uma série de torneios semiprofissionais para as equipas das Américas. Semanalmente haverá uma partida eliminatória única no formato \"melhor de um\". O vencedor ganhará todo o prémio de 100$."
"[english]league_description_218"	"The Thursday Evening Cup Series (TECS) is a semipro tournament series for North and South American teams. Every week there is a best-of-1 single elimination bracket, $100 winner-take-all."
"league_name_219"	"ICL DotA 2 LAN"
"[english]league_name_219"	"ICL DotA 2 LAN"
"league_description_219"	"Hungarian DotA 2 LAN league for Hungarians"
"[english]league_description_219"	"Hungarian DotA 2 LAN league for Hungarians"
"league_name_220"	"Little Yard Festival"
"[english]league_name_220"	"Little Yard Festival"
"league_description_220"	"Um torneio da Europa de Leste onde 32 equipas competem por um prémio."
"[english]league_description_220"	"В турнире будет принимать участие 32 команды из стран СНГ , "
"league_name_221"	"CEVO - 4ª Temporada"
"[english]league_name_221"	"CEVO Season 4"
"league_description_221"	"Um evento profissional e amador dos EUA onde as equipas competirão numa temporada de 8 semanas, seguida de playoffs, por mais de 5000$ e a chance de jogar em divisões mais avançadas em temporadas futuras. Compra o bilhete da 4ª temporada + a ward e ajuda a aumentar o prémio total da 5ª temporada!"
"[english]league_description_221"	"CEVO Season 4 is a North American Pro-Am event where teams compete in an 8-week regular season, followed by playoffs for over $5,000 and the chance to advance to higher skill divisions in future seasons. Purchase the Season 4 ticket + ward and help increase the prize pool in Season 5!"
"league_name_222"	"Donbass Cup 2 play off"
"[english]league_name_222"	"Donbass Cup 2 play off"
"league_description_222"	"A Donbass Cup é o primeiro torneio da Ucrânia de Leste, onde as melhores equipas da região vão competir pelo prémio de 20.000 grívnias."
"[english]league_description_222"	"Donbass Cup первый турнир в восточной Украине, собравший сильнейшие команды региона, которые будут бороться за призовой фонд, в размере 20 000 грн."
"league_name_223"	"ASUS ROG DreamLeague - 1ª Temporada"
"[english]league_name_223"	"ASUS ROG DreamLeague Season 1"
"league_description_223"	"Este evento é patrocinado pela ASUS ROG, ROCCAT e TV6. A partir de 3 de março, 12 grandes equipas irão competir em 84 partidas e nos playoffs na DreamHack Summer 2014 por um prémio de 100.000$. Compra o Compêndio, aumenta o prémio total e joga na Liga de Sonho!"
"[english]league_description_223"	"ASUS ROG DreamLeague Season 1 is sponsored by ASUS ROG, ROCCAT & TV6. Starting on 3 March, 12 of the world's best teams will compete in 84 league matches and a playoffs at DreamHack Summer 2014, $100,000 prize pool. Purchase the Compendium and extend the prize pool and play the Fantasy League."
"league_name_224"	"ProDotA 2 Solo Ranked League - 3ª Temporada"
"[english]league_name_224"	"ProDotA 2 Solo Ranked League Season 3"
"league_description_224"	"240 jogadores competem em 2 ligas diferentes (amadora e semiprofissional) sem parar durante 2 semanas para ganharem prémios no valor de até 200$."
"[english]league_description_224"	"240 players fight in 2 different leagues (Amateur and Semi-Pro) non-stop for 2 weeks to claim the prizes up to 200$"
"league_name_226"	"CIS Dota 2 League"
"[english]league_name_226"	"CIS Dota 2 League"
"league_description_226"	"32 equipas competem na CISDL por um prémio total de 200 dólares!"
"[english]league_description_226"	"32 teams compete in the ِCISDL  for a total prize pool of 200 dollars!"
"league_name_227"	"CFC Elite Cup"
"[english]league_name_227"	"CFC Elite Cup"
"league_description_227"	"Um torneio amador com um prémio total de 1200$."
"[english]league_description_227"	"Любительский турнир с призовым фондом в 1200$"
"league_name_228"	"ESL Series Brazil - 1ª Temporada"
"[english]league_name_228"	"ESL Series Brazil Season 1"
"league_description_228"	"Equipas brasileiras competem três dias por semana durante três meses por periféricos da Ozone Gaming!"
"[english]league_description_228"	"Brazilian teams fight three days a week during a three months season for gaming equipments from Ozone Gaming"
"league_name_229"	"Indonesia maindota2 League"
"[english]league_name_229"	"Indonesia maindota2 League"
"league_description_229"	"A primeira liga nacional da Indonésia. Centenas de equipas competem para alcançar divisões mais avançadas nesta liga que consta de eliminatórias e as seguintes divisões: amadora, semiprofissional e profissional. O evento conta com um prémio total de 5.580.000 rúpias indonésias, e parte das receitas provenientes da venda dos bilhetes serão adicionadas ao prémio destinado a cada divisão (20% para a amadora, 30% para a semiprofissional e 50% para a profissional)."
"[english]league_description_229"	"First national league in Indonesia. Hundread of team competing and climb higher division, from qualification, amature league, Semi-Pro League to Pro League. All ticket sold will go to prize pool in each division base on percentage (amature 20%, Semi-Pro 30%, Pro 50%) Plus total Prize Rp 5,580,000"
"league_name_230"	"Torresmo Legacy League"
"[english]league_name_230"	"Torresmo Legacy League"
"league_description_230"	"Equipas amadoras brasileiras competem por um prémio total de 900$ todos os meses."
"[english]league_description_230"	"Brazilian amateur teams compete for a 900$ prize pool monthly"
"league_name_231"	"RO goes PRO"
"[english]league_name_231"	"RO goes PRO"
"league_description_231"	"Um torneio de Dota 2 para equipas romenas."
"[english]league_description_231"	"Dota2 tournament for Romanian teams"
"league_name_232"	"SLTV Star Series - 9ª Temporada"
"[english]league_name_232"	"SLTV Star Series Season 9"
"league_description_232"	"A lendária SLTV Star Series está de volta com um novo torneio global."
"[english]league_description_232"	"Legendary SLTV Star Series is back with a new Global Tournament"
"league_name_233"	"League of Dota - 3ª Temporada"
"[english]league_name_233"	"League of Dota Season 3"
"league_description_233"	"A 3ª temporada da League of Dota está de volta num novo formato e um prémio total renovado! As equipas competem por 800$ durante um mês em torneios diários amadores para a América do Norte e Europa. Inclui a ward \"Clockwerk Watcher\"!"
"[english]league_description_233"	"Season 3 of League of Dota returns with a new format and revamped prize pool! Teams compete for $800 over the course of one month in daily amateur tournaments for North America and Europe. Includes the Clockwork Watcher Ward!"
"league_name_234"	"deafESL Dota2 League - 2ª Temporada"
"[english]league_name_234"	"deafESL Dota2 League Season 2"
"league_description_234"	"A deafESL apresenta a segunda temporada de um torneio dedicado à comunidade surda. Serão transmitidas partidas de duas divisões compostas de equipas do mundo inteiro."
"[english]league_description_234"	"The deafESL behind the second season in a tournament made â€‹â€‹for the deaf community, bringing games two divisions composed of teams from around the world."
"league_name_235"	"The Monster Invitational"
"[english]league_name_235"	"The Monster Invitational"
"league_description_235"	"Quatro das melhores equipas norte-americanas de Dota 2 competem em Austin, Texas, na SXSW por 15000$ e pelo título de \"Monster Invitational Champion\"."
"[english]league_description_235"	"Four of the top American Dota 2 teams fight it out live in Austin, TX at SXSW for $15,000 and the title of 'Monster Invitational Champion.'"
"league_name_236"	"Dota2.Ru Cup #2"
"[english]league_name_236"	"Dota2.Ru Cup #2"
"league_description_236"	"As melhores equipas da Europa de Leste competem entre si pelo prémio de 2000$!"
"[english]league_description_236"	"Best CIS Dota 2 teams will fight against each other for prize $2000!"
"league_name_238"	"Defense of the Australians Autumn Tournament"
"[english]league_name_238"	"Defense of the Australians Autumn Tournament"
"league_description_238"	"A Defense of the Australians está de volta para a temporada de outono, contando com eliminatórias abertas com 64 equipas da Austrália, onde competirão entre si até restarem 8 equipas! Estas equipas irão depois enfrentar as 8 melhores equipas do verão de 2014 pelo título de equipa n.º1 da Austrália. As finais terão lugar na Defense HQ, em Melbourne."
"[english]league_description_238"	"Defense brings you its autumn season with an open qualifiers of 64 teams around Australia competing against each other until only 8 teams remain, who will then battle against our top 8 teams of summer 2014 and crown Australiaâ€™s #1 team. Finals at Defense HQ in Melbourne."
"league_name_239"	"Ronin Dota 2 Tournament"
"[english]league_name_239"	"Ronin Dota 2 Tournament"
"league_description_239"	"Ronin Tournament - 1ª Temporada"
"[english]league_description_239"	"Ronin Tournament Season 1"
"league_name_240"	"FGCL: CIS Open Cup"
"[english]league_name_240"	"FGCL: CIS Open Cup"
"league_description_240"	"Um torneio aberto para equipas da Europa de Leste. Mais de 500 equipas vão lutar pelo título. Inclui o conjunto \"Sovereign of the Woodlands\"."
"[english]league_description_240"	"Open tournament among teams CIS. Over 500 teams will fight for the championship. Includes a unique set of Sovereign of the Woodlands"
"league_name_500"	"South Ural League eSports - 3ª Temporada"
"[english]league_name_500"	"South Ural League eSports Season 3"
"league_description_500"	"A terceira temporada da South Ural League consiste em 16 equipas na divisão profissional e 80 na divisão amadora. As finais em LAN terão lugar em Chelyabinsk."
"[english]league_description_500"	"The third season is the best non-professional teams of Central Russia. Online season and LAN finals in Chelyabinsk, a city-meteorite. 16 teams PRO division, 80 teams AM division. Sponsor of the tournament, GB. The most severe players, the team of the government of the region, a raffle during the bro"
"league_name_501"	"Pro Gaming Tours League March"
"[english]league_name_501"	"Pro Gaming Tours League March"
"league_description_501"	"O segundo torneio de 300$ da PGTL 2014 terá lugar em março e os playoffs contarão com 16 equipas (as 2 melhores do mês anterior e 14 equipas de eliminatórias)."
"[english]league_description_501"	"March the second $300 tournament for PGTL 2014. The playoffs are 16 teams, the top 2 teams from our previous month and 14 teams from qualifiers.  "
"league_name_502"	"Prodota Cup Spring"
"[english]league_name_502"	"Prodota Cup Spring"
"league_description_502"	"8 equipas profissionais e 8 apuradas através de eliminatórias competem por 1000$."
"[english]league_description_502"	"8 professional teams and 8 qualified teams compete for 1000$ prize"
"league_name_505"	"DotA2VO.Ru Ability Cup #1"
"[english]league_name_505"	"DotA2VO.Ru Ability Cup #1"
"league_description_505"	"32 equipas competem entre si por 16.000 rublos e pelo título de primeiros campeões do modo de Seleção de Habilidades!"
"[english]league_description_505"	"32 teams will compete with each other for 16 000 rubles+ and the title of first champions of Ability Draft Mode!"
"league_name_506"	"CZ-SK Dota 2 League"
"[english]league_name_506"	"CZ-SK Dota 2 League"
"league_description_506"	"A primeira liga checa/eslovaca que decorrerá durante seis meses. A equipa vencedora levará para casa um prémio em dinheiro!"
"[english]league_description_506"	"First Czech-Slovakia League will be played for 6 weeks for price money!"
"league_name_507"	"E-Sports Arena Cup"
"[english]league_name_507"	"E-Sports Arena Cup"
"league_name_510"	"FSL #2 - FemaleDotA2 SEA League - 2ª Temporada"
"[english]league_name_510"	"FSL #2 - FemaleDotA2 SEA League Season 2"
"league_name_512"	"MD2 Malaysia Brunei Cup - 1ª Temporada"
"[english]league_name_512"	"MD2 Malaysia Brunei Cup Season 1"
"league_name_513"	"WD Dota2 Pro Series"
"[english]league_name_513"	"WD Dota2 Pro Series"
"league_name_600"	"The International 2014"
"[english]league_name_600"	"The International 2014"
"league_description_600"	"The International 2014"
"[english]league_description_600"	"The International 2014"
"league_name_1002"	"CZ-SK Dota 2 League"
"[english]league_name_1002"	"CZ-SK Dota 2 League"
"league_name_1003"	"ExcellentMoscowCup"
"[english]league_name_1003"	"ExcellentMoscowCup"
"league_name_1004"	"Star Cloud League"
"[english]league_name_1004"	"Star Cloud League"
"league_description_1004"	"Dota 2 Amateur League"
"[english]league_description_1004"	"Dota 2 Amateur League"
"league_name_1005"	"Testleague"
"[english]league_name_1005"	"Testleague"
"league_description_1005"	"Testleague"
"[english]league_description_1005"	"Testleague"
"league_name_1008"	"0"
"[english]league_name_1008"	"0"
"league_name_1009"	"TryHard Cup"
"[english]league_name_1009"	"TryHard Cup"
"league_name_1015"	"UFES Dota 2 Cup - 4ª Temporada"
"[english]league_name_1015"	"UFES Dota2 Cup Season #4"
"league_name_1016"	"Astrological Sign Championship"
"[english]league_name_1016"	"Astrological sign championship"
"league_name_1018"	"PinoyDota Online Battle Season 2"
"[english]league_name_1018"	"PinoyDotA Online Battle Season 2"
"league_name_1022"	"PantheonES CUP"
"[english]league_name_1022"	"PantheonES CUP"
"league_name_1024"	"Claw Dota League"
"[english]league_name_1024"	"Claw Dota League"
"league_name_1026"	"Dota Trash Destruction"
"[english]league_name_1026"	"Dota Trash Destruction"
"league_name_1031"	"E-Sports Arena Cup"
"[english]league_name_1031"	"E-Sports Arena Cup"
"league_name_1036"	"asdfasdgasdgs"
"[english]league_name_1036"	"asdfasdgasdgs"
"league_description_1036"	"asdfasdfgasdags"
"[english]league_description_1036"	"asdfasdfgasdags"
"league_name_1042"	"FGCL Championship League - 2ª Temporada"
"[english]league_name_1042"	"FGCL Championship League Season 2"
"league_name_1045"	"ElPadrinoth Latin Cup "
"[english]league_name_1045"	"ElPadrinoth Latin Cup "
"league_name_1046"	"Gamersportperu - 4ª Temporada"
"[english]league_name_1046"	"Gamersportperu Season 4"
"league_name_1048"	"League of Polarity"
"[english]league_name_1048"	"League of polarity "
"league_name_1051"	"GameRing Dota 2 March Cup"
"[english]league_name_1051"	"GameRing Dota 2 March Cup"
"league_name_1056"	"YoDota League - 1ª Temporada"
"[english]league_name_1056"	"YoDota League Season 01"
"league_name_1060"	"Japan Dota2 League #1"
"[english]league_name_1060"	"Japan Dota2 League #1"
"league_name_1062"	"TTÜ eSports 2014 Spring"
"[english]league_name_1062"	"TTÜ eSports 2014 Spring"
"league_name_1064"	"Battle of the Cities"
"[english]league_name_1064"	"Battle of the Cities"
"league_name_1066"	"Macedonian Dota2 Cup #3"
"[english]league_name_1066"	"Macedonian Dota2 Cup #3"
"league_description_1066"	"Um torneio macedónio onde as melhores equipas do país competem por um prémio!"
"[english]league_description_1066"	"A Macedonian tournament where all the Macedonian teams compete for a prize!"
"league_name_1068"	"Dota 2 Champions League"
"[english]league_name_1068"	"Dota 2 Champions League"
"league_name_1069"	"Sweaty Cup 2"
"[english]league_name_1069"	"Sweaty Cup 2"
"league_name_1070"	"Golden Esports League Season 1"
"[english]league_name_1070"	"Golden Esports League Season 1"
"league_name_1072"	"Netolic Amateur League - 2ª Temporada"
"[english]league_name_1072"	"Netolic Amateur League - Season 2"
"league_name_1077"	"EVOEL - 1ª Temporada"
"[english]league_name_1077"	"EVOEL Season 1"
"league_name_1081"	"Nvidia DOTA2 Vietnam Tournament"
"[english]league_name_1081"	"Nvidia DOTA2 Vietnam Tournament"
"league_name_1082"	"AAULAN"
"[english]league_name_1082"	"AAULAN"
"league_description_1082"	"AAULAN"
"[english]league_description_1082"	"AAULAN"
"league_name_1084"	"Megalodon Cup - 2ª Temporada"
"[english]league_name_1084"	"Megalodon Cup Season 2"
"league_name_1085"	"WPL Champions League - 2ª Temporada"
"[english]league_name_1085"	"WPL Champions  League Season 2"
"league_name_1088"	"DotaTalk Open Cup"
"[english]league_name_1088"	"DotaTalk Open Cup"
"league_name_1092"	"Vanguard Series"
"[english]league_name_1092"	"Vanguard Series"
"league_name_1093"	"Learn 2 Play Australian Masters"
"[english]league_name_1093"	"Learn 2 Play Australian Masters"
"league_name_1094"	"Steelseries Malaysia Cup - March"
"[english]league_name_1094"	"Steelseries Malaysia Cup - March"
"league_description_1094"	"As oito melhores equipas da Malásia competem por periféricos da Steelseries no valor de $1000!"
"[english]league_description_1094"	"The top eight Malaysian teams will compete for gaming equipment from Steelseries worth $1,000!"
"league_name_1097"	"WVW全国电子竞技精英赛"
"[english]league_name_1097"	"WVW全国电子竞技精英赛"
"league_name_1099"	"WVW全国电子竞技职业联赛(WVW National E-Sports Professional League)"
"[english]league_name_1099"	"WVW全国电子竞技职业联赛(WVW National E-Sports Professional League)"
"league_name_1100"	"American Dota League - 2ª Temporada"
"[english]league_name_1100"	"American Dota League Season 2"
"league_name_1106"	"mainDOTA2 Champion Tournament"
"[english]league_name_1106"	"mainDOTA2 Champion Tournament"
"league_name_1108"	"ESL's Brazil Rei da Mesa"
"[english]league_name_1108"	"ESL's Brazil Rei da Mesa"
"league_name_1110"	"tavyyy"
"[english]league_name_1110"	"tavyyy"
"league_description_1110"	"tare"
"[english]league_description_1110"	"tare"
"league_name_1116"	"Esports Champion League"
"[english]league_name_1116"	"Esports Champion League"
"league_name_1117"	"POT Spain League"
"[english]league_name_1117"	"POT Spain League"
"league_name_1118"	"Techlabs CUP Moscow 2014"
"[english]league_name_1118"	"Techlabs CUP Moscow 2014"
"league_name_1119"	"SDL 2014 - 2ª Temporada"
"[english]league_name_1119"	"SDL 2014 Season 2"
"league_name_1121"	"The Inaugural"
"[english]league_name_1121"	"The Inaugural"
"league_name_1122"	"Digital Wars Online - 2ª Temporada"
"[english]league_name_1122"	"Digital Wars Online - Season #2"
"league_name_1124"	"The Inaugural"
"[english]league_name_1124"	"The Inaugural"
"league_name_1127"	"Fragbite Masters 2014"
"[english]league_name_1127"	"Fragbite Masters 2014"
"league_name_1129"	"Copa Argentina"
"[english]league_name_1129"	"Copa Argentina"
"league_name_1134"	"Arts of War Open"
"[english]league_name_1134"	"Arts of War Open"
"league_name_1135"	"D2L Western Challenge"
"[english]league_name_1135"	"D2L Western Challenge"
"league_name_1157"	"The Summit"
"[english]league_name_1157"	"The Summit"
"league_name_1177"	"Corsair Asia Cup"
"[english]league_name_1177"	"Corsair Asia Cup"
"league_name_1178"	"POT Spain League 2"
"[english]league_name_1178"	"POT Spain League 2"
"league_name_1183"	"SteelSeries ID DX Dota 2 Tournament"
"[english]league_name_1183"	"SteelSeries ID DX Dota 2 Tournament"
"league_name_1189"	"AEGIS Gaming League"
"[english]league_name_1189"	"AEGIS Gaming League"
"league_name_1191"	"Logitech G Challenge"
"[english]league_name_1191"	"Logitech G Challenge"
"league_name_1192"	"Steelseries Oceania Cup - 3ª Temporada"
"[english]league_name_1192"	"Steelseries Oceania Cup - Season 3"
"league_name_1194"	"League of Dota Season 4 Europe"
"[english]league_name_1194"	"League of Dota Season 4 Europe"
"league_description_1194"	"A League of Dota está de volta com uma 4ª temporada para equipas europeias amadoras! As equipas competem em 10 torneios ao longo de um mês pelo prémio total de $400."
"[english]league_description_1194"	"League of Dota returns with a fourth season for amateur European teams! Teams compete in 10 tournaments over one month for a total prize pool of $400. "
"league_name_1205"	"Gamersportperu - 5ª Temporada"
"[english]league_name_1205"	"Gamersportperu Season 5"
"league_name_1206"	"Gamersportperu - 5ª Temporada"
"[english]league_name_1206"	"Gamersportperu Season 5"
"league_name_1207"	"Gamersportperu - 5ª Temporada"
"[english]league_name_1207"	"Gamersportperu Season 5"
"league_name_1209"	"Vicara Gaming Open"
"[english]league_name_1209"	"Vicara Gaming Open"
"league_name_1211"	"Pro Gaming Tours League April"
"[english]league_name_1211"	"Pro Gaming Tours League April"
"league_name_1229"	"DotaTalk Datbet Championship"
"[english]league_name_1229"	"DotaTalk Datbet Championship"
"league_name_1230"	"Steelseries Malaysia Cup April"
"[english]league_name_1230"	"Steelseries Malaysia Cup April"
"league_name_1234"	"Star Cloud League - 2ª Temporada"
"[english]league_name_1234"	"Star Cloud League - Season II"
"league_name_1237"	"Dota4You Cup - 2ª Temporada"
"[english]league_name_1237"	"Dota4You Cup Season 2"
"league_name_1240"	"Dota2.fr League - 5ª Temporada"
"[english]league_name_1240"	"Dota2.fr League Season 5"
"league_description_1240"	"As melhores equipas francesas competem todas as semanas na principal liga francesa."
"[english]league_description_1240"	"The best french teams compete every week in the major french League"
"league_name_1242"	"KDL - 2ª Temporada"
"[english]league_name_1242"	"KDL Season 2"
"league_name_1243"	"Defense Of The Arabians"
"[english]league_name_1243"	"Defense Of The Arabians"
"league_name_1244"	"Bounty Hunter Series"
"[english]league_name_1244"	"Bounty Hunter Series"
"league_name_1245"	"SuL"
"[english]league_name_1245"	"SuL"
"league_description_1245"	"A Steelseries uuu9 League (SuL) conta com a participação de equipas apuradas através de eliminatórias ou convidadas diretamente. As equipas que ganharem as eliminatórias receberão periféricos. Todas as equipas profissionais chinesas serão convidadas. O prémio total base é de 17.000 renmimbis e todas as receitas obtidas com a venda dos bilhetes serão adicionadas ao prémio total."
"[english]league_description_1245"	"There are two ways to join Sreelseries uuu9 League1(Sul) ：trials and invitation,the teams who win the trials will get gaming peripherals.All the Chinese Professional team will be invited.The total prize money is 17,000RMB base,and the 100% of the Sul ticket sales earnings will fund the prize pool."
"league_name_1248"	"ESL One Frankfurt 2014"
"[english]league_name_1248"	"ESL One Frankfurt 2014"
"league_name_1253"	"NACDEC"
"[english]league_name_1253"	"NACDEC"
"league_name_1258"	"Spanish DOTA2 Pro Series"
"[english]league_name_1258"	"Spanish DOTA2 Pro Series"
"league_name_1262"	"NADotA Elite League - 3ª Temporada"
"[english]league_name_1262"	"NADotA Elite League Season 3"
"league_description_1262"	"As equipas mais talentosas da América do Norte competem no formato de liga clássico interno."
"[english]league_description_1262"	"The most talented players in North America compete in the classic inhouse league format."
"league_name_1264"	"MSI Beat IT GosuCup Asia"
"[english]league_name_1264"	"MSI Beat IT GosuCup Asia"
"league_name_1284"	"讯拓CDEC全年联赛"
"[english]league_name_1284"	"讯拓CDEC全年联赛"
"league_name_1301"	"Good Play SEA Invitational"
"[english]league_name_1301"	"Good Play SEA Invitational"
"league_name_1311"	"FGCL Fight Club: Promote Season"
"[english]league_name_1311"	"FGCL Fight Club: Promote Season"
"league_name_1314"	"RAMPAGE D2 LEAGUE"
"[english]league_name_1314"	"RAMPAGE D2 LEAGUE"
"league_name_1325"	"Dota2Qc"
"[english]league_name_1325"	"Dota2Qc"
"league_name_1337"	"Federal League"
"[english]league_name_1337"	"Federal League"
"league_name_1341"	"UFES Dota 2 Cup - 5ª Temporada"
"[english]league_name_1341"	"UFES Dota2 Cup Season #5"
"league_description_1341"	"Até 64 equipas sul-americanas competem por um grande prémio!"
"[english]league_description_1341"	"Up to 64 South American teams compete for grand prize!"
"league_name_1348"	"UK Dota 2 Challenge"
"[english]league_name_1348"	"UK Dota 2 Challenge"
"league_name_1350"	"MSI Beat IT 2014"
"[english]league_name_1350"	"MSI Beat IT 2014"
"league_name_1352"	"Cabeca Dota 2 League"
"[english]league_name_1352"	"Cabeca Dota 2 League"
"league_name_1357"	"Samsung DOTA2 Pro League"
"[english]league_name_1357"	"Samsung DOTA2 Pro League"
"league_name_1358"	"YoDota Championship - 2ª Temporada"
"[english]league_name_1358"	"YoDota Championship Season 2"
"league_name_1361"	"Battle of Central Europe"
"[english]league_name_1361"	"Battle of Central Europe"
"league_name_1362"	"Techlabs Cup 2014 Season 2 Minsk"
"[english]league_name_1362"	"Techlabs CUP 2014 Season 2 Minsk"
"league_name_1366"	"PowerPlay Philippine Dota 2 Invitational"
"[english]league_name_1366"	"PowerPlay Philippine Dota 2 Invitational"
"league_name_1376"	"National eSports League"
"[english]league_name_1376"	"National eSports League"
"league_description_1376"	"32 equipas vão competir por mais de $500"
"[english]league_description_1376"	"32 teams will compete for 500+$"
"league_name_1378"	"fastDOTA Solo Ranked"
"[english]league_name_1378"	"fastDOTA Solo Ranked"
"league_name_1382"	"Liga Livedota chile "
"[english]league_name_1382"	"Liga Livedota chile "
"league_name_1384"	"Logitech G - Free2Play #3"
"[english]league_name_1384"	"Logitech G - Free2Play #3"
"league_name_1391"	"MSi Masters"
"[english]league_name_1391"	"MSi Masters"
"league_description_1391"	"A ESAU MSi Masters é um torneio profissional que conta com os jogadores mais talentosos da Austrália. No fim, 8 equipas competirão pelo título e $3000."
"[english]league_description_1391"	"The ESAU MSi Masters is a professional tournament compiling Australia's most talented players. Eight final teams will compete for the title and $3,000."
"league_name_1400"	"Vietnam eSports Champions League 2014"
"[english]league_name_1400"	"Vietnam eSports Champions League 2014"
"league_name_1407"	"GEST Challenge"
"[english]league_name_1407"	"GEST Challenge"
"league_name_1415"	"DOTA 2 Cebu League"
"[english]league_name_1415"	"DOTA 2 Cebu League"
"league_name_1418"	"MARSTV DOTA ELITE INVITATIONAL"
"[english]league_name_1418"	"MARSTV DOTA ELITE INVITATIONAL"
"league_description_1418"	"As equipas que ficarem em 1º e 2º lugar nas eliminatórias chinesas do The International irão enfrentar 4 equipas convidadas em Huaxi, na China."
"[english]league_description_1418"	"The first and second places from CN Qualifer for the International will face up four invited Chinese top teams in Huaxi, the top village in China."
"league_name_1423"	"MSI Beat It RGN League"
"[english]league_name_1423"	"MSI Beat It RGN League"
"league_name_1432"	"GEST SEA"
"[english]league_name_1432"	"GEST SEA"
"league_name_1441"	"PAGE Premier League"
"[english]league_name_1441"	"PAGE Premier League"
"league_name_1445"	"Dota Legends"
"[english]league_name_1445"	"Dota Legends"
"league_description_1445"	"Dota Legends by AD2L"
"[english]league_description_1445"	"Dota Legends by AD2L"
"league_name_1465"	"Torneos Dota Latino - 2ª Temporada"
"[english]league_name_1465"	"Torneos Dota Latino Season II"
"league_name_1475"	"GEMplay Challenge - 1ª Temporada"
"[english]league_name_1475"	"GEMplay Challenge Season 1"
"league_name_1478"	"BoraDota STARS"
"[english]league_name_1478"	"BoraDota STARS"
"league_description_1478"	"Primeira temporada da BoraDota STARS com as melhores equipas da América do Sul."
"[english]league_description_1478"	"First Cup BoraDota STARS with the best teams in South America."
"league_name_1489"	"Spanish Dota 2 Pro Series Finals"
"[english]league_name_1489"	"Spanish Dota 2 Pro Series Finals"
"league_name_1490"	"Techno Int DX Dota 2 Tournament"
"[english]league_name_1490"	"Techno Int DX Dota 2 Tournament"
"league_name_1493"	"Dota 2 Canada Cup - 3ª Temporada"
"[english]league_name_1493"	"Dota 2 Canada Cup Season 3"
"league_name_1508"	"Balkan Floods Charity Cup"
"[english]league_name_1508"	"Balkan Floods Charity Cup"
"league_description_1508"	"Angariação de fundos para a Croácia, Sérvia e Bósnia, países que foram atingidos por grandes cheias."
"[english]league_description_1508"	"Raising money for Croatia, Serbia and Bosnia, countries that got hit by heavy floods."
"league_name_1511"	"RAZER GATE DOTA 2 Champions League #1"
"[english]league_name_1511"	"RAZER GATE DOTA 2 Champions League #1"
"league_name_1522"	"Super Battle of the Cities"
"[english]league_name_1522"	"Super Battle of the Cities"
"league_name_1523"	"2014NEST全国电子竞技大赛"
"[english]league_name_1523"	"2014NEST全国电子竞技大赛"
"league_description_1523"	"2014NEST全国电子竞技大赛由国家体育总局体育信息中心主办"
"[english]league_description_1523"	"2014NEST全国电子竞技大赛由国家体育总局体育信息中心主办"
"league_name_1524"	"MVP Phoenix Exhibition Match"
"[english]league_name_1524"	"MVP Phoenix Exhibition Match"
"league_name_1566"	"BenQ SEA Go4Dota2 Cups"
"[english]league_name_1566"	"BenQ SEA Go4Dota2 Cups"
"league_description_1566"	"Equipas de Dota 2 terão a oportunidade de ganhar $750 todos os meses. As partidas do Go4Dota2 serão semanais realizadas aos domingos."
"[english]league_description_1566"	"Dota 2 teams will get the chance to win as much as $750 every month. Go4Dota2 weekly cups occur every Sunday."
"league_name_1577"	"Stella Сhamp - 2ª Temporada"
"[english]league_name_1577"	"Stella Сhamp Season 2"
"league_description_1577"	"Equipas amadoras da Europa de Leste vão competir por 1600 grívnias."
"[english]league_description_1577"	"Аматорские команды из стран СНГ сразятся за 1600 гривен"
"league_name_1579"	"D2LPR - 1ª Temporada"
"[english]league_name_1579"	"D2LPR Season 1"
"league_name_1587"	"CEVO - 5ª Temporada"
"[english]league_name_1587"	"CEVO Season 5"
"league_name_1592"	"Gamersportperu - 6ª Temporada"
"[english]league_name_1592"	"Gamersportperu Season 6"
"league_name_1608"	"Balkan Challenger"
"[english]league_name_1608"	"Balkan Challenger"
"league_name_1633"	"Team Fight League"
"[english]league_name_1633"	"Team Fight League"
"league_name_1635"	"Serbian Weekly Dota Cup - 2ª Temporada"
"[english]league_name_1635"	"Serbian Weekly Dota Cup | Season 2"
"league_name_1637"	"UCL-Moscow Cup"
"[english]league_name_1637"	"UCL-Moscow Cup"
"league_description_1637"	"Um torneio de Dota 2 para estudantes universitários de Moscovo."
"[english]league_description_1637"	"Чемпионат по дисциплине Dota2 среди студентов московских ВУЗов."
"league_name_1640"	"joinDOTA League #3"
"[english]league_name_1640"	"joinDOTA League #3"
"league_name_1643"	"Battle Arena Tournament"
"[english]league_name_1643"	"Battle Arena Tournament"
"league_description_1643"	"Um torneio de Dota 2 espanhol."
"[english]league_description_1643"	"Torneo dota 2 Español"
"league_name_1648"	"Flag League"
"[english]league_name_1648"	"Flag League"
"league_name_1651"	"Step Up Dota 2 Tournament"
"[english]league_name_1651"	"Step Up Dota 2 Tournament"
"league_name_1654"	"SDL 2014 - 3ª Temporada"
"[english]league_name_1654"	"SDL 2014 Season Three"
"league_description_1657"	"A 3ª série do DX Indonesia Dota 2 Tournament. O torneio consiste em 16 grandes equipas da Indonésia a competir por um prémio total de $1000."
"[english]league_description_1657"	"The third series of DX Indonesia Dota 2 Tournament. The tournament consists of 16 top teams in Indonesia and will compete for $1000 prize pool. "
"league_name_1658"	"Inter-Cafe Championship - Powered by Logitech G"
"[english]league_name_1658"	"Inter-Cafe Championship - Powered by Logitech G"
"league_name_1662"	"World eSports Championship Games"
"[english]league_name_1662"	"World eSports Championship Games"
"league_name_1663"	"World E-sport Championship（WEC）"
"[english]league_name_1663"	"World E-sport Championship（WEC）"
"league_name_1667"	"NADota Elite League August"
"[english]league_name_1667"	"NADotA Elite League August"
"league_description_1667"	"Os jogadores mais talentosos dos EUA competem no formato de liga clássico durante 4 semanas."
"[english]league_description_1667"	"The most talented players in North America compete in the classic inhouse league format for four weeks."
"league_name_1669"	"KDL - 3ª Temporada"
"[english]league_name_1669"	"KDL Season 3"
"league_name_1671"	"battle4arcana"
"[english]league_name_1671"	"battle4arcana"
"league_description_1671"	"A Battle4Arcana é um torneio de Dota 2 online onde os jogadores competem por itens do jogo no valor de 200$."
"[english]league_description_1671"	"Battle4Arcana is an online d2 Tournament where winners get in game items worth 200$ as prize pool "
"league_name_1672"	"Indonesia Game Show 2014 Dota 2 Tournament"
"[english]league_name_1672"	"Indonesia Game Show 2014 Dota 2 Tournament"
"league_name_1673"	"Osetia Open Cup - 1ª Temporada"
"[english]league_name_1673"	"Osetia Open Cup - Season 1"
"league_description_1673"	"Um torneio aberto de Dota 2 para jogadores da Ossétia."
"[english]league_description_1673"	"Открытый чемпионат Осетии по игре Dota 2"
"league_name_1674"	"DOTA Regions"
"[english]league_name_1674"	"DOTA Regions"
"league_name_1683"	"The Prime DX Dota 2 Master Tournament"
"[english]league_name_1683"	"The Prime DX Dota 2 Master Tournament"
"league_description_1683"	"A 3ª série do DX Indonesia Dota 2 Tournament. O torneio consiste em 16 grandes equipas da Indonésia a competir por um prémio total de $1000."
"[english]league_description_1683"	"The third series of DX Indonesia Dota 2 Tournament. The tournament consists of 16 top teams in Indonesia and will compete for $1000 prize pool. "
"league_name_1684"	"Crashgame 2"
"[english]league_name_1684"	"Crashgame 2"
"league_name_1693"	"Top Europe Challenge"
"[english]league_name_1693"	"Top Europe Challenge"
"league_name_1698"	"Indonesian Amateur League"
"[english]league_name_1698"	"Indonesian Amateur League"
"league_description_1698"	"Esta liga conta com 20 equipas da Indonésia a competir pelo prémio total de 1,5 milhões de rupias indonésias."
"[english]league_description_1698"	"This league consists of 20 teams from indonesia competing for IDR 1.5 Million Prizepool"
"league_name_1699"	"CSPL: Dota 2 Pro League "
"[english]league_name_1699"	"CSPL: Dota 2 Pro League "
"league_name_1701"	"GEMplay Challenge - 2ª Temporada"
"[english]league_name_1701"	"GEMplay Challenge Season 2"
"league_name_1702"	"SCL New Star Tournament"
"[english]league_name_1702"	"SCL New Star Tournament"
"league_name_1706"	"Persian Gulf Cup"
"[english]league_name_1706"	"Persian Gulf Cup"
"league_name_1708"	"CZ-SK Dota 2 League - 2ª Temporada"
"[english]league_name_1708"	"CZ-SK Dota 2 League Season 2"
"league_name_1709"	"i League"
"[english]league_name_1709"	"i League"
"league_name_1712"	"DotA 2 Champions League - 4ª Temporada"
"[english]league_name_1712"	"DotA 2 Champions League Season 4"
"league_name_1713"	"1ª Copa OnArt"
"[english]league_name_1713"	"1ª Copa OnArt"
"league_name_1714"	"Запорожский летний турнир"
"[english]league_name_1714"	"Запорожский летний турнир"
"league_description_1714"	"Запорожский турнир #1"
"[english]league_description_1714"	"Запорожский турнир #1"
"league_name_1735"	"ElPadrinoth American Cup"
"[english]league_name_1735"	"ElPadrinoth American Cup"
"league_name_1741"	"Megalodon Starters League #1"
"[english]league_name_1741"	"Megalodon Starters League #1"
"league_name_1742"	"TP Anatolian Cup"
"[english]league_name_1742"	"TP Anatolian Cup"
"league_name_1748"	"ASUS ROG Insomnia52 Dota 2 Cup"
"[english]league_name_1748"	"ASUS ROG Insomnia52 Dota 2 Cup"
"league_name_1751"	"VPGAME菠赛"
"[english]league_name_1751"	"VPGAME菠赛"
"league_description_1751"	"VP菠赛是VPGAME携手DOTA2博彩吧举行的娱乐联赛，旨在促进VP和贴吧的交流，丰富玩家的DOTA2生活，在轻松娱乐的赛制中体验DOTA2的魅力。"
"[english]league_description_1751"	"VP菠赛是VPGAME携手DOTA2博彩吧举行的娱乐联赛，旨在促进VP和贴吧的交流，丰富玩家的DOTA2生活，在轻松娱乐的赛制中体验DOTA2的魅力。"
"league_name_1754"	"Golden Esports League - 2ª Temporada"
"[english]league_name_1754"	"Golden Esports League Season 2"
"league_name_1755"	"Golden Esports League - 2ª Temporada"
"[english]league_name_1755"	"Golden Esports League Season 2"
"league_name_1757"	"Battle of Central Europe - 2ª Temporada"
"[english]league_name_1757"	"Battle of Central Europe Season 2"
"league_name_1761"	"Excellent Moscow Cup - 2ª Temporada"
"[english]league_name_1761"	"Excellent Moscow Cup Season 2"
"league_name_1764"	"Rise of the Myrmidons"
"[english]league_name_1764"	"Rise of the Myrmidons"
"league_name_1776"	"Tactic Hive League - 1ª Temporada"
"[english]league_name_1776"	"Tactic Hive League Season 1"
"league_name_1800"	"NADota Elite League September"
"[english]league_name_1800"	"NADotA Elite League September"
"league_description_1800"	"Os jogadores mais talentosos dos EUA competem no formato de liga clássico durante 4 semanas."
"[english]league_description_1800"	"The most talented players in North America compete in the classic inhouse league format for four weeks."
"league_name_1802"	"GG DotA2 Latin League"
"[english]league_name_1802"	"GG DotA2 Latin League"
"league_name_1803"	"SLTV Star Series - 10ª Temporada"
"[english]league_name_1803"	"SLTV Star Series Season 10"
"league_name_1814"	"Gladius Dota 2"
"[english]league_name_1814"	"Gladius Dota 2"
"league_name_1829"	"Battle of America"
"[english]league_name_1829"	"Battle of America"
"league_name_1834"	"Battle Hall Dota 2 - 1ª Temporada"
"[english]league_name_1834"	"Battle Hall Dota 2 Season One"
"league_description_1834"	"Um torneio amador russo."
"[english]league_description_1834"	"Российский non-pro турнир"
"league_name_1839"	"MSI SEA Dragon Battle"
"[english]league_name_1839"	"MSI SEA Dragon Battle"
"league_name_1843"	"Crashgame League"
"[english]league_name_1843"	"Crashgame League"
"league_name_1854"	"Full Metal Dota - 1ª Temporada"
"[english]league_name_1854"	"Full Metal Dota season 1"
"league_name_1869"	"第五届新浪超新星刀塔公开赛"
"[english]league_name_1869"	"第五届新浪超新星刀塔公开赛"
"league_description_1869"	"超新星杯的传统仍是新生队伍通过资格赛来获得与中国的顶尖战队较量的机会，总奖金为10万人民币。"
"[english]league_description_1869"	"超新星杯的传统仍是新生队伍通过资格赛来获得与中国的顶尖战队较量的机会，总奖金为10万人民币。"
"league_name_1875"	"European Elite League September"
"[english]league_name_1875"	"European Elite League September"
"league_description_1875"	"Os jogadores mais talentosos da Europa competem no formato de liga clássico durante 4 semanas."
"[english]league_description_1875"	"The most talented players in Europe compete in the classic inhouse league format for four weeks."
"league_name_1886"	"ESL One New York"
"[english]league_name_1886"	"ESL One New York"
"league_name_1887"	"Game Show Dota 2 League"
"[english]league_name_1887"	"Game Show Dota 2 League"
"league_description_1887"	"De 11 a 13 de setembro, 6 equipas europeias competem pelo prémio total de 50000$. O torneio será transmitido em 6 idiomas. As partidas da final serão jogadas na DreamHack Moscow."
"[english]league_description_1887"	"On 11-13 September six European teams will compete for the prize pool of $50,000. The tournament will be casted in six languages. Final matches will be played at DreamHack Moscow."
"league_name_1892"	"SLTV Pro Series - 10ª Temporada"
"[english]league_name_1892"	"SLTV Pro Series Season 10"
"league_name_1905"	"TP Anatolian Cup"
"[english]league_name_1905"	"TP Anatolian Cup"
"league_name_1907"	"上海dota2冠军之杯"
"[english]league_name_1907"	"上海dota2冠军之杯"
"league_description_1907"	"上海玩家携手为期2个月IH比赛，旨在促进上海玩家的交流，丰富玩家的DOTA2生活，在轻松娱乐的赛制中体验DOTA2的魅力。"
"[english]league_description_1907"	"上海玩家携手为期2个月IH比赛，旨在促进上海玩家的交流，丰富玩家的DOTA2生活，在轻松娱乐的赛制中体验DOTA2的魅力。"
"league_name_1913"	"OGSeries DotA2 Online #1"
"[english]league_name_1913"	"OGSeries DotA2 Online #1"
"league_name_1921"	"Geo DOTA 2 - 1ª Temporada"
"[english]league_name_1921"	"Geo DOTA 2 Season 1"
"league_description_1921"	"16 equipas vão competir pelo título de campeões na primeira temporada do GEO DOTA."
"[english]league_description_1921"	"за право чемпионствa GEO DOTA SEASON 1 сразятся 16 команд"
"league_name_1925"	"Yard Red Festival"
"[english]league_name_1925"	"Yard Red Festival"
"league_name_1933"	"2014 Telkom Gaming Championships"
"[english]league_name_1933"	"2014 Telkom Gaming Championships"
"league_name_1934"	"SynergyLeague - 1ª Temporada"
"[english]league_name_1934"	"SynergyLeague Season 1"
"league_name_1936"	"The Summit 2"
"[english]league_name_1936"	"The Summit 2"
"league_name_1937"	"URUDota Cup - 1ª Temporada"
"[english]league_name_1937"	"URUDota Cup Season 1"
"league_name_1939"	"Circuito LVP Dota 2"
"[english]league_name_1939"	"Circuito LVP Dota 2"
"league_name_1942"	"Dota Pit League - 2ª Temporada"
"[english]league_name_1942"	"Dota Pit League Season Two"
"league_name_1950"	"NVIDIA Game24 Invitational"
"[english]league_name_1950"	"NVIDIA Game24 Invitational"
"league_name_1969"	"GG Latin League"
"[english]league_name_1969"	"GG Latin League"
"league_name_1970"	"League of Dota - 6ª Temporada"
"[english]league_name_1970"	"League of Dota Season 6"
"league_name_1974"	"THEPRIME Dota 2 Tournament - 1ª Temporada"
"[english]league_name_1974"	"THEPRIME Dota 2 Tournament Season I"
"league_name_1978"	"Barganizer Online Tournament - 2ª Temporada"
"[english]league_name_1978"	"Barganizer Online Tournament Season 2"
"league_description_1978"	"96 equipas irão competir para se tornarem na melhor equipa na Indonésia com um prémio total de 1200$"
"[english]league_description_1978"	"96 teams will compete to become the Top Team in Indonesia with total prize $1200"
"league_name_1980"	"joinDOTA League #4"
"[english]league_name_1980"	"joinDOTA League #4"
"league_name_1986"	"DotA2VO Ability Cup #2"
"[english]league_name_1986"	"DotA2VO Ability Cup #2"
"league_name_1990"	"Murmansk CUP"
"[english]league_name_1990"	"Murmansk CUP"
"league_description_1990"	"As melhores equipas russas de Oblast de Murmansk vão competir por 300 itens raros."
"[english]league_description_1990"	"Лучшие команды Мурманской области будут сражаться за 300 предметов качества \"Rare\""
"league_name_1993"	"Copa Black Fyre - 1ª Temporada"
"[english]league_name_1993"	"Copa Black Fyre - Season One"
"league_name_2000"	"DotA2VO Ability Cup #2"
"[english]league_name_2000"	"DotA2VO Ability Cup #2"
"league_name_2001"	"Macedonian Dota 2 Cup #5"
"[english]league_name_2001"	"Macedonian Dota 2 Cup #5"
"league_description_2001"	"Equipas macedónias competem por um prémio na quinta temporada da Macedonian Cup!"
"[english]league_description_2001"	"Macedonian teams compete for a prize in the five season of the Macedonian Cup!"
"league_name_2008"	"Cyber Gaming Indonesia Competition - 2ª Temporada"
"[english]league_name_2008"	"Cyber Gaming Indonesia Competition Season 2"
"league_description_2008"	"Cyber Gaming Indonesia Competition - 2ª Temporada"
"[english]league_description_2008"	"Cyber Gaming Indonesia Competition Season 2"
"league_name_2009"	"OGSeries DotA2 Online - 2ª Temporada"
"[english]league_name_2009"	"OGSeries DotA2 Online Season2"
"league_description_2009"	"Jogadores espanhóis lutam para conseguir 250€ em prémios."
"[english]league_description_2009"	"Jugadores españoles luchan por conseguir 250€ en premios."
"league_name_2017"	"TEvent Dota 2 - 1ª Temporada"
"[english]league_name_2017"	"TEvent Dota 2 Season 1"
"league_name_2019"	"GG League - 2ª Temporada"
"[english]league_name_2019"	"GG League Season 2"
"league_name_2020"	"Gigabyte Windforce Dota2 Cup"
"[english]league_name_2020"	"Gigabyte Windforce Dota2 Cup"
"league_name_2025"	"SIBERIA Dota 2 Cup"
"[english]league_name_2025"	"SIBERIA Dota 2 Cup"
"league_description_2025"	"Equipas amadoras do Extremo Oriente Russo vão competir por um prémio de 32.500 rublos."
"[english]league_description_2025"	"Любтельские команды Дальнего Востока сразятся за приз в 32500 рублей"
"league_name_2028"	"GrossuCup - 2ª Temporada"
"[english]league_name_2028"	"GrossuCup Season 2"
"league_name_2032"	"G-League 2014S1"
"[english]league_name_2032"	"G-League 2014S1"
"league_description_2032"	"G-League 2014"
"[english]league_description_2032"	"G-League 2014"
"league_name_2039"	"ArtCyber - 1ª Temporada"
"[english]league_name_2039"	"ArtCyber Season #1"
"league_description_2039"	"O ArtCyber é um torneio da Europa de Leste com um prémio total de 4500 rublos."
"[english]league_description_2039"	"ArtCyber это СНГ турнир с призовым фондом 4500 рублей"
"league_name_2040"	"AD2L - 5ª Temporada"
"[english]league_name_2040"	"AD2L Season 5"
"league_description_2040"	"A 5ª temporada da Amateur Dota 2 League."
"[english]league_description_2040"	"Season 5 of the Amateur Dota 2 League"
"league_name_2043"	"Watch 4 Dota Tournament - 2ª Temporada"
"[english]league_name_2043"	"Watch 4 Dota Tournament Season 2"
"league_description_2043"	"Equipas semiprofissionais e profissionais da Rússia competem pelo prémio principal deste torneio."
"[english]league_description_2043"	"Полупрофессиональные и профессиональные команды со всей России сразятся за главный приз турнира."
"league_name_2044"	"DOTA Regions - 2ª Temporada"
"[english]league_name_2044"	"DOTA Regions : Season 2"
"league_name_2045"	"World Cyber Arena"
"[english]league_name_2045"	"World Cyber Arena"
"league_description_2045"	"Evento do Dota 2"
"[english]league_description_2045"	"Dota2 event"
"league_description_2046"	"Torneio de Dota 2 para os jogadores indianos. Patrocinado pela BenQ, Cooler Master e pela Kingston Technology com um prémio total de 25000 INR + Hardware."
"[english]league_description_2046"	"Dota 2 Tournament for Indian Gamers. Sponsored by BenQ, Cooler Master & Kingston Technology with 25000 INR Cash + Hardware Prizes."
"league_name_2051"	"SLTV Pro Series - 10ª Temporada"
"[english]league_name_2051"	"SLTV Pro Series Season X"
"league_name_2056"	"GDL - 4ª Temporada"
"[english]league_name_2056"	"GDL Season IV"
"league_description_2056"	"Um torneio destinado às equipas mais fortes da Rússia, que conta com um prémio total de 3000$. O bilhete permite assistir a partidas das duas divisões (amadora e profissional). As finais em LAN da divisão profissional terão lugar em Cheliabinsk"
"[english]league_description_2056"	"Турнир ориентирован на сильнейшие Российские команды. Призовой фонд 3000$. Два дивизиона AM и PRO доступны в билете. LAN-финал PRO дивизиона состоится в Челябинске в середи"
"league_name_2057"	"KDL - 4ª Temporada"
"[english]league_name_2057"	"KDL Season 4"
"league_name_2058"	"WECG Korea National Final"
"[english]league_name_2058"	"WECG Korea National Final"
"league_name_2062"	"Montenegro National League - 2ª Temporada"
"[english]league_name_2062"	"Montenegro National League Season 2"
"league_description_2062"	"Mais uma temporada da Montenegro National League está a aproximar-se, com um prémio total maior e melhor. Quem serão os novos campeões montenegrinos do Dota 2?"
"[english]league_description_2062"	"Another season of Montenegro National League is coming with bigger and better prize pool. Who will become new masters of Montenegrin Dota 2 scene?"
"league_name_2067"	"Arabian Dota League"
"[english]league_name_2067"	"Arabian Dota League"
"league_description_2067"	"A primeira liga online do Médio Oriente com 10.000 dirames em dinheiro para serem ganhos!"
"[english]league_description_2067"	"The first online League for the Middle East with 10,000 dirhams in cash to be won!"
"league_name_2076"	"DeadlyGaming Cup - 1ª Temporada"
"[english]league_name_2076"	"DeadlyGaming Cup Season 1"
"league_description_2076"	"DeadlyGaming Cup - Um torneio onde 12 equipas profissionais convidadas competem por um prémio de 5000$."
"[english]league_description_2076"	"DeadlyGaming Cup - это турнир где 12 приглашенных стар и про команд сразятся за приз в 5000$"
"league_name_2077"	"Copa chile 2 EXPOGEEK"
"[english]league_name_2077"	"Copa chile 2 EXPOGEEK"
"league_description_2077"	"O maior torneio do Chile com as melhores equipas do país, que irão competir por mais de 1300$ em prémios. As finais em LAN terão lugar na EXPOGEEK Valparaíso."
"[english]league_description_2077"	"El torneo mas grande de chile con los mejores equipos de este pais los cuales se disputaran  mas de 1300usd  en premios.. Tendrá finales  LAN en EXPOGEEK valparaiso"
"league_name_2079"	"The 6th e-Sports World Championship Baku 2014"
"[english]league_name_2079"	"The 6th e-Sports World Championship Baku 2014"
"league_name_2084"	"Defense of the Australians Spring 2014"
"[english]league_name_2084"	"Defense of the Australians Spring 2014"
"league_name_2086"	"Dota-LAN Winter 2015"
"[english]league_name_2086"	"Dota-LAN Winter 2015"
"league_name_2091"	"CSPL.RU Dota 2 League - 2ª Temporada"
"[english]league_name_2091"	"CSPL.RU Dota 2 League Season 2"
"league_description_2091"	"A segunda temporada de uma longa batalha onde mais de 500 participantes vão competir por um prémio e pelo título de campeões!"
"[english]league_description_2091"	"Второй сезон продолжительной битвы, в которой более 500 участников сразятся за приз и титул чемпиона!"
"league_name_2094"	"SDL 2014 - 4ª Temporada"
"[english]league_name_2094"	"SDL 2014 Season Four"
"league_description_2094"	"64 equipas profissionais competem pelo prémio e a glória na última temporada do SDL 2014."
"[english]league_description_2094"	"64 professional teams fighting for the prize and glory at the last season of SDL 2014"
"league_name_2095"	"Exp Dota Cup - 2ª Temporada"
"[english]league_name_2095"	"Exp Dota Cup Season 2"
"league_description_2095"	"16 equipas lutam por 5000 rublos."
"[english]league_description_2095"	"16 team fighting for 5000 rublies"
"league_name_2096"	"HyperX D2L - 5ª Temporada"
"[english]league_name_2096"	"HyperX D2L Season 5"
"league_name_2101"	"Exp solo cup - 2ª Temporada"
"[english]league_name_2101"	"Exp solo cup season 2"
"league_description_2101"	"32 jogadores competirão por um prémio de 1600 rublos."
"[english]league_description_2101"	"32 players will compete in the middle for a prize of 1600 rubles"
"league_name_2105"	"The Battle Fury 2014"
"[english]league_name_2105"	"The Battle Fury 2014"
"league_description_2105"	"Nos dias 15 e 16 de novembro, Lima será o centro das atenções de toda a América Latina, 16 das melhores equipas competirão para chegar à glória e aos 5000$ em prémios. O pack inclui a HUD e LS oficiais."
"[english]league_description_2105"	"El 15 y 16 de Noviembre Lima será el centro de atención de toda latinoamerica, 16 de los mejores equipos competirán por llegar a la gloria y los 5000 Dólares en premios. el pack incluye HUD y LS oficial."
"league_name_2109"	"The 6th e-Sports World Championship Baku 2014"
"[english]league_name_2109"	"The 6th e-Sports World Championship Baku 2014"
"league_name_2112"	"VAKE FEMALE TOURNAMENT"
"[english]league_name_2112"	"VAKE FEMALE TOURNAMENT"
"league_description_2112"	"Torneio Profissional Feminino"
"[english]league_description_2112"	"Professional women's tournament"
"league_name_2114"	"Cyberviews 1x1 Cup"
"[english]league_name_2114"	"Cyberviews 1x1 Cup"
"league_description_2114"	"Jogadores amadores da Europa de Leste vão competir num torneio 1x1 por um prémio de 1000 rublos."
"[english]league_description_2114"	"Игроки любители из СНГ будут сражаться в турнире 1х1 за приз 1000 руб."
"league_name_2119"	"DOTA 2 Secondary Pro League"
"[english]league_name_2119"	"DOTA 2 Secondary Pro League"
"league_description_2119"	"Um torneio organizado por Perfect World em colaboração com MarsTV, que conta com equipas amadoras chinesas a jogar em eliminatórias nacionais para que possam avançar para a final em LAN, onde competirão no formato \"round robin\"."
"[english]league_description_2119"	"Dota 2 Secondary Pro League is organized by Perfect World with the cooperation with MarsTV. The tournament will have top Chinese amateur teams through national qualifiers, who will advance to LAN final to compete in a round robin format before becoming tomorrow stars in Dota scene."
"league_name_2125"	"Battle of Central Europe"
"[english]league_name_2125"	"Battle of Central Europe"
"league_description_2125"	"As 16 melhores equipas da Europa irão competir por um prémio total de 30.000$ e decidirão qual é a melhor! Um evento com a duração de 2 semanas, com mais de 100 partidas."
"[english]league_description_2125"	"16 best teams in Europe compete for the $30.000 prize pool and decide who is the best! Over 2 weeks, more then 100 games"
"league_name_2126"	"Battle of America"
"[english]league_name_2126"	"Battle of America"
"league_description_2126"	"64 equipas registadas irão competir na ronda qualificatória para chegarem ao evento principal e lutar contra as 8 equipas convidadas para conseguir um prémio total de 5000$. Durante 2 semanas, mais de 100 jogos."
"[english]league_description_2126"	"64 registered teams will compete at qualifying round to get into the main event and fight with 8 invited teams to get the total $5000 prize pool. Over 2 weeks, more than 100 matches."
"league_name_2129"	"Dota Pit League - 3ª Temporada"
"[english]league_name_2129"	"Dota Pit League Season Three"
"league_name_2133"	"OGSeries DotA2 Online - 3ª Temporada"
"[english]league_name_2133"	"OGSeries DotA2 Online Season3"
"league_description_2133"	"Os melhores jogadores espanhóis lutam para conseguir 250€ em prémios."
"[english]league_description_2133"	"Los mejores jugadores españoles luchan por conseguir 250€ en premios."
"league_name_2134"	"CEVO - 6ª Temporada"
"[english]league_name_2134"	"CEVO Season 6"
"league_description_2134"	"Um evento profissional e amador norte-americano onde todos competem numa temporada de 8 semanas, seguida de playoffs, por 1000$ mais os lucros das vendas do pacote e a chance de avançar para divisões mais sérias em temporadas futuras."
"[english]league_description_2134"	"CEVO Season 6 is a North American Pro-Am event where teams compete in an 8-week regular season, followed by Playoffs for over $1,000 + bundle sales and the chance to advance to higher skill divisions in future seasons."
"league_name_2139"	"Dota2.Net Cup #1"
"[english]league_name_2139"	"Dota2.Net Cup #1"
"league_description_2139"	"Um novo torneio de Dota 2 que será um desafio para a maioria das equipas semiprofissionais da Comunidade dos Estados Independentes. As melhores equipas da Ucrânia, Rússia, Cazaquistão e Bielorrússia irão competir por um prémio de 15.000 rublos."
"[english]league_description_2139"	"Новый Dota 2 турнир, который станет вызовом для большиснтва semi-pro команд из СНГ. Лучшие коллективы из России, Украины, Казахстана и Беларуси сразятся за приз в 15,000 рубл"
"league_name_2140"	"DotaCinema Presents the XMG Captains Draft 2.0"
"[english]league_name_2140"	"DotaCinema Presents the XMG Captains Draft 2.0"
"league_description_2140"	"Em breve"
"[english]league_description_2140"	"Coming Soon"
"league_name_2142"	"Dota 2 Gonzaga Festival"
"[english]league_name_2142"	"Dota 2 Gonzaga Festival"
"league_name_2145"	"#2K14dotaprincess"
"[english]league_name_2145"	"#2K14dotaprincess"
"league_description_2145"	"melhor de sempre"
"[english]league_description_2145"	"best ever"
"league_name_2156"	"NorthCapital League"
"[english]league_name_2156"	"NorthCapital League"
"league_description_2156"	"Torneio de Dota 2 com um prémio total de 4000$."
"[english]league_description_2156"	"Турнир по Дота2 с призовым фондом 4 000$. "
"league_name_2158"	"SLTV Star Series - 11ª Temporada"
"[english]league_name_2158"	"SLTV Star Series Season 11"
"league_description_2158"	"A 11ª temporada da SLTV StarSeries! As melhores equipas do mundo, os melhores estúdios do mundo e muitos jogos inesquecíveis!"
"[english]league_description_2158"	"Season 11 of SLTV own StarSeries! Best teams in the world, best studios in the world and a lot of unfogettable matches!"
"league_name_2159"	"DotA2VO Seasons: Nature's Call"
"[english]league_name_2159"	"DotA2VO Seasons: Nature's Call"
"league_name_2166"	"iCG-DOTA2 Fall 2014"
"[english]league_name_2166"	"iCG-DOTA2 Fall 2014"
"league_name_2167"	"Game Masters MOL Dota2 Championship"
"[english]league_name_2167"	"Game Masters MOL Dota2 Championship"
"league_name_2171"	"SLTV Pro Series - 11ª Temporada"
"[english]league_name_2171"	"SLTV Pro Series Season 11"
"league_name_2172"	"Esportal Dota 2 League"
"[english]league_name_2172"	"Esportal Dota 2 League"
"league_name_2176"	"Compêndio - PC Bang"
"[english]league_name_2176"	"PC Bang Compendium"
"league_name_2178"	"i League - 2ª Temporada"
"[english]league_name_2178"	"i League Season 2"
"league_description_2179"	"O maior torneio de Dota 2 da Índia, \"GameGod Games Arena\", patrocinado pela MTS e organizado pela NODWIN Gaming irá decorrer de 14 a 16 de novembro. O prémio total do evento principal é de 16000$ e será dividido entre as 64 melhores equipas, com a equipa campeã a receber o maior prémio, de 5000$."
"[english]league_description_2179"	"India's largest DOTA 2 Tournament  \"GameGod Games Arena\" powered by MTS and organized by NODWIN Gaming will be held from 14th to 16th Nov, 2014. The total prize pool for the main event is USD $16,000 split between top 64 teams in cash prize with the Champion winning USD $5000 as first place prize."
"league_name_2184"	"Dota 2 Female Tournament"
"[english]league_name_2184"	"Dota 2 Female Tournament"
"league_name_2190"	"ASUS ROG DreamLeague - 2ª Temporada"
"[english]league_name_2190"	"ASUS ROG DreamLeague Season 2"
"league_name_2196"	"Nether eSports by Razer - 1ª Temporada"
"[english]league_name_2196"	"Nether eSports Season 1 by Razer"
"league_name_2206"	"Hitbox Obutto Dota2 Championship"
"[english]league_name_2206"	"Hitbox Obutto Dota2 Championship"
"league_name_2215"	"ok.- DOTA 2 @ GG 2014"
"[english]league_name_2215"	"ok.- DOTA 2 @ GG 2014"
"league_name_2227"	"Dota 2 Cup in Lipetsk - 2ª Temporada"
"[english]league_name_2227"	"Dota 2 Cup in Lipetsk Season 2"
"league_description_2227"	"Um torneio de Dota 2 em LAN em Lipetsk com um prémio total de mais de 10.000 rublos."
"[english]league_description_2227"	"Dota 2 Lan Cup in Lipetsk с призовым фондом более 10000 рублей"
"league_name_2231"	"Virtute League - 1ª Temporada"
"[english]league_name_2231"	"Virtute League Season 1"
"league_description_2231"	"Equipas competem pelo prémio total de 100$!"
"[english]league_description_2231"	"Команды сражаются за призовой фонд 100+ долларов США!"
"league_name_2232"	"Dota 2 Solo League by Phazy - 1ª Temporada"
"[english]league_name_2232"	"Dota 2 Solo League by Phazy: Season 1 "
"league_description_2232"	"16 jogadores irão competir por um prémio em dinheiro."
"[english]league_description_2232"	"16 players will compete for a cash prize"
"league_name_2234"	"Torneos Dota Latino"
"[english]league_name_2234"	"Torneos Dota Latino"
"league_name_2238"	"Militant Cup: 1ª Temporada"
"[english]league_name_2238"	"Militant Cup: Season 1"
"league_description_2238"	"A primeira temporada da Militant Cup onde 32 equipas da CEI irão competir por um prémio em dinheiro!"
"[english]league_description_2238"	"The first season of Militant Cup series. 32 teams from CIS will compete each other. The winner will receive prize money upon victory!"
"league_name_2239"	"ShowMatch Coliseo"
"[english]league_name_2239"	"ShowMatch Coliseo"
"league_name_2301"	"Professional Dota 2 League of Turkey"
"[english]league_name_2301"	"Professional Dota 2 league of Turkey"
"league_name_2307"	"UGC Dota 2 League - 3ª Temporada"
"[english]league_name_2307"	"UGC Dota 2 League Season 3"
"league_description_2307"	"A UGC League é uma liga comunitária que atualmente organiza eventos competitivos do Dota 2 e do TF2."
"[english]league_description_2307"	"The UGC League in a community league currently running Dota 2 and TF2 Skill based competitions"
"league_name_2326"	"Aspen's Cup - 1ª Temporada"
"[english]league_name_2326"	"Aspen's Cup Season 1"
"league_description_2326"	"16 equipas irão competir por um prémio em dinheiro."
"[english]league_description_2326"	"16 team will compete for a prize money"
"league_name_2331"	"64QuartersCup - 1ª Temporada"
"[english]league_name_2331"	"64QuartersCup Season 1"
"league_description_2331"	"64 equipas irão competir pelo prémio total de 10000 rublos na primeira temporada de 64QuartersCup."
"[english]league_description_2331"	"64 teams will compete for the prize pool of 10,000 rubles in first season 64QuartersCup."
"league_name_2332"	"DotA2VO Seasons: Nature's Call"
"[english]league_name_2332"	"DotA2VO Seasons: Nature's Call"
"league_name_2337"	"MLG and joinDOTA 2015"
"[english]league_name_2337"	"MLG and joinDOTA 2015"
"league_name_2339"	"Dota 2 Asia Championship 2015"
"[english]league_name_2339"	"Dota 2 Asia Championship 2015"
"league_description_2339"	"16 equipas de topo competem por uma grande honra."
"[english]league_description_2339"	"16 top teams compete for grand honor."
"league_name_2343"	"UnderCastleLeague - 1ª Temporada"
"[english]league_name_2343"	"UnderCastleLeague Season 1"
"league_name_2357"	"Myth League"
"[english]league_name_2357"	"Myth League"
"league_name_2358"	"D2CL - 5ª Temporada"
"[english]league_name_2358"	"D2CL Season 5"
"league_name_2360"	"ProDota League - 3ª Temporada"
"[english]league_name_2360"	"ProDota League season 3"
"league_name_2364"	"Ecuador Vip Game Cup"
"[english]league_name_2364"	"Ecuador Vip Game Cup"
"league_name_2377"	"Dota 2 Canada Cup - 4ª Temporada"
"[english]league_name_2377"	"Dota 2 Canada Cup Season 4"
"league_description_2377"	"O Dota 2 Canada Cup está de volta, com algumas das melhores equipas da América do Norte e do Sul."
"[english]league_description_2377"	"The Dota 2 Canada Cup is back! Featuring some of the finest teams from North and South America. "
"league_name_2379"	"SngLadder - 1ª Temporada"
"[english]league_name_2379"	"SngLadder Season One"
"league_description_2379"	"Centenas de jogadores irão lutar na SngLadder pela vitória e por prémios valiosos."
"[english]league_description_2379"	"Сотни игроков будут сражаться за право победить на SngLadder и выиграть ценные призы."
"league_name_2380"	"SngLadder - 1ª Temporada"
"[english]league_name_2380"	"SngLadder Season One"
"league_description_2380"	"Centenas de jogadores irão lutar na SngLadder pela vitória e por prémios valiosos."
"[english]league_description_2380"	"Сотни игроков будут сражаться за право победить на SngLadder и выиграть ценные призы."
"league_name_2381"	"D2LP - 4ª Temporada"
"[english]league_name_2381"	"D2LP Season 4"
"league_description_2381"	"32 equipas irão competir pelo título de campeão e pelo prémio."
"[english]league_description_2381"	"32 teams will compete for the championship title and the prize "
"league_name_2384"	"Donbass Cup 3"
"[english]league_name_2384"	"Donbass Cup 3"
"league_name_2388"	"Bridon League Open Cup"
"[english]league_name_2388"	"Bridon League Open Cup"
"league_description_2388"	"4 equipas de uma eliminatória vão competir com convidados por um prémio de 500.000 rublos."
"[english]league_description_2388"	"4 teams from qualification will compete with guest stars for a prize of 500,000 RUB"
"league_name_2392"	"MLG World Finals 2015"
"[english]league_name_2392"	"MLG World Finals 2015"
"league_description_2392"	"Finais da MLG em Nova Orleães, Los Angeles"
"[english]league_description_2392"	"MLG World Finals in New Orleans, LA"
"league_name_2396"	"Clash of Pubs"
"[english]league_name_2396"	"Clash of Pubs"
"league_description_2396"	"Uma liga para os jogadores casuais mostrarem o seu espírito competitivo."
"[english]league_description_2396"	"A league for the causal pubers to show their competitive spirit. "
"league_name_2400"	"Living Gaming Competition - 1ª Temporada"
"[english]league_name_2400"	"Living Gaming Competition Season 1"
"league_description_2400"	"A 1ª temporada da Living Gaming Competition com um prémio total superior a 500$."
"[english]league_description_2400"	"Living Gaming Competition Season 1 with more than $500 Prize Pool"
"league_name_2401"	"64Quarters Fast Cup "
"[english]league_name_2401"	"64Quarters Fast Cup "
"league_description_2401"	"Equipas amadoras de Dota 2 vão competir em 5 torneios rápidos por um prémio em dinheiro."
"[english]league_description_2401"	"Amateur Dota 2 teams will compete in 5 fast cups by 64Quarters Cups for the cash prize."
"league_name_2403"	"CrashGame Pro League"
"[english]league_name_2403"	"CrashGame Pro League"
"league_name_2406"	"Forward to Victory"
"[english]league_name_2406"	"Forward to victory"
"league_name_2410"	"DossierChannel Classic Tournament - 3ª Temporada"
"[english]league_name_2410"	"DossierChannel Classic Tournament Season 3"
"league_description_2410"	"O DossierChannel apresenta um torneio clássico tailandês patrocinado por melonbox.com."
"[english]league_description_2410"	"DossierChannel Present Classic Tournament, Only Pick Hero on your side. Classic Team in Thailand Sponsor by melonbox.com"
"league_name_2412"	"Boredgamer.co.uk Dota2 One Night One Cup"
"[english]league_name_2412"	"Boredgamer.co.uk Dota2 One Night One Cup"
"league_description_2412"	"One Day EU West Dota 2 Tournament "
"[english]league_description_2412"	"One Day EU West Dota 2 Tournament "
"league_name_2418"	"SLTV Star Series - 12ª Temporada"
"[english]league_name_2418"	"SLTV Star Series Season 12"
"league_description_2418"	"As melhores equipas de todo o mundo competem por um lugar nas Finais em LAN."
"[english]league_description_2418"	"Top teams from all over the world are competing for a place at LAN Finals."
"league_name_2422"	"The Summit 3"
"[english]league_name_2422"	"The Summit 3 "
"league_name_2431"	"Aivix Tournament"
"[english]league_name_2431"	"Aivix Tournament"
"league_description_2431"	"Os melhores jogadores da Europa de Leste e da Rússia irão competir for um prémio total de 1500 rublos!"
"[english]league_description_2431"	"The best players of the CIS and Russia will compete for a prize in 1500P!"
"league_name_2437"	"The Trilogy of Eternal League"
"[english]league_name_2437"	"The Trilogy of Eternal League"
"league_name_2438"	"The Trilogy of Eternal League"
"[english]league_name_2438"	"The Trilogy of Eternal League"
"league_description_2439"	"24 equipas amadoras irão competir pelo prémio total."
"[english]league_description_2439"	"24 Аматорские команды сразятся за призовой фонд"
"league_name_2440"	"Possible Heroes Cup - 2ª Temporada"
"[english]league_name_2440"	"Possible Heroes Cup Season 2"
"league_description_2440"	"16 equipas profissionais irão competir por um prémio total de 500 dólares na segunda temporada do torneio Possible Heroes."
"[english]league_description_2440"	"16 professional teams will compete for a prize pool of 500 Dollars in the second season of the tournament Possible Heroes"
"league_name_2445"	"Relic Dota2MK #Episode 1"
"[english]league_name_2445"	"Relic Dota2MK #Episode 1"
"league_description_2460"	"As equipas convidadas irão competir pelo prémio total de 10000 rublos!"
"[english]league_description_2460"	"Приглашенные команды сразятся за приз в размере 10.000 рублей!"
"league_name_2465"	"ASUS Clash of the Titans Dota 2 Tournament - Série 1"
"[english]league_name_2465"	"ASUS Clash of the Titans Dota 2 Tournament - Series 1"
"league_name_2468"	"Alienware Area 51 Dota Cup"
"[english]league_name_2468"	"Alienware Area 51 Dota Cup"
"league_name_2477"	"TEvent Dota 2 - 2ª Temporada"
"[english]league_name_2477"	"TEvent Dota 2 Season 2"
"league_name_2478"	"BuzzCraft Dota 2 League #2"
"[english]league_name_2478"	"BuzzCraft Dota 2 League #2"
"league_description_2478"	"Equipas semiprofissionais irão competir entre si na arena do Dota 2. O prémio total é de 30.000 rublos."
"[english]league_description_2478"	"Semiprofessional teams will compete with each other in the arena Dota 2. The prize fund of 30,000 rubles."
"league_name_2485"	"South American Elite League - Fevereiro"
"[english]league_name_2485"	"South American Elite League February"
"league_description_2485"	"Os jogadores mais talentosos da América do Sul competem no formato de liga clássico interno."
"[english]league_description_2485"	"The most talented players in South America compete in the classic inhouse league format."
"league_description_2488"	"O CyberMotion Tournament 1x1 é o torneio em que o jogador joga contra outro jogador."
"[english]league_description_2488"	"The CyberMotion Tournament 1x1 is the tournament where the player plays against another player."
"league_description_2493"	"É um torneio para jogadores colombianos e para promover o Dota 2 competitivo na Colômbia."
"[english]league_description_2493"	"Es un torneo para gamers colombianos y para ayudar a que el Dota competitivo en Colombia se empiece a mover."
"league_name_2500"	"Bandung Next Gaming - 1ª Temporada"
"[english]league_name_2500"	"Bandung Next Gaming Season 1"
"league_name_2501"	"Cup of Heroes 3"
"[english]league_name_2501"	"Cup of Heroes 3"
"league_name_2510"	"SA Challenge"
"[english]league_name_2510"	"SA Challenge"
"league_description_2510"	"As melhores equipas da América do Sul irão competir pelo título de campeões da América do Sul e por 1000$."
"[english]league_description_2510"	"the best Teams of South america compete to be the SA champions and win USD 1000"
"league_description_2511"	"Um torneio aberto a equipas do sudeste asiático, com uma fase eliminatória que leva à final em LAN na Malásia com equipas orientais e ocidentais. A final será em Kuala Lumpur em março de 2015, onde 8 desafiantes competirão pelo prémio inicial de 100000$."
"[english]league_description_2511"	"The Major Allstars tournament by Fallout Gaming will be open for SEA squads, with extensive qualifiers leading to the LAN finals in Malaysia with both eastern and western teams. The finals will take place in Kuala Lumpur in March 2015, with eight challengers battling for the initial $100k prizepool"
"league_name_2517"	"joinDOTA League #5"
"[english]league_name_2517"	"joinDOTA League #5"
"league_description_2517"	"A liga de Dota 2 global para toda a gente. Inclui a maioria das partidas da 2ª divisão semiprofissional e algumas partidas das divisões amadoras."
"[english]league_description_2517"	"The global Dota 2 league for everyone. This includes most matches from the semi-pro division 2 and some matches from the amateur divisions."
"league_name_2523"	"Zonda Cup"
"[english]league_name_2523"	"Zonda Cup"
"league_name_2535"	"CI Cyber League: Second Cup"
"[english]league_name_2535"	"CI Cyber League: Second Cup"
"league_description_2535"	"32 equipas amadoras competem pelo prémio."
"[english]league_description_2535"	"32 amateur teams compete for the prize"
"league_description_2543"	"32 equipas lutam por 100$."
"[english]league_description_2543"	"32 team battle for 100$"
"league_name_2550"	"Tomsk Dota 2 - Champion Solo Mid 1x1"
"[english]league_name_2550"	"Tomsk Dota 2 - Champion Solo Mid 1x1"
"league_description_2550"	"Jogadores da Sibéria irão lutar pelo prémio total de mais de 1000 rublos e pelo título de melhor jogador no torneio."
"[english]league_description_2550"	"Игроки из Сибири будут бороться за приз в размере 1000+ рублей и звание лучшего игрока в турнире.   Players from the Siberia will fight for the prize of 1000+ rubles and the title of the best player in the tournament."
"league_name_2555"	"Razer Think Fast - 2ª Temporada"
"[english]league_name_2555"	"Razer Think Fast Season 2"
"league_name_2575"	"Solo Mid Battle by Terrikon"
"[english]league_name_2575"	"Solo Mid Battle by Terrikon"
"league_description_2575"	"Jogadores da Europa de Leste competem por itens raros."
"[english]league_description_2575"	"Players from CIS will fight for the RAR."
"league_name_2576"	"Faringame League - 1ª Temporada"
"[english]league_name_2576"	"Faringame League Season 1"
"league_description_2576"	"As melhores equipas do Extremo Oriental Russo irão competir por um prémio total de 50.000 rublos!"
"[english]league_description_2576"	"Best russian Far East teams compete for a 50000 rubles prize pool!"
"league_name_2578"	"ProDotA 2 National Cup"
"[english]league_name_2578"	"ProDotA 2 National Cup"
"league_description_2578"	"Jogadores profissionais de DotA lideram equipas nacionais para descobrir quem é a nação mais forte de DotA 2 e reclamar o prémio!"
"[english]league_description_2578"	"Professional DotA players leading national teams to find out which nation is the strongest in DotA 2 and claim the prize pool!"
"league_name_2582"	"F&J - 1ª Temporada"
"[english]league_name_2582"	"F&J Season 1"
"league_name_2584"	"Uprise Champions Cup - 2ª Temporada"
"[english]league_name_2584"	"Uprise Champions Cup Season 2"
"league_name_2589"	"The Prime Major Tournament"
"[english]league_name_2589"	"The Prime Major Tournament"
"league_description_2589"	"Seis equipas convidadas do Sudeste Asiático e duas equipas do qualificador indonésio irão competir por um prémio total 1500$ no The Prime Major Tournament. Este torneio será alojado pelo The Prime, organizado pela Id-PrimeGames e apoiado pelo eClub."
"[english]league_description_2589"	"Six South East Asia invited teams and two teams from Indonesia qualifier will compete for $1500 cash prize in The Prime Major Tournament. This tournament hosted by The Prime, organized by Id-PrimeGames, and supported by eClub"
"league_name_2597"	"Retos Dota GG - TDL"
"[english]league_name_2597"	"Retos Dota GG - TDL"
"league_name_2598"	"CZ-SK Dota 2 League - 4ª Temporada"
"[english]league_name_2598"	"CZ-SK Dota 2 League Season 4"
"league_name_2607"	"The Pirate League"
"[english]league_name_2607"	"The Pirate League"
"league_name_2608"	"GG League - 3ª Temporada"
"[english]league_name_2608"	"GG League Season 3"
"league_description_2608"	"Grandes equipas vindas da América do Norte, Europa e China irão competir por um prémio total de pelo menos 150.000$ e um convite para as finais em LAN."
"[english]league_description_2608"	"Top teams from NA, EU and China will fight for prize poll of at least $150.000 and invitation at LAN-Finals"
"league_name_2613"	"PGC Winter league"
"[english]league_name_2613"	"PGC Winter league"
"league_name_2619"	"Dota 2 Professional League"
"[english]league_name_2619"	"Dota 2 professional League"
"league_name_2620"	"MYM Prime Defending"
"[english]league_name_2620"	"MYM Prime Defending"
"league_name_2637"	"RoXe Tournament - 2ª Temporada"
"[english]league_name_2637"	"RoXe Tournament Season 2"
"league_name_2638"	"64Quarters Cup - 2ª Temporada"
"[english]league_name_2638"	"64Quarters Cup Season 2"
"league_description_2638"	"32 equipas competem pelo prémio total de 150.000 rublos na 2ª temporada da 64Quarters Cup."
"[english]league_description_2638"	"32 teams will compete for the prize pool 150.000 rubels in second season 64Quarters Cup."
"league_name_2643"	"Golden eSports League - 3ª Temporada"
"[english]league_name_2643"	"Golden eSports League Season 3"
"league_description_2643"	"Assiste a oito das melhores equipas nórdicas a competirem numa temporada de três meses por um prémio total de 30.000 SEK e produtos da Plantronics e da Razer. As finais em LAN terão lugar a 18 de abril em Sundsvall, Suécia."
"[english]league_description_2643"	"Watch eight of the top Nordic teams compete in a three-month long season for a 30,000 SEK prize pool and merchandise from Plantronics and Razer. The LAN finals will be held on the 18th of April in Sundsvall, Sweden."
"league_name_2661"	"The Summit 3"
"[english]league_name_2661"	"The Summit 3 "
"league_description_2661"	"Mantendo o espírito das edições anteriores, o The Summit 3 será outra experiência íntima e descontraída com as melhores equipas de todo o mundo a enfrentar-se no estúdio da Beyond the Summit em Los Angeles."
"[english]league_description_2661"	"Continuing the the spirit of previous iterations, The Summit 3 will be another laid-back, intimate experience with the best teams from across the globe duking it out in the Beyond the Summit studio in Los Angeles"
"league_name_2669"	"SGPL Dota 2 Cup - 1ª Temporada"
"[english]league_name_2669"	"SGPL Dota 2 Cup Season 1"
"league_description_2671"	"Um torneio que durará 3 meses e contará com a participação de equipas de topo."
"[english]league_description_2671"	"3 month long cup with high skilled teams"
"league_name_2672"	"PinkFae Dota 2 League: 2015 Female 1v1 Tournament"
"[english]league_name_2672"	"PinkFae Dota 2 League: 2015 Female 1v1 Tournament"
"league_description_2672"	"Uma liga para as melhores jogadoras femininas se destacarem na cena profissional e se juntarem a outras jogadoras e equipas femininas."
"[english]league_description_2672"	"A league for the top female gamers to break out into the professional scene and network with other female gamers and teams."
"league_name_2673"	"Dota 2 Canada Cup - 5ª Temporada"
"[english]league_name_2673"	"Dota 2 Canada Cup Season 5"
"league_description_2673"	"O Dota 2 Canada Cup está de volta, com algumas das melhores equipas da América do Norte e do Sul."
"[english]league_description_2673"	"The Dota 2 Canada Cup is back! Featuring some of the finest teams from North and South America. "
"league_name_2686"	"ESL One Frankfurt 2015"
"[english]league_name_2686"	"ESL One Frankfurt 2015"
"league_description_2686"	"Um Estádio. Dota 2 no seu estado mais puro."
"[english]league_description_2686"	"One Stadium. Pure Dota 2."
"league_name_2693"	"Mineski Pro-Gaming League - 7ª Temporada"
"[english]league_name_2693"	"Mineski Pro-Gaming League Season 7"
"league_description_2693"	"A Mineski-Events Team tem o orgulho de apresentar a 7ª temporada da Mineski Pro-Gaming League. Assiste a partidas intensas de Dota 2 enquanto equipas de todas as Filipinas competem pelo título de melhor equipa do país e por uma parte do prémio no valor de pelo menos 840.000 pesos filipinos."
"[english]league_description_2693"	"Mineski-Events Team proudly presents the 7th season of the Mineski Pro-Gaming League. Witness intense Dota 2 action as teams from all over the Philippines battle for the right to be named as the best in the country and a share from the initial prize pool of PHP 840,000 (USD 19,000)."
"league_name_2697"	"Hitbox European Championship"
"[english]league_name_2697"	"Hitbox European Championship"
"league_name_2716"	"Battle of The Legends"
"[english]league_name_2716"	"Battle of The Legends"
"league_description_2716"	"As melhores equipas no Médio Oriente chegam ao Que Club Dubai para jogarem por 25.000 AED."
"[english]league_description_2716"	"Top teams in the Middle East arrive at Que Club Dubai to play for 25,000 AED"
"league_description_2725"	"As melhores equipas da Rússia e dos países da CEI irão competir por uma enorme ovação e um prémio total de 3.000$."
"[english]league_description_2725"	"The best teams in Russia and CIS countries will compete for a standing ovation and a prize pool of $ 3k"
"league_name_2733"	"The International 2015"
"[english]league_name_2733"	"The International 2015"
"league_description_2733"	"The International 2015"
"[english]league_description_2733"	"The International 2015"
"league_name_2734"	"North American Solo Mid 1v1"
"[english]league_name_2734"	"North American Solo Mid 1v1"
"league_description_2734"	"Todas as semanas, 64 jogadores irão enfrentar-se por um prémio total de 30$. O vencedor de cada semana será colocado num grupo de um torneio de derradeiros duelos 1v1 que conta com um prémio total cada vez maior. Reserva já o teu lugar e vê se tens o que é preciso para seres o número um! Inscreve-te em northamericansolo.com"
"[english]league_description_2734"	"every week 64 players will go head to head for a 30$ prize pool. the winner of each week will be put into a bracket for the 1v1 ultimate show down that will consest of an expanding prize pool. lock your place in now and see if you have what it takes to be number one sign up at northamericansolo.com "
"league_name_2743"	"AEL March 2015"
"[english]league_name_2743"	"AEL March 2015"
"league_description_2743"	"Os jogadores mais talentosos da Ásia competem no formato de liga clássico interno."
"[english]league_description_2743"	"The most talented players in Asia compete in the classic inhouse league format."
"league_name_2744"	"TDL HUARAZ CUP 2015"
"[english]league_name_2744"	"TDL HUARAZ CUP 2015"
"league_name_2747"	"Dota 2 Canada Cup - 6ª Temporada"
"[english]league_name_2747"	"Dota 2 Canada Cup Season 6"
"league_description_2747"	"O Dota 2 Canada Cup está de volta, com algumas das melhores equipas da América do Norte e do Sul."
"[english]league_description_2747"	"The Dota 2 Canada Cup is back! Featuring some of the finest teams from North and South America. "
"league_name_2757"	"NN Dota 2 League - 3ª Temporada"
"[english]league_name_2757"	"NN Dota 2 League Season 3"
"league_name_2760"	"Quaswexort Championship Series 2015"
"[english]league_name_2760"	"Quaswexort Championship Series 2015"
"league_name_2763"	"GEST SEA CUP"
"[english]league_name_2763"	"GEST SEA CUP"
"league_description_2763"	"16 das melhores equipas do Sudeste Asiático irão lutar para ser a melhor equipa da sua região e por um prémio total de 3000$. Organizado pela Mineski e patrocinado pela GIGABYTE. Este torneio será comentado pela Beyond The Summit."
"[english]league_description_2763"	"16 of South East Asia Best Team battle it out to be the best team in SEA and total prize pool worth of 3,000USD. Organized by Mineski and sponsored by GIGABYTE. This tournament will be casted by Beyond The Summit"
"league_name_2770"	"MPGL SEA - 7ª Temporada"
"[english]league_name_2770"	"MPGL SEA Season 7"
"league_description_2770"	"Mineski Pro Gaming League apresenta a sua sétima temporada! As melhores equipas de vários países no Sudeste Asiático irão voar para a Malásia para participar na grande final em LAN em maio de 2015 por um prémio total de 50.000$."
"[english]league_description_2770"	"Mineski Pro Gaming League presents its seven season! Best teams from various countries in Southeast Asia will fly to Malaysia to participate in the Lan Grand finals in May 2015 for a total prize pool 50,000USD"
"league_name_2784"	"Big Prime Dota 2 Tournament"
"[english]league_name_2784"	"Big Prime Dota 2 Tournament"
"league_description_2784"	"Equipas da Indonésia irão lutar pelo prémio total de 15.000.000 IDR no formato de eliminatória simples. O Big Prime Tournament é patrocinado por 36bol Gaming."
"[english]league_description_2784"	"Indonesian team will fight for total IDR 15.000.000 prize pool in single elimination format. Big Prime Tournament is sponsored by 36bol Gaming"
"league_name_2788"	"Low Skill Cup - 1ª Temporada"
"[english]league_name_2788"	"Low Skill Cup Season 1"
"league_name_2790"	"ASUS ROG DreamLeague - 3ª Temporada"
"[english]league_name_2790"	"ASUS ROG DreamLeague Season 3"
"league_description_2791"	"16 equipas da Europa e da Rússia competem por um prémio de 100$."
"[english]league_description_2791"	"16 teams from Europe and Russia fight for a 100$ prize pool"
"league_name_2793"	"AD2L - 7ª Temporada"
"[english]league_name_2793"	"AD2L Season 7"
"league_description_2793"	"AD2L"
"[english]league_description_2793"	"AD2L"
"league_name_2810"	"CyberSpace DOTA2 Spring Cup 2015"
"[english]league_name_2810"	"CyberSpace DOTA2 Spring Cup 2015"
"league_name_2811"	"DotA2 UNITRY Tournament March 2015"
"[english]league_name_2811"	"DotA2 UNITRY Tournament March 2015"
"league_name_2812"	"Anzac Dota"
"[english]league_name_2812"	"Anzac Dota"
"league_description_2812"	"New Zealand's Online Anzac Weekend Dota 2 Tournament"
"[english]league_description_2812"	"New Zealand's Online Anzac Weekend Dota 2 Tournament"
"league_name_2815"	"i League - 3ª Temporada"
"[english]league_name_2815"	"i League Season 3"
"league_name_2816"	"Copa Black Fyre - 2ª Temporada"
"[english]league_name_2816"	"Copa Black Fyre - Season Two"
"league_name_2821"	"XMA - SP1 2015"
"[english]league_name_2821"	"XMA - SP1 2015"
"league_name_2823"	"Romanian Dota Pro League"
"[english]league_name_2823"	"Romanian Dota Pro League"
"league_description_2823"	"A Romanian Dota Pro League é a primeira liga profissional de Dota 2 organizada por Dota2Romania.com em colaboração com TwitchTV. As melhores equipas do país irão competir pela supremacia do campeonato e um prémio de 1500$ em dinheiro!"
"[english]league_description_2823"	"Romanian Dota Pro League is the first professional Dota 2 League organized by Dota2Romania.com in colaboration with TwitchTV. The best teams in the country will compete for the championship supremacy and 1500 $ prize in cash !"
"league_name_2831"	"Emerge Insomnia54 Dota 2 Cup"
"[english]league_name_2831"	"Emerge Insomnia54 Dota 2 Cup"
"league_name_2832"	"MPGL SEA - 7ª Temporada (Eliminatórias)"
"[english]league_name_2832"	"MPGL SEA Season 7 Qualifiers"
"league_description_2832"	"O caminho para a Malásia começa nas eliminatórias da 7ª temporada da MPGL SEA. Todas as equipas do sudeste asiático batalharão por um dos 11 lugares na final da 7ª temporada da MPGL SEA, em maio na Malásia, com um prémio total de 50.000$."
"[english]league_description_2832"	"Road to Malaysia start with MPGL SEA Season 7 Qualifiers. All teams in South East Asia will fight for the 11 slots in MPGL SEA Season 7 Final in Malaysia on May for 50,000USD"
"league_description_2836"	"Jogadores da Europa de Leste competem por itens raros."
"[english]league_description_2836"	"Players from CIS will fight for the RAR."
"league_name_2849"	"Hitbox European Championship #2"
"[english]league_name_2849"	"Hitbox European Championship #2"
"league_name_2860"	"On Art Challenge Series"
"[english]league_name_2860"	"On Art Challenge Series"
"league_description_2860"	"Campeonato sul-americano de Dota 2 que garante um lugar no torneio tradicional Onart 2015."
"[english]league_description_2860"	"South American Dota2 Championship, qualifying for traditional tournament Onart 2015 ."
"league_name_2868"	"Vake Dota2.fm Tournament"
"[english]league_name_2868"	"Vake Dota2.fm Tournament"
"league_description_2868"	"Este torneio é de inscrição aberta e qualquer equipa amadora pode inscrever-se gratuitamente em Dota2.fm e competir por 800$. Este bilhete só te permite assistir a partidas do VAKE DOTA2.FM TOURNAMENT."
"[english]league_description_2868"	"This tournament is open registration, and any non-pro team can sign up at Dota2.fm to compete for 800$. This ticket only grants access to view games from the VAKE DOTA2.FM TOURNAMENT."
"league_name_2877"	"Red Bull Battle Grounds: Dota 2"
"[english]league_name_2877"	"Red Bull Battle Grounds: Dota 2"
"league_name_2879"	"DOT.fair Challenge"
"[english]league_name_2879"	"DOT.fair Challenge"
"league_name_2882"	"American Star League "
"[english]league_name_2882"	"American Star League "
"league_description_2882"	"As melhores equipas americanas competem por um prémio de mais de 500$."
"[english]league_description_2882"	"American top teams face to compete for a prize fund of more than $500"
"league_name_2883"	"RLG Dota 2 Championship"
"[english]league_name_2883"	"RLG Dota 2 Championship"
"league_description_2883"	"O maior torneio de Dota 2 no Sri Lanka com o maior prémio total na história dos eSports na região!"
"[english]league_description_2883"	"The largest DOTA 2 tournament in Sri Lanka, featuring the biggest prize pool ever in Sri Lankan eSports history! "
"league_name_2892"	"Dota 2 Arena League # 2"
"[english]league_name_2892"	"Dota 2 Arena League # 2"
"league_description_2892"	"128 equipas irão competir por um prémio."
"[english]league_description_2892"	"128 teams will battle for a prize fund"
"league_name_2899"	"HEELYS CUP - 1ª Temporada"
"[english]league_name_2899"	"HEELYS CUP season 1"
"league_name_2912"	"VPGame Pro League"
"[english]league_name_2912"	"VPGame Pro League"
"league_description_2912"	"VPGAME"
"[english]league_description_2912"	"VPGame"
"league_name_2913"	"Luki E-Sport"
"[english]league_name_2913"	"Luki E-Sport"
"league_description_2913"	"A primeira temporada do torneio amador onde as melhores equipas de Velikiye Luki, na Rússia, irão competir pelo título de campeão!"
"[english]league_description_2913"	"The first season of the amateur tournament in which the best teams of Velikie Luki will meet in battle for the title of the champion!"
"league_name_2919"	"Ragnarok Dota2 Championship"
"[english]league_name_2919"	"Ragnarok Dota2 Championship"
"league_description_2919"	"Um torneio indiano de Dota 2 online com um prémio total de 35000 rupias."
"[english]league_description_2919"	"Online Dota2 tournament based in India with a prize pool of Rs. 35000"
"league_name_2921"	"The GamePlan - 1ª Temporada"
"[english]league_name_2921"	"The GamePlan Season 1"
"league_description_2922"	"A WCA 2015 está de volta com 4 eliminatórias regionais. Os vencedores das eliminatórias irão encontrar-se e competir por 140.000$ nas finais em LAN de Yinchuan em dezembro deste ano. Esta é a eliminatória profissional chinesa que inclui 32 partidas."
"[english]league_description_2922"	"WCA 2015 returns with four regional qualifiers. Qualifier winners will meet and compete for $140,000 at the LAN finals in Yinchuan in this December. This is the chinese Pro-qualifier include 32 matches."
"league_name_2928"	"The Battle Fury 2015"
"[english]league_name_2928"	"The Battle Fury 2015"
"league_description_2928"	"As melhores equipas do Peru lutam pelo título de campeão da Battle Fury 2015."
"[english]league_description_2928"	"The best teams from Perú fight for consecrated as the champion of  the Battle Fury 2015

"
"league_name_2929"	"Virtute League - 2ª Temporada"
"[english]league_name_2929"	"Virtute League Season 2"
"league_name_2940"	"DotAing Man League - 1ª Temporada"
"[english]league_name_2940"	"DotAing Man League Season 1"
"league_name_2941"	"iSTTS Indodota Gamma Cup"
"[english]league_name_2941"	"iSTTS Indodota Gamma Cup"
"league_description_2941"	"Equipas da Indonésia competem por 10.000.000 IDR. Organizado por Indodota e patrocinado por iSTTS e Camel Tape."
"[english]league_description_2941"	"Teams from Indonesia battle it out to be the winner of 10.000.000 IDR. Organized by Indodota and sponsored by iSTTS and Camel Tape"
"league_name_2952"	"The FDL"
"[english]league_name_2952"	"The FDL"
"league_description_2952"	"Liga Amadora de Dota2"
"[english]league_description_2952"	"Amateur DOTA2 League"
"league_name_2954"	"Mountain Trail Challenge"
"[english]league_name_2954"	"Mountain Trail Challenge"
"league_name_2963"	"Sudamerican Master 2"
"[english]league_name_2963"	"Sudamerican Master 2"
"league_description_2963"	"Segunda edição de um dos maiores torneios da América Latina. As 16 melhores equipas da América do Sul irão competir por um prémio total de mais de 1500$."
"[english]league_description_2963"	"Second version of one of the biggest tournaments in Latin America. The 16 best teams in South America compete to win over $ 1500USD prize. "
"league_name_2970"	"UGC Dota 2 League - 4ª Temporada"
"[english]league_name_2970"	"UGC Dota 2 League Season 4"
"league_description_2970"	"A UGC League é uma liga comunitária que atualmente organiza eventos competitivos do Dota 2 e do TF2."
"[english]league_description_2970"	"The UGC League in a community league currently running Dota 2 and TF2 Skill based competitions"
"league_name_2973"	"ASUS Clash of the Titans Dota 2 Tournament - Series 2"
"[english]league_name_2973"	"ASUS Clash of the Titans Dota 2 Tournament - Series 2"
"league_description_2973"	"A segunda série do ASUS Indonesia Clash of the Titans Dota 2 Tournament. O torneio contará com 64 grandes equipas da Indonésia a competir por um prémio total de 600$."
"[english]league_description_2973"	"The second series of ASUS Indonesia Clash of the Titans Dota 2 Tournament. The tournament consists of 64 top teams in Indonesia and will compete for $600 prize pool. "
"league_name_2979"	"Donbass Cup : Zp Qual"
"[english]league_name_2979"	"Donbass Cup : Zp Qual"
"league_description_2979"	"Eliminatórias para a Donbass Cup na cidade de Zaporozhye. A equipa vencedora recebe um prémio e jogará nos playoffs do torneio principal."
"[english]league_description_2979"	"Qualifications at Donbass cop in the city of Zaporozhye. The winner receives a prize and plays in the playoffs of the main tournament."
"league_name_2980"	"joinDOTA MLG Pro League - 2ª Temporada"
"[english]league_name_2980"	"joinDOTA MLG Pro League Season 2"
"league_name_2985"	"Esports Champion League 2015 Spring"
"[english]league_name_2985"	"Esports Champion League 2015 Spring"
"league_name_2986"	"MarsTV Dota 2 League"
"[english]league_name_2986"	"MarsTV Dota 2 League"
"league_description_2986"	"A MarsTV Dota 2 League (MDL) é uma liga organizada pela MarsTV que contará com um prémio total base de cerca de 320.000$."
"[english]league_description_2986"	"The MarsTV Dota 2 League (MDL) is a league hosted by MarsTV that will feature a base prize-pool of around $320,000."
"league_name_2993"	"D2SLP: Season 3 - Crownless Version"
"[english]league_name_2993"	"D2SLP: Season 3 - Crownless Version"
"league_description_2993"	"16 jogadores da Rússia irão competir um prémio em dinheiro."
"[english]league_description_2993"	"16 players from Russia will compete for a cash prize in D2SLP: Season 3 - Crownless Version"
"league_name_3012"	"Eternally Exiled Cup Season III"
"[english]league_name_3012"	"Eternally Exiled Cup Season III"
"league_name_3013"	"FirstGameTV DOTA 2 CUP"
"[english]league_name_3013"	"FirstGameTV DOTA 2 CUP"
"league_name_3022"	"Battle of the Five Runes"
"[english]league_name_3022"	"Battle of the Five Runes"
"league_name_3037"	"Razer Think Fast 2 Finals"
"[english]league_name_3037"	"Razer Think Fast 2 Finals"
"league_description_3037"	"8 equipas jogam num evento em LAN por 10000$."
"[english]league_description_3037"	"8 Teams Meet in LAN to Battle for 10.000$"
"league_name_3038"	"Forward To Victory cup 3"
"[english]league_name_3038"	"Forward To Victory cup 3"
"league_description_3038"	"32 equipas da Europa de Leste competem por 100$."
"[english]league_description_3038"	"32 team CIS battle for 100$"
"league_name_3049"	"D2S Spring Cup"
"[english]league_name_3049"	"D2S Spring Cup"
"league_description_3049"	"Nesta primavera trazemos-te a D2S Spring Cup, onde equipas da região dos Balcãs irão competir por prémios em dinheiro e produtos."
"[english]league_description_3049"	"This Spring, we bring you the D2S Spring Cup where the teams from Balkan will compete for cash and commodity prize. "
"league_name_3072"	"AOC & Rapoo Masters Championship"
"[english]league_name_3072"	"AOC & Rapoo Masters Championship"
"league_description_3072"	"Este torneio conta com 16 das melhores equipas do sudeste asiático a competir por um prémio total de 3000$ e hardware de AOC e Rapoo."
"[english]league_description_3072"	"This tournament features 16 of the best South-East Asian teams competing for a total prize money of 3,000USD and hardware from AOC and Rapoo."
"league_name_3084"	"Giant Rocket League - 3ª Temporada"
"[english]league_name_3084"	"Giant Rocket League - Season 3"
"league_name_3092"	"FACEIT Pro League"
"[english]league_name_3092"	"FACEIT Pro League"
"league_description_3092"	"FACEIT Pro League é uma comunidade de elite criada por jogadores profissionais da Europa. Assiste a centenas de jogos por mês de graça e vê os melhores jogadores da Europa a lutar por um prémio mensal. Podes também qualificar-te para a FPL jogando em FACEIT MASTER LEAGUE."
"[english]league_description_3092"	"FACEIT Pro League is an elite community created by professional Dota2 players from Europe. Watch hundreds of games per month for free and witness the best players of Europe fight for a monthly prizepool. You can aswell qualify for FPL by playing at FACEIT Master League."
"league_name_3098"	"South American Fire Cup"
"[english]league_name_3098"	"South American Fire Cup"
"league_name_3129"	"ProDotA Cup by Twitch.tv"
"[english]league_name_3129"	"ProDotA Cup by Twitch.tv"
"league_description_3129"	"4 equipas convidadas e 4 equipas apuradas jogam no formato de eliminação única pelo prémio de 2000$!"
"[english]league_description_3129"	"4 invited and 4 qualified teams complete single elimination round to claim the 2,000$ prize pool!"
"league_name_3133"	"Lampions League III"
"[english]league_name_3133"	"Lampions League III"
"league_name_3135"	"Possible Heroes Pudge Wars"
"[english]league_name_3135"	"Possible Heroes Pudge Wars"
"league_name_3173"	"Battle of the Five Runes"
"[english]league_name_3173"	"Battle of the Five Runes"
"league_name_3177"	"Master League"
"[english]league_name_3177"	"Master League"
"league_description_3177"	"Master League é um torneio onde equipas principiantes do Peru começam a sua busca por novos desafios."
"[english]league_description_3177"	"Master League tournament teams Peru where beginners start looking for new challenges."
"league_name_3215"	"Teams Impact - 1ª Temporada"
"[english]league_name_3215"	"Teams Impact Season 1"
"league_description_3215"	"16 equipas amadoras competem por um prémio total de 500$."
"[english]league_description_3215"	"16 amateur teams will compete for a prize pool of 500$."
"league_name_3221"	"On Art Challenge Series #2"
"[english]league_name_3221"	"On Art Challenge Series #2"
"league_description_3221"	"Campeonato sul-americano de Dota 2, como eliminatória para a 2ª temporada do campeonato tradicional Onart 2015."
"[english]league_description_3221"	"South American Dota2 Championship, qualifying for traditional tournament Onart 2015, Season 2."
"league_name_3236"	"Recall Pro League - 1ª Temporada"
"[english]league_name_3236"	"Recall Pro League Season #1"
"league_description_3236"	"32 equipas brasileiras competem entre si pelo título de campeão na 1ª temporada da Recall Pro League."
"[english]league_description_3236"	"32 Brazilian teams face off for the title of the first season of Recall Pro League Dota 2."
"league_name_3263"	"DOTA 2 SIVVIT League"
"[english]league_name_3263"	"DOTA 2 SIVVIT League"
"league_description_3263"	"Equipas da C.E.I. vão enfrentar-se em batalhas épicas até que a equipa campeã surja vitoriosa."
"[english]league_description_3263"	"Teams from all around CIS will meet in epic battles until the one champion is known."
"league_name_3279"	"Reborn French League"
"[english]league_name_3279"	"Reborn French League"
"league_name_3282"	"DA 5v5 Team Series - Junho 2015"
"[english]league_name_3282"	"DA 5v5 Team Series - June 2015"
"league_name_3290"	"Low Skill Cup - 2ª Temporada"
"[english]league_name_3290"	"Low Skill Cup Season 2"
"league_name_3296"	"TEvent Dota 2 - 3ª Temporada"
"[english]league_name_3296"	"TEvent Dota 2 Season 3"
"league_name_3305"	"The Basher Cup"
"[english]league_name_3305"	"The Basher Cup"
"league_name_3312"	"SIVVIT Tournament "
"[english]league_name_3312"	"SIVVIT Tournament "
"league_description_3312"	"As melhores equipas vão competir pelo título de campeão do SIVVIT."
"[english]league_description_3312"	"The best teams will compete for the title and the right to be called champion SIVVIT."
"league_description_3332"	"Equipas semiprofissionais da Europa de Leste lutam pelo título de campeão."
"[english]league_description_3332"	"The battle for the title of the best semi-pro team of the CIS"
"league_name_3340"	"FACEIT Pro League Europe"
"[english]league_name_3340"	"FACEIT Pro League Europe"
"league_description_3340"	"FACEIT Pro League Europe é uma comunidade de elite criada por jogadores profissionais de Dota 2 da Europa. FPL é também um centro de desenvolvimento para jovens jogadores com talento e futuros campeões. Podes apurar-te para a FPL jogando na Master e Diamond League em FACEIT todos os meses."
"[english]league_description_3340"	"FACEIT Pro League Europe is an elite community created by professional Dota2 players from EU. FPL is also a development centre for young talented players and future champions. You can qualify for FPL by playing on Master and Diamond League on FACEIT every month."
"league_name_3341"	"FACEIT Pro League North America "
"[english]league_name_3341"	"FACEIT Pro League North America "
"league_description_3341"	"FACEIT Pro League North America é uma comunidade de elite criada por jogadores profissionais de Dota 2 da América do Norte. FPL é também um centro de desenvolvimento para jovens jogadores com talento e futuros campeões. Podes apurar-te para a FPL jogando na Master e Diamond League em FACEIT todos os meses."
"[english]league_description_3341"	"FACEIT Pro League North America is an elite community created by professional Dota2 players from NA. FPL is also a development centre for young talented players and future champions. You can qualify for FPL by playing on Master and Diamond League on FACEIT every month."
"league_name_3344"	"KOD Temporada 1"
"[english]league_name_3344"	"KOD Temporada 1"
"league_name_3363"	"S-Prime Dota 2 Tournament"
"[english]league_name_3363"	"S-Prime Dota 2 Tournament"
"league_name_3402"	"Meister Series League"
"[english]league_name_3402"	"Meister Series League"
"league_name_3415"	"ATRA League qualifiers"
"[english]league_name_3415"	"ATRA League qualifiers"
"league_name_3450"	"CZ-SK Dota 2 League - 5ª Temporada"
"[english]league_name_3450"	"CZ-SK Dota 2 League Season 5"
"league_description_3450"	"A quinta temporada desta liga checoslovaca que terá a duração de dois meses. A equipa vencedora levará um prémio em dinheiro para casa!"
"[english]league_description_3450"	"The fifth season of Czech-Slovakia league will take place over a two months period. The winner will receive prize money upon victory!"
"league_name_3454"	"WePlay League - 3ª Temporada"
"[english]league_name_3454"	"WePlay League Season 3"
"league_description_3454"	"A WePlay League está de volta para a sua 3ª temporada! Grandes equipas de todo o mundo enfrentam-se em batalhas épicas por um prémio total de mais de $200.000. Bilhetes vendidos aumentam o prémio total em 20% enquanto a compra de qualquer um dos 4 conjuntos de itens aumenta em 10%. As 8 melhores equipas enfrentar-se-ão na final em LAN em Kiev."
"[english]league_description_3454"	"The WePlay League is back with Season 3! Top teams from around the world will compete for a prizepool of more than $200,000. Ticket purchases increase the prize pool by 20% of sales, while purchase of any of the 4 cosmetic sets increases it by 10%. Best 8 teams will travel to the LAN finals in Kiev."
"league_name_3455"	"Elpadrinoth Latin Tournaments - 2ª Temporada"
"[english]league_name_3455"	"Elpadrinoth Latin Tournaments Season 2"
"league_name_3462"	"Esportsone Pro Series - 1ª Temporada"
"[english]league_name_3462"	"Esportsone Pro Series Season 1"
"league_description_3462"	"É com orgulho que Esportsone apresenta a 1ª temporada da Esportsone Pro Series. Assiste às melhores equipas da Oceânia a competir pelo título de campeão e pelo prémio total de 2500 dólares australianos!"
"[english]league_description_3462"	"Esportsone proudly presents the 1st season of the Esportsone  Pro Series. Watch the best teams in the Oceanic region battle it out to be crowned season champions and take home a share in a base prize pool of AUD $2500 "
"league_name_3468"	"VPGAME Challenger League"
"[english]league_name_3468"	"VPGAME Challenger League"
"league_name_3482"	"Sudamerican Master 3 by g2a"
"[english]league_name_3482"	"Sudamerican Master 3 by g2a"
"league_description_3482"	"A terceira versão de um dos maiores torneios da América Latina. As melhores equipas da região vão competir por um prémio de $3500. "
"[english]league_description_3482"	"Third version of one of the biggest tournaments in Latin America. The  best teams in South America compete to win over $ 3500USD prize. "
"league_name_3502"	"Nanyang Championships"
"[english]league_name_3502"	"Nanyang Championships"
"league_description_3502"	"O Nanyang Championship é um dos maiores torneios de Dota 2 do Sudeste Asiático, organizado por KeyTV. Com um prémio total base de $200000, este torneio vai ter a participação de 10 das melhores equipas de Dota 2 do mundo em Singapura."
"[english]league_description_3502"	"Nanyang Championship is one of the largest DOTA2 tournaments held in SEA, hosted by KeyTV. With a base prize pool of USD200,000 , this tournament will see 10 of the top DOTA2 teams across the globe meet in Singapore."
"league_name_3511"	"ProDotA Cup by Azubu.tv"
"[english]league_name_3511"	"ProDotA Cup by Azubu.tv"
"league_description_3511"	"8 equipas convidadas e 8 equipas apuradas competem em rondas de eliminação simples por um prémio total de 5000$!"
"[english]league_description_3511"	"8 invited teams and 8 qualified teams complete single elimination round to claim the 5,000$ total prize pool!"
"league_name_3526"	"Recall Pro League - 2ª Temporada"
"[english]league_name_3526"	"Recall Pro League Season #2"
"league_description_3526"	"32 equipas brasileiras competem pelo título de campeão da 2ª temporada da Recall Pro League Dota 2."
"[english]league_description_3526"	"32 Brazilian teams face off for the title of the second season of Recall Pro League Dota 2."
"league_name_3530"	"BTS Americas"
"[english]league_name_3530"	"BTS Americas"
"league_description_3530"	"Em parceria com o FaceIT, a Beyond the Summit traz a 1ª edição da BTS Americas, apresentada por Squarespace. A BTS Americas coloca 16 equipas a competir entre si em grupos de eliminação única onde irão competir por 10.000$ durante 3 semanas."
"[english]league_description_3530"	"In partnership with FaceIT, Beyond the Summit brings you the first edition of the BTS Americas presented by Squarespace. The BTS Americas puts 16 teams up against each other in a single elimination bracket where they will compete for $10,000 USD over the course of 3 weeks. On top of the invited team"
"league_name_3531"	"epic.FIFTEEN Dota 2 Championship"
"[english]league_name_3531"	"epic.FIFTEEN Dota 2 Championship"
"league_description_3531"	"Várias equipas promissoras de Dota encontram-se neste evento em LAN que terá lugar em Kettering, no Reino Unido!"
"[english]league_description_3531"	"A collection of up-and-coming Dota teams meet in LAN combat in Kettering, UK!"
"league_name_3534"	"The Defense - 5ª Temporada"
"[english]league_name_3534"	"The Defense Season 5"
"league_description_3534"	"The Defense foi o primeiro grande torneio de Dota 2 organizado pela www.joinDOTA.com sem contar com o International. Chegou a altura de trazer esta marca icónica de volta."
"[english]league_description_3534"	"The Defense was the first major tournament run by www.joinDOTA.com for Dota 2 outside of 'The International'. The time has come to return this iconic brand to the scene."
"league_name_3538"	"Dota Elite Series - 2ª Temporada"
"[english]league_name_3538"	"Dota Elite Series - Season 2"
"league_description_3538"	"A 2ª temporada do torneio DOTA 2 Elite Series, com algumas das melhores equipas da América do Norte."
"[english]league_description_3538"	"The second season of DOTA 2 Elite Series tournament, hosting some of the the best teams in North America."
"league_name_3539"	"KOD League"
"[english]league_name_3539"	"KOD League"
"league_name_3570"	"HuoMaoTV Mid-Summer League"
"[english]league_name_3570"	"HuoMaoTV Mid-Summer League"
"league_description_3570"	"A HuoMaoTV Mid-Summer League é uma liga organizada por HuoMaoTV. Algumas das equipas mais promissores da China e do Sudeste Asiático vão competir por 150.000 RMB."
"[english]league_description_3570"	"The HuoMaoTV Mid-Summer League is a league organized by HuoMaoTV. Some of the best promising teams in China and Southeast Asia will compete for 150,000RMB. "
"league_name_3571"	"Dota-LAN Summer 2015"
"[english]league_name_3571"	"Dota-LAN Summer 2015"
"league_description_3571"	"A maior LAN party dedicada ao Dota da Alemanha está de volta na sua 13ª edição, onde alguns dos melhores jogadores alemães de Dota se irão encontrar para participar em partidas casuais e num torneio sério. Este bilhete dá acesso às melhores partidas do torneio 5on5, comentadas por Blacklight e Fas."
"[english]league_description_3571"	"Germany's biggest Dota dedicated LAN party returns for it's 13th edition with some of the best German Dota players meeting up for both fun games and a serious tournament. This ticket features the best matches of the 5on5 tournament with casting from Blacklight and Fas."
"league_name_3654"	"sCSL Eclipse - 1ª Temporada"
"[english]league_name_3654"	"sCSL Eclipse Season I"
"league_description_3654"	"A 1ª temporada da liga do Extremo Oriente, \"Eclipse\", que consiste em duas fases: a fase de grupos e os play-offs. As equipas de todo o Extremo Oriente vão competir pelo título de melhor equipa da temporada e um prémio total de 100$."
"[english]league_description_3654"	"The first season of the Far Eastern league, \" Eclipse,\" which consists of two stages: the group stage and play - off . Teams from all over the Far East will compete for the title of best team of the season and a prize pool of $ 100."
"league_name_3671"	"Dota 2 Majors EU 2015"
"[english]league_name_3671"	"Dota 2 Majors EU 2015"
"league_name_3672"	"DotA2VO Ability Cup #3"
"[english]league_name_3672"	"DotA2VO Ability Cup #3"
"league_description_3672"	"O 3º grande torneio do modo de seleção de habilidades. As melhores equipas europeias competem entre si por 1000$ e o título de campeão da Ability Cup #3."
"[english]league_description_3672"	"Third grand tournament of ability draft mode. Best EU teams compete with each other for 1000$ and title of the champions of the Ability Cup #2"
"league_name_3685"	"Teams Impact - 2ª Temporada"
"[english]league_name_3685"	"Teams Impact season 2"
"league_description_3685"	"16 equipas vão enfrentar-se umas às outras por um prémio. Duas delas foram as vencedoras da 1ª temporada e outras duas foram vencedoras das eliminatórias para a 2ª temporada."
"[english]league_description_3685"	"16 teams will face each other for a prize, from which 2 teams are the winners of the first season and 2 teams-winners of qualifiers for season 2."
"league_name_3688"	"MLeS"
"[english]league_name_3688"	"MLeS"
"league_name_3697"	"NQ Dota 2 League Season 2"
"[english]league_name_3697"	"NQ Dota 2 League Season # 2"
"league_name_3726"	"D2CL - 6ª Temporada"
"[english]league_name_3726"	"D2CL Season 6"
"league_name_3730"	"Phoenix Cup"
"[english]league_name_3730"	"Phoenix Cup"
"league_name_3736"	"ProKits Arena"
"[english]league_name_3736"	"ProKits Arena"
"league_name_3739"	"Gaming Paradise - 1ª Temporada"
"[english]league_name_3739"	"Gaming Paradise Season 1"
"league_description_3739"	"8 equipas convidadas competem por um prémio total de $50000"
"[english]league_description_3739"	"8 Invited teams competing for basic prize pool of $50.000 in unique environment"
"league_name_3766"	"InetPeru League - 2ª Temporada"
"[english]league_name_3766"	"InetPeru League Season 2"
"league_name_3768"	"Eternally Exiled Cup - 4ª Temporada"
"[english]league_name_3768"	"Eternally Exiled Cup Season IV"
"league_description_3768"	"Eternally Exiled Cup apresenta a sua 4ª temporada! Equipas profissionais da Europa de Leste vão competir por um prémio."
"[english]league_description_3768"	"Eternally Exiled Cup presents its four season! Professional teams from CIS will compete for a total prize pool. "
"league_name_3779"	"BTS Americas #2"
"[english]league_name_3779"	"BTS Americas #2"
"league_description_3779"	"A série BTS Americas apresenta as melhores equipas da América do Norte a competir por um prémio de $10000."
"[english]league_description_3779"	"The BTS Americas series pits the best teams in North America against each other for $10,000 USD"
"league_name_3781"	"The Summit 4"
"[english]league_name_3781"	"The Summit 4"
"league_description_3781"	"Mantendo o espírito das edições anteriores, o The Summit 4 será outra experiência íntima e descontraída com as melhores equipas de todo o mundo a enfrentar-se no estúdio da Beyond the Summit em Los Angeles."
"[english]league_description_3781"	"Continuing the the spirit of previous iterations, The Summit 4 will be another laid-back, intimate experience with the best teams from across the globe duking it out in the Beyond the Summit studio in Los Angeles."
"league_name_3782"	"Tecnolan 2015"
"[english]league_name_3782"	"Tecnolan 2015"
"league_name_3798"	"ESL One at New York Super Week"
"[english]league_name_3798"	"ESL One at New York Super Week"
"league_name_3844"	"Ve_Dota Ethereal Blade Cup"
"[english]league_name_3844"	"Ve_Dota Ethereal Blade Cup"
"league_name_3849"	"Dota 2 MASGAMERS Pro League"
"[english]league_name_3849"	"Dota 2 MASGAMERS Pro League"
"league_name_3865"	"ASUS ROG DreamLeague Season 4"
"[english]league_name_3865"	"ASUS ROG DreamLeague Season 4"
"league_name_3867"	"MSDT Season1"
"[english]league_name_3867"	"MSDT Season1"
"league_name_3877"	"DOTA2 Radiant & Dire Cup 2015"
"[english]league_name_3877"	"DOTA2 Radiant & Dire Cup 2015"
"league_name_3902"	"StarLadder | i-League"
"[english]league_name_3902"	"StarLadder | i-League"
"league_description_3902"	"Starladder e i-League apresentam a 13ª temporada da StarSeries"
"[english]league_description_3902"	"Starladder and i-League present new StarSeries Season 13"
"league_name_3904"	"Esports Champion League 2015 Autumn"
"[english]league_name_3904"	"Esports Champion League 2015 Autumn"
"league_name_3976"	"Hitbox EU Championship #4"
"[english]league_name_3976"	"Hitbox EU Championship #4"
"league_name_3990"	"Frankfurt Major 2015 - Eliminatórias Abertas"
"[english]league_name_3990"	"Frankfurt Major 2015 Open Qualifiers"
"league_description_3990"	"Vê equipas vindas de todas as partes do mundo a competirem por um lugar no Frankfurt Major 2015."
"[english]league_description_3990"	"Witness teams from all around the world compete for a place at The Frankfurt Major 2015."
"league_name_3991"	"Nxtgame Eternal Dota League Season 4"
"[english]league_name_3991"	"Nxtgame Eternal Dota League Season 4"
"league_description_3991"	"A 4ª temporada da Nxtgame Eternal Dota League, organizada por Eternal Gaming Organizer, onde equipas irão lutar pelo prémio total de 8.000.000 IDR. Patrocinado por NXTGAME, Logitech G, G2A, Unipin e Dota2Geek."
"[english]league_description_3991"	"Nxtgame Eternal Dota League Season 4 Organized by Eternal Gaming Organizer where team will Battle for total prize IDR 8.000.000 Sponsored by NXTGAME ,Logitech G, G2A ,Unipin, Dota2Geek"
"league_name_3993"	"D2TV League - 3ª Temporada"
"[english]league_name_3993"	"D2TV League Season 3"
"league_name_4037"	"The Choco Cup"
"[english]league_name_4037"	"The Choco Cup"
"league_name_4039"	"CDEC Classic"
"[english]league_name_4039"	"CDEC Classic"
"league_name_4049"	"BoraDota STARS 2"
"[english]league_name_4049"	"BoraDota STARS 2"
"league_description_4049"	"A segunda temporada da BoraDota STARS, um torneio profissional com as 16 melhores equipas da América do Sul."
"[english]league_description_4049"	"Second BoraDota STARS with the best sixteen teams in South America in a professional tournment."
"league_name_4088"	"World Cyber Arena 2015 GRAND FINAL"
"[english]league_name_4088"	"World Cyber Arena 2015 GRAND FINAL"
"league_description_4088"	"WCA 2015 está de volta com 4 eliminatórias regionais. Os vencedores das eliminatórias irão enfrentar-se por 680.000$ nas finais em LAN em Yinchuan neste mês de dezembro."
"[english]league_description_4088"	"WCA 2015 returns with four regional qualifiers. Qualifier winners will meet and compete for $680,000 at the LAN finals in Yinchuan in this December. This League is World Cyber Arena 2015 GRAND FINAL"
"league_name_4100"	"K-Cup Dota2 Amateur League - 2ª Temporada"
"[english]league_name_4100"	"K-Cup Dota2 Amateur League Season 2"
"league_name_4112"	"Global eSports Cup LAN Finals - 1ª Temporada"
"[english]league_name_4112"	"Global eSports Cup LAN Finals Season 1"
"league_description_4112"	"Game Show Global eSports Cup é a primeira de três temporadas com um prémio total de 1.000.000$. Todas as regiões competem em várias fases até 8 equipas se encontram na Game Show Studio LAN Vilnius. As 4 melhores competirão na grande final na Dreamhack Moscow por 250.000$."
"[english]league_description_4112"	"Game Show Global eSports Cup is the first of three seasons with a prizepool of 1.000.000 USD. All regions battle in various stages until 8 teams meet eachother in the Game Show Studio LAN Vilnius. The best 4 will move on to fight on Dreamhack Moscow to enter the Grand Final for 250.000 USD"
"league_name_4119"	"D2CL S7 Christmas Magic"
"[english]league_name_4119"	"D2CL S7 Christmas Magic"
"league_description_4119"	"Vamos começar a nova temporada com regras incríveis, comentadores fantásticos, equipas experientes e uma oportunidade única de melhorar o Natal!"
"[english]league_description_4119"	"We are beginning the new season with incredible match rules, best casters, skillful teams and a unique opportunity to make Christmas better!"
"league_name_4127"	"Uprise Champions Cup: Special"
"[english]league_name_4127"	"Uprise Champions Cup: Special"
"league_description_4127"	"A 3ª temporada do UCC: Special para equipas profissionais da CEI e da Europa. As melhores equipas irão lutar por um prémio total de 4.000$ durante 2 meses."
"[english]league_description_4127"	"UCC: Special Season 3 for professional teams from CIS and EU. The best teams will fight for  $  4000 prize pool for 2 month."
"league_name_4147"	"Siaranku.com Tournament"
"[english]league_name_4147"	"Siaranku.com Tournament"
"league_description_4147"	"Um torneio indonésio de Dota 2 por Siaranku.com que decorrerá de 21 a 28 de novembro."
"[english]league_description_4147"	"DotA 2 Indonesia Tournament Project by Siaranku.com on main event 21 November - 28 November"
"league_name_4156"	"DotAing Man League - 2ª Temporada"
"[english]league_name_4156"	"DotAing Man League Season 2"
"league_name_4172"	"Cyber Namba DOTA 2 - 2ª Temporada"
"[english]league_name_4172"	"Cyber Namba DOTA II Season II."
"league_name_4176"	"HELL League"
"[english]league_name_4176"	"HELL League"
"league_name_4177"	"CDEC Master"
"[english]league_name_4177"	"CDEC Master"
"league_description_4177"	"CDEC Master é a temporada principal da CDEC League. Só os jogadores profissionais e amadores de alto nível podem participar nesta liga. Cada temporada Master dura 2 semanas e usa o Modo de Capitães. No fim de cada temporada, os melhores jogadores receberão recompensas."
"[english]league_description_4177"	"CDEC Master is the highest level of CDEC league. Only the Pro players and the high-lever amaeur players can join this league. Each Master season lasts two weeks. The game mode is the Captain Mode. At the end of the season, the top players will have some rewards."
"league_name_4179"	"Tica Legends League - 2ª Temporada"
"[english]league_name_4179"	"Tica Legends League Season 2"
"league_description_4179"	"24 equipas da Costa Rica vão competir por prémios no valor de mais de 600$, em 3 divisões diferentes."
"[english]league_description_4179"	"24 costaricans teams will compete for a prize fund of over $600 and sponsors products, in 3 different divisions"
"league_name_4180"	"SIVVIT League"
"[english]league_name_4180"	"SIVVIT League"
"league_description_4180"	"As doze melhores equipas foram selecionadas para participar na liga SIVVIT, onde todas as semanas vão competir pelo título de campeão da liga."
"[english]league_description_4180"	"Twelve best teams were selected to participate in the League SIVVIT. Each week they will compete for the title of League champion."
"league_name_4181"	"Dota 2 Canada Cup Season 6 Open Qualifiers"
"[english]league_name_4181"	"Dota 2 Canada Cup Season 6 Open Qualifiers"
"league_description_4181"	"Eliminatórias abertas da 6ª temporada da Dota 2 Canada Cup. As 2 melhores equipas avançam diretamente para a fase de grupos. A ação começa a 28/29 de novembro!"
"[english]league_description_4181"	"Dota 2 Canada Cup Season 6 Open Qualifiers. Top 2 advance directly into the group stage.  Action begins November 28th / 29th!"
"league_name_4183"	"VivaWin Grand Slam Dota 2 Tournament"
"[english]league_name_4183"	"VivaWin Grand Slam Dota 2 Tournament"
"league_description_4183"	"O VIVAWIN Grand Slam contará com grandes equipas da Indonésia a competir por 10 milhões de rupias indonésias! Torneio patrocinado por VivaWin."
"[english]league_description_4183"	"VIVAWIN Grand Slam will featured Indonesia top team to fight total 10 million IDR. Tournament sponsored by VivaWin."
"league_name_4185"	"NGT - 4ª Temporada"
"[english]league_name_4185"	"NGT Season 4"
"league_description_4185"	"Contando com equipas semiprofissionais habilidosas da Europa e da América do Norte, o NeoN GuilD Tournament está de volta mais uma vez. Quem é que vai ser a equipa campeã?"
"[english]league_description_4185"	"Featuring skilled semi-pro teams across Europe and North America, NeoN GuilD Tournament is back once again. Who will emerge victorious?"
"league_name_4194"	"Dubai E-Sports Championship"
"[english]league_name_4194"	"Dubai E-Sports Championship"
"league_name_4210"	"Dota Pit League - 4ª Temporada"
"[english]league_name_4210"	"Dota Pit League Season Four"
"league_name_4219"	"UIUC League"
"[english]league_name_4219"	"UIUC League"
"league_description_4219"	"Um torneio de Dota 2 para determinar qual é a melhor equipa da universidade de Illinois Urbana-Champaign. 8 equipas vão competir num torneio online que culmina numa final em LAN."
"[english]league_description_4219"	"A full out 5 v 5 Dota 2 tournament to determine which team is the best in University of Illinois Urbana Champaign. There will be 8 teams competing with each other in an online tournament with a Lan Final. "
"league_name_4223"	"Vietnam eSports Champions - 3ª Temporada"
"[english]league_name_4223"	"Vietnam eSports Champions League III"
"league_description_4223"	"A 3ª temporada da eSports Champions League, organizada por eSportsviet.vn."
"[english]league_description_4223"	"eSportsviet.vn are going to organize Vietnam eSports Champions League season III. "
"league_name_4241"	"LANSKILL WINTER 2016"
"[english]league_name_4241"	"LANSKILL WINTER 2016"
"league_name_4249"	"Acer Predator Dota 2 Online Tournament"
"[english]league_name_4249"	"Acer Predator Dota 2 Online Tournament"
"league_name_4252"	"CZ-SK Dota 2 League - 7ª Temporada"
"[english]league_name_4252"	"CZ-SK Dota 2 League Season 7"
"league_description_4252"	"A sétima temporada desta liga checoslovaca decorrerá durante dois meses. A equipa vencedora levará para casa um prémio em dinheiro!"
"[english]league_description_4252"	"The seventh season of Czech-Slovakia league will take place over a two months period. The winner will receive prize money upon victory!"
"league_name_4263"	"DOTA Regions : Japan"
"[english]league_name_4263"	"DOTA Regions : Japan"
"league_description_4263"	"O evento de eleição para as equipas mais talentosas do Japão, contando com comentários em japonês e inglês, e um grande prémio em dinheiro."
"[english]league_description_4263"	"The premier event for top Japanese Dota 2 talent. Enjoy Japanese and English broadcasting as teams battle for some serious cash.  "
"league_name_4266"	"Winter Major 2016"
"[english]league_name_4266"	"Winter Major 2016"
"league_description_4266"	"The Shanghai Major 2016"
"[english]league_description_4266"	"The Shanghai Major 2016"
"league_name_4272"	"Sudamerican Master 4"
"[english]league_name_4272"	"Sudamerican Master 4"
"league_description_4272"	"A quarta edição de um dos maiores torneios das Américas. As melhores equipas da América do Sul e do Norte competem por um prémio de mais de 4000$."
"[english]league_description_4272"	"Quarte version of one of the biggest tournaments in  America. The best teams in South America and North America compete to win over $ 4000USD prize."
"league_name_4279"	"KOD LEAGUE - 2ª Temporada"
"[english]league_name_4279"	"KOD LEAGUE SEASON II"
"league_name_4282"	"Persian Gulf Cup - 2ª Temporada"
"[english]league_name_4282"	"Persian Gulf Cup Season 2"
"league_description_4282"	"Este torneio conta com as melhores equipas do Médio Oriente a competir entre si por um prémio total de 1500$."
"[english]league_description_4282"	"The Persian Gulf Cup Season 2 Pits The Best Team From The MEA Region Against Each Other For A Prize Pool Of 1500 $ ."
"league_name_4288"	"Artifice Chapter 1 Online Tournament"
"[english]league_name_4288"	"Artifice  Chapter 1 Online Tournament"
"league_name_4289"	"Captains Draft 3.0 Presented by DotaCinema & MoonduckTV"
"[english]league_name_4289"	"Captains Draft 3.0 Presented by DotaCinema & MoonduckTV"
"league_description_4289"	"A Captains Draft 3.0 traz-te jogadas únicas das melhores equipas do mundo. Os capitães das equipas são obrigados a pensar fora do seu ambiente nesta edição do único torneio profissional jogado no modo de Seleção dos Capitães."
"[english]league_description_4289"	"Captains Draft 3.0 brings you more unique gameplay consisting of some of the best teams in the world. Team captains are forced out of their comfort zone in the only professional tournament played in Captains Draft mode."
"league_name_4297"	"Dota 2 Canada Cup - 7ª Temporada"
"[english]league_name_4297"	"Dota 2 Canada Cup Season 7"
"league_description_4297"	"O Dota 2 Canada Cup está de volta, com algumas das melhores equipas da América do Norte e do Sul."
"[english]league_description_4297"	"The Dota 2 Canada Cup is back! Featuring some of the finest teams from North and South America."
"league_name_4301"	"2015 MarsTV Dota 2 League"
"[english]league_name_4301"	"2015 MarsTV Dota 2 League"
"league_description_4301"	"A MarsTV Dota 2 League está de volta para a temporada de inverno de 2015, contando com um prémio total base de 250.000$, assim como algumas das melhores equipas do planeta, incluindo os campeões da última temporada: Team Secret. Ao comprar um bilhete estarás a apoiar diretamente o torneio e as equipas: 25% dos lucros das vendas serão remetidos para o prémio total."
"[english]league_description_4301"	"The MarsTV Dota 2 League is back with its 2015 winter season featuring a base prize-pool of $250,000 as well as some of the finest teams on the planet including last season's champions: Team Secret. By purchasing a ticket, you will directly support the tournament, but also the teams as 25% of the proceeds contributes towards the prize-pool."
"league_name_4316"	"Weproud Tournament - 2ª Temporada"
"[english]league_name_4316"	"Weproud Tournament Season 2"
"league_description_4316"	"128 equipas da Indonésia vão competir por 5.000.000 rupias indonésias."
"[english]league_description_4316"	"128 Team From Indonesia will Fight for 5.000.000 IDR . Cause We Proud To be Indonesian E-Sports Player"
"league_name_4320"	"Red Dota Championship Sponsored by DafaeSports"
"[english]league_name_4320"	"Red Dota Championship Sponsored by DafaeSports"
"league_name_4324"	"TELKOMFEST 2016"
"[english]league_name_4324"	"TELKOMFEST 2016"
"league_description_4324"	"TELKOMFEST 2016"
"[english]league_description_4324"	"TELKOMFEST 2016"
"league_name_4325"	"Shanghai Major - Eliminatórias Abertas"
"[english]league_name_4325"	"Shanghai Major Open Qualifiers"
"league_description_4325"	"Shanghai Major"
"[english]league_description_4325"	"Shanghai Major"
"league_name_4329"	"ProStage cybersport: Tournament \"Genesis\""
"[english]league_name_4329"	"ProStage cybersport: Tournament \"Genesis\""
"league_name_4357"	"ESL One Manila 2016"
"[english]league_name_4357"	"ESL One Manila 2016"
"league_name_4361"	"DobroCup - 2ª Temporada"
"[english]league_name_4361"	"DobroCup Season 2"
"league_description_4361"	"32 equipas femininas vão competir pelo prémio de 20000 rublos num torneio organizado para a caridade."
"[english]league_description_4361"	"32 female teams, will compete for the prize of 20 000 rubles, the tournament is held for charity"
"league_name_4368"	"The Pirate League"
"[english]league_name_4368"	"The Pirate League"
"league_name_4382"	"Grapple Gaming Tournament - 2ª Temporada"
"[english]league_name_4382"	"Grapple Gaming Tournament Season 2"
"league_description_4382"	"Este torneio é organizado por Grapple Gaming e tem o apoio de Dota Base Indonesia. 64 equipas vão competir pelo prémio total de 6.000.000 IDR."
"[english]league_description_4382"	"This Tournament Organized by Grapple Gaming and Supported by Dota Base Indonesia. 64 team will compete to get IDR 6.000.000 Prizepool."
"league_name_4405"	"World Cyber Arena 2016 S1"
"[english]league_name_4405"	"World Cyber Arena 2016 S1"
"league_description_4405"	"A WCA 2016 está de volta com 3 temporadas. Os vencedores de cada temporada irão enfrentar-se por 760.000$ nas finais em LAN de Yinchuan em dezembro."
"[english]league_description_4405"	"WCA 2016 returns with 3 seasons. The winners of each season will meet and compete for $760,000 at the LAN finals in Yinchuan in this December. This League is World Cyber Arena 2016 season 1"
"league_name_4408"	"Click-Storm DOTA 2 League"
"[english]league_name_4408"	"Click-Storm DOTA 2 League"
"league_name_4442"	"The Summit 5"
"[english]league_name_4442"	"The Summit 5"
"league_description_4442"	"The Summit está de volta para a sua 5ª edição! Grandes equipas, jogadas de Dota fantásticas e momentos memoráveis esperam-te neste torneio favorito da comunidade."
"[english]league_description_4442"	"The Summit returns for its 5th iteration! Expect top teams, fantastic Dota 2, and memorable moments from this community favorite Tournament. "
"league_name_4459"	"SOFTEC '16"
"[english]league_name_4459"	"SOFTEC '16"
"league_description_4459"	"16 grandes equipas do Paquistão vão competir num evento em LAN organizado em FAST NU Lahore pelo prémio-base de 600$."
"[english]league_description_4459"	"Top 16 teams of Pakistan compete at a LAN event held at FAST NU Lahore for a base prize pool of $600."
"league_name_4461"	"EPICENTER: Moscow"
"[english]league_name_4461"	"EPICENTER: Moscow"
"league_description_4461"	"Grandes equipas de todo o mundo vão competir pelo prémio de 500.000$ em Moscovo."
"[english]league_description_4461"	"World's top teams will rumble for the $500 000 prize pool in Moscow"
"league_name_4468"	"University Games - 1ª Temporada"
"[english]league_name_4468"	"University Games Season 1"
"league_name_4469"	"Alsa Unpad Dota 2 Tournament"
"[english]league_name_4469"	"Alsa Unpad Dota 2 Tournament"
"league_description_4469"	"Um torneio apresentado pela ALSA da Padjadjaran University, para o evento ALSA Night. 64 equipas vão competir pelo prémio total neste torneio apoiado por Dota Base Indonesia e com comentários em direto."
"[english]league_description_4469"	"This Tournament Presented by Alsa of Padjadjaran University, for Alsa Night Event. 64 team will compete the prizepool, this tournament supported by Dota Base Indonesia and Live Gaming Broadcast."
"league_name_4471"	"SEA Kappa Invitationals"
"[english]league_name_4471"	"SEA Kappa Invitationals"
"league_description_4471"	"O SEA Kappa é um dos maiores torneios regionais do Sudeste Asiático com 50.000$ distribuídos ao longo de 4 temporadas!"
"[english]league_description_4471"	"SEA Kappa is one of the biggest regional tournaments in SEA with $50,000 in prize spread over 4 seasons!"
"league_name_4478"	"ASEAN Games for Esports 2016"
"[english]league_name_4478"	"ASEAN Games for Esports 2016"
"league_name_4483"	"Alchemy Dota2 Indonesia Tournament"
"[english]league_name_4483"	"Alchemy Dota2 Indonesia Tournament"
"league_name_4484"	"Clumba Cup - 2ª Temporada"
"[english]league_name_4484"	"Clumba Cup Season 2"
"league_description_4484"	"Um torneio criado para os jogadores da Comunidade dos Estados Independentes. 64 equipas vão competir pelo título de campeão do Clumba Cup e pelo prémio principal de 15000 rublos (340$). GL, HF!"
"[english]league_description_4484"	"Clumba Cup - Tournament-project created to improve the CIS community. 64 teams will compete for the title of Clumba Cup Champion and the main prize of 15 000 rubles ($ 340). In addition to the tournament in our group VK you can see the additional content designed to improve the CIS pubs. GL HF friends. We are waiting for you in our Clumba!"
"league_name_4489"	"Legendary Gaming League - 1ª Temporada"
"[english]league_name_4489"	"Legendary Gaming League Season 1"
"league_name_4503"	"UGC League Dota 2 Premium 2016"
"[english]league_name_4503"	"UGC League Dota 2 Premium 2016"
"league_name_4507"	"DreamLeague - 5ª Temporada"
"[english]league_name_4507"	"DreamLeague Season 5"
"league_description_4507"	"Nove das melhores equipas ocidentais vão competir por um lugar nos playoffs e pelo prémio total de 156.000$!"
"[english]league_description_4507"	"Nine of the best western teams in the world will fight for a spot in the playoffs and for the $156,000 prize pool!"
"league_name_4515"	"Mineski Pro Gaming League - 8ª Temporada"
"[english]league_name_4515"	"Mineski Pro Gaming League Season 8"
"league_description_4515"	"A MPGL está de volta para a oitava temporada deste torneio que irá reunir as melhores equipas das Filipinas. Qual é a equipa que vai surgir vitoriosa?"
"[english]league_description_4515"	"MPGL returns for the eighth season to gather the best teams in Philippines. Who will Rise from the Rest?"
"league_name_4525"	"World Cyber Arena 2016 S2"
"[english]league_name_4525"	"World Cyber Arena 2016 S2"
"league_description_4525"	"A WCA 2016 está de volta com 3 temporadas. Os vencedores de cada temporada irão enfrentar-se por 760.000$ nas finais em LAN de Yinchuan em dezembro. Esta é a segunda temporada."
"[english]league_description_4525"	"WCA 2016 returns with 3 seasons. The winners of each season will meet and compete for $760,000 at the LAN finals in Yinchuan in this December. This League is World Cyber Arena 2016 season 2"
"league_name_4530"	"WellPlay Invitational by Hitbox.tv"
"[english]league_name_4530"	"WellPlay Invitational by Hitbox.tv"
"league_description_4530"	"Oito equipas convidadas competem num formato de dupla eliminação pelo prémio de 3000$."
"[english]league_description_4530"	"8 invited teams competing in a Double-Elimination bracket to claim the 3,000$ prizepool."
"league_name_4536"	"The April Invitational"
"[english]league_name_4536"	"The April Invitational"
"league_name_4543"	"CyberGamer Pro Leagues - 3ª Temporada"
"[english]league_name_4543"	"CyberGamer Pro Leagues Season 3"
"league_description_4543"	"CyberGamer é a líder na Oceânia em torneios online. As Pro Leagues vão contar com as melhores equipas da região a competir por mais de 3000$."
"[english]league_description_4543"	"CyberGamer is Oceania's leader is online tournaments, leagues and ladders. DOTA2 Season 3 Pro Leagues will see the regions best teams battle it out for over $3000 in cash prizes"
"league_description_4546"	"A IMBATV apresenta uma liga chinesa onde cada temporada dura uma semana e o prémio total é de 20.000 renminbis."
"[english]league_description_4546"	"Presents by IMBATV,every week is a single season,prizepool is 20,000RMB for each week,most chinese teams play this tournament to improve themselves."
"league_name_4554"	"ESL One Frankfurt 2016"
"[english]league_name_4554"	"ESL One Frankfurt 2016"
"league_name_4565"	"Rookie Cup 2016"
"[english]league_name_4565"	"Rookie Cup 2016"
"league_description_4565"	"O torneio mais popular da Bolívia está de volta graças ao GG GROUP BOLIVIA: o Rookie Cup! Começa em abril com mais de 500$ em prémios."
"[english]league_description_4565"	"The most representative Bolivian tournament is back thanks to GG GROUP BOLIVIA: The rookie cup! It starts in April with over $ 500 in prizes."
"league_name_4567"	"TEvent Dota 2 - 5ª Temporada"
"[english]league_name_4567"	"TEvent Dota 2 Season 5"
"league_name_4579"	"SL i-League Invitational - 1ª Temporada"
"[english]league_name_4579"	"SL i-League Invitational Season 1"
"league_description_4579"	"A Starladder e a ImbaTV apresentam um torneio internacional com um prémio total de 100.000 USD. Assistam ao torneio e apoiem as vossas equipas favoritas de todo o planeta!"
"[english]league_description_4579"	"Starladder and ImbaTV present an international tournament with 100,000 USD prize pool. Watch us and support your favourite teams from the whole globe!"
"league_name_4598"	"NEA2016"
"[english]league_name_4598"	"NEA2016"
"league_description_4598"	"Este evento conta com o apoio do centro de informação desportiva da China e do gabinete de desportos de Pequim, com o patrocínio do centro de gestão desportiva de Pequim e é organizado por TongFang Media(Beijing)co.,Ltd.."
"[english]league_description_4598"	"NEA was founded in 2016. Bird's Nest is the place of final competition. The event is supported by the sports information center of General Administration of Sports of China and Beijing Sports Bureau, is sponsored by Beijing Sports Management Center and Bird's Nest, the hosted by TongFang Media(Beijing)co.,Ltd. The underlying tenets is \"competition spirit.\" \"E-sports China Dream\" for the vision to build a professional brand. Keeping the way of boutique competition to service society. We are devoted to develop E-sports and Cultural Diversity."
"league_name_4610"	"Shanghai Dota2 Open"
"[english]league_name_4610"	"Shanghai Dota2 Open"
"league_description_4610"	"Várias equipas competem em Xangai por um prémio total de 520.000 yuans."
"[english]league_description_4610"	" SDO planned by the Lanyou Culture of Shanghai , various teams compete with the prize pool of 520 thousand yuan."
"league_name_4613"	"KOD League"
"[english]league_name_4613"	"KOD League"
"league_description_4613"	"KOD League é uma liga de Dota 2 profissional que conta com as melhores equipas das Américas."
"[english]league_description_4613"	"KOD League is a professional league with best teams of america."
"league_name_4618"	"Dota 2 Challenge Mexico"
"[english]league_name_4618"	"Dota 2 Challenge Mexico"
"league_description_4618"	"A Dota 2 Challenge Mexico é a primeira liga profissional mexicana e contará com oito equipas provenientes de três eliminatórias regionais e um evento de repescagem."
"[english]league_description_4618"	"Dota 2 Challenge Mexico is the first professional Mexican League, including eight teams who qualified from three regional qualifiers and a wildcard."
"league_name_4632"	"SGC 2016"
"[english]league_name_4632"	"SGC 2016"
"league_name_4644"	"CZ-SK Dota 2 League - 8ª Temporada"
"[english]league_name_4644"	"CZ-SK Dota 2 League Season 8"
"league_description_4644"	"A oitava temporada desta liga checoslovaca decorrerá durante dois meses. A equipa vencedora levará para casa um prémio em dinheiro!"
"[english]league_description_4644"	"The eighth season of Czech-Slovakia league will take place over a two months period. The winner will receive prize money upon victory!"
"league_name_4646"	"SL i-League StarSeries S2"
"[english]league_name_4646"	"SL i-League StarSeries S2"
"league_name_4649"	"Manila Major - Eliminatórias Abertas"
"[english]league_name_4649"	"Manila Major Open Qualifiers"
"league_description_4660"	"Os Nanyang Championships estão de volta para a segunda temporada! Oito das melhores equipas profissionais de Dota 2 do mundo competem em Xangai de 6 a 10 de julho."
"[english]league_description_4660"	"Nanyang Championships Season2 is back! There will be 8 of the best professional DOTA2 teams in the world coming to Shanghai to compete from July 6th to 10th."
"league_name_4665"	"ProDotA Cup Series by Azubu.tv"
"[english]league_name_4665"	"ProDotA Cup Series by Azubu.tv"
"league_description_4665"	"Equipas profissionais da Europa e dos Estados Unidos competem pelo prémio de 5000$ para cada região."
"[english]league_description_4665"	"Professional teams participating from EU and US region to claim the $5.000 prize pool for each region"
"league_name_4669"	"WellPlay Invitational by VitalBet"
"[english]league_name_4669"	"WellPlay Invitational by VitalBet"
"league_description_4669"	"Oito equipas convidadas competem num formato de dupla eliminação pelo prémio de 3000$."
"[english]league_description_4669"	"8 invited teams competing in a Double-Elimination bracket to claim the 3,000$ prizepool."
"league_name_4682"	"DafaeSports Indonesia Series Presented by Eternal Gaming"
"[english]league_name_4682"	"DafaeSports Indonesia Series Presented by Eternal Gaming"
"league_description_4682"	"A DafaeSports Indonesia Series é um torneio profissional patrocinado por DafaeSports e apresentado por Eternal Gaming. Com o apoio da Fnatic, uma das equipas de e-sports mais famosas do mundo."
"[english]league_description_4682"	"DafaeSports Indonesia Series is Professional Tournament Sponsored by DafaeSports Presented by Eternal Gaming. Support by Fnatic One of the most famous e-sports team in the world."
"league_name_4685"	"AES Summer League S1"
"[english]league_name_4685"	"AES Summer League S1"
"league_name_4693"	"Dota 2 Professional League"
"[english]league_name_4693"	"Dota 2 Professional League"
"league_description_4693"	"A Dota 2 Professional League (DPL) é a liga mais prestigiada da China e contará com um prémio total de 1 milhão de dólares ao longo de duas temporadas. Organizada pelo Sports Information Center of National Sports General Administration e pela MarsTV, e com o apoio oficial do Perfect World, 22 das melhores equipas da China competem nos próximos meses até à conclusão da primeira temporada em julho, por um prémio de 200.000$."
"[english]league_description_4693"	"The Dota 2 Professional League (DPL) is the most prestigious league in China, and will feature a prize-pool of USD$1 million over two seasons. Hosted by the Sports Information Center of National Sports General Administration, organized by MarsTV and officially supported by Perfect World, 22 of the best teams in China compete over the next few months with the first season finishing in July, and featuring USD$200,000."
"league_name_4695"	"LootMarket Invitational"
"[english]league_name_4695"	"LootMarket Invitational"
"league_description_4695"	"Oito equipas convidadas competem num formato de dupla eliminação pelo prémio de 3000$."
"[english]league_description_4695"	"8 invited teams competing in a Double-Elimination bracket to claim the 3,000$ prizepool."
"league_name_4704"	"Serie XLG Dota 2 - First Split"
"[english]league_name_4704"	"Serie XLG Dota 2 - First Split"
"league_description_4704"	"A Serie XLG Dota 2 faz parte da XLG (Xtreme League), uma liga de E-Sports independente. Esta liga é uma competição com as melhores equipas de Dota 2 do Brasil."
"[english]league_description_4704"	"The Serie XLG Dota 2 is part of the company XLG (Xtreme League) an independent league of E-Sports. This league is a competition with the top teams in the Brazilian scene."
"league_name_4709"	"ESL India Premiership - 1ª Temporada"
"[english]league_name_4709"	"ESL India Premiership - Season One"
"league_name_4716"	"Global Grand Masters by Prodota.eu"
"[english]league_name_4716"	"Global Grand Masters by Prodota.eu"
"league_description_4716"	"12 equipas irão competir neste evento pelo prémio total de 50.000$. 8 equipas serão convidadas para as eliminatórias fechadas. 4 irão sobreviver e enfrentar as 4 equipas diretamente convidadas."
"[english]league_description_4716"	"12 total teams will fight in this event to claim the $50.000 total prize pool. 8 team will be invited to the closed qualifier 4 will survive and face against the 4 directly invited team."
"league_name_4729"	"Red Bull Heroicks"
"[english]league_name_4729"	"Red Bull Heroicks"
"league_description_4729"	"Estás pronto para um torneio de Dota 2 novo e inovador? Assiste a 4 grandes equipas internacionais e uma equipa alemã amadora a competir entre si num modo de torneio completamente novo e no local mais impressionante na história do Dota 2."
"[english]league_description_4729"	"Are you ready for a new and innovative Dota 2 tournament? Watch four top international teams and a German rookie team battle each other in a complete new tournament mode and at the most impressive venue in Dota 2 history."
"league_name_4753"	"American Star League Invitational "
"[english]league_name_4753"	"American Star League Invitational "
"league_description_4753"	"As melhores equipas da América defrontam-se para decidir qual é a mais forte."
"[english]league_description_4753"	"America top teams, face in the battlefield to see who is the best"
"league_name_4764"	"Eternally Exiled Cup 5 Reborn"
"[english]league_name_4764"	"Eternally Exiled Cup 5 Reborn"
"league_description_4764"	"A Eternally Exiled Cup está de volta para a sua 5ª edição. Equipas profissionais e semiprofissionais da Comunidade dos Estados Independentes vão competir por um prémio."
"[english]league_description_4764"	"Eternally Exiled Cup presents five season. Professional and semi-pro teams from CIS will compete for a total prize pool. "
"league_name_4768"	"The International 2016 - Eliminatórias Abertas"
"[english]league_name_4768"	"The International 2016 Open Qualifiers"
"league_name_4770"	"Bishkek Stars League #5 - PRO SUMMER"
"[english]league_name_4770"	"Bishkek Stars League #5 - PRO SUMMER"
"league_name_4771"	"Adrenalina Tournament - 2ª Temporada"
"[english]league_name_4771"	"Adrenalina Tournament Season 2"
"league_description_4771"	"O torneio consiste em 8 eliminatórias, onde as 16 melhores equipas serão apuradas. As eliminatórias usam o formato de grupos de equipas vencedoras e derrotadas e duram 2 dias. Este torneio conta a participação de equipas do Peru, Argentina, Chile, Equador, Venezuela e Colômbia, tornando este torneio numa competição bastante renhida."
"[english]league_description_4771"	"The tournament consists of 8 qualifying, which brings together the top 16 of these. Qualifiers have the form of winner and loser brackets played in 2 days. In this tournament countries like Peru, Argentina, Chile, Ecuador, Venezuela and Colombia, which makes this tournament competitive participate."
"league_name_4775"	"Dobro Cup - 3ª Temporada"
"[english]league_name_4775"	"Dobro Cup Season 3"
"league_description_4775"	"16 equipas profissionais femininas vão competir pelo prémio total e pelo título de melhor equipa feminina da Dobro Cup."
"[english]league_description_4775"	"16 professional female teams,will fight for prize pool and the title of the best female team for version Dobro Cup"
"league_name_4777"	"VPGame Pro League - 2ª Temporada"
"[english]league_name_4777"	"VPGame Pro League Season 2"
"league_name_4779"	"Northern Arena BEAT Invitational presented by Bell"
"[english]league_name_4779"	"Northern Arena BEAT Invitational presented by Bell"
"league_description_4779"	"Este evento conta com a participação das melhores equipas das Américas em novembro numa competição por mais de 100.000$ em Montreal!"
"[english]league_description_4779"	"Northern Arena Dota 2 BEAT Invitational presented by Bell brings the finest teams from North & South America together in November  to compete for over $100,000 USD in Montreal!"
"league_name_4781"	"LatinCup Summer 2016"
"[english]league_name_4781"	"LatinCup Summer 2016"
"league_description_4781"	"Um torneio exclusivo para a região da América Latina, onde cada país da região será representado pela sua melhor equipa. O formato é semelhante ao da Copa America e o prémio total será de 2500$."
"[english]league_description_4781"	"Enlace Gamer latest project by Pinzak Network investing in the LATAM market brings the LatinCup Summer 2016 an exclusive tournament for the Latin American region where each country will send their best team to represent them in a format similar to the Copa America for a prize pool of $2500.00 USD"
"league_name_4813"	"NEL"
"[english]league_name_4813"	"NEL"
"league_description_4813"	"As equipas mais talentosas da América do Norte competem no formato de liga clássico interno."
"[english]league_description_4813"	"The most talented players in North America compete in the classic inhouse league format."
"league_name_4833"	"Elements Cup 2"
"[english]league_name_4833"	"Elements Cup 2"
"league_name_4836"	"Dota2Baz Summertime Matches"
"[english]league_name_4836"	"Dota2Baz Summertime Matches"
"league_description_4836"	"As melhores equipas de Dota2 do Sudeste Asiático competem na taça Dota2Baz Summertime por prémios em dinheiro e itens."
"[english]league_description_4836"	"Top Dota2 teams from Southeast Asia will challenge themselves in a Dota2Baz Summertime cup for cash and cosmetic prizes. "
"league_name_4837"	"World Cyber Arena 2016 - 3ª Temporada"
"[english]league_name_4837"	"World Cyber Arena 2016 S3"
"league_description_4837"	"A WCA 2016 está de volta com 3 temporadas. Os vencedores de cada temporada irão enfrentar-se por 760.000$ nas finais em LAN de Yinchuan em dezembro."
"[english]league_description_4837"	"WCA 2016 returns with 3 seasons. The winners of each season will meet and compete for $760,000 at the LAN finals in Yinchuan in this December. This League is World Cyber Arena 2016 season 3"
"league_name_4844"	"sCSL Eclipse - 2ª Temporada"
"[english]league_name_4844"	"sCSL Eclipse Season II"
"league_name_4857"	"DBe ANZ League Qualifiers"
"[english]league_name_4857"	"DBe ANZ League Qualifiers"
"league_description_4857"	"A DBeSports está a organizar uma eliminatória para a DBe Dota 2 League. Em jogo está um prémio base de 2500$ e a entrada na DBe Australian & New Zealand Dota 2 League. 8 lugares estão disponíveis para as melhores equipas da Austrália e da Nova Zelândia, e 18 para o público. Este evento contará com prémios no valor de 1000$ todos os meses e será transmitido em streams populares produzidos por Kai Studios."
"[english]league_description_4857"	"DBeSports are hosting a qualifier for the DBe Dota 2 League. $2500 base prize pool up for grabs, and entry into the DBe Australian & New Zealand Dota 2 League. 8 Seeds are available for top ANZ teams and 18 seeds available to the public. The DBe Australian & New Zealand Dota 2 League will offer $1000 in prize pools per month, coverage on Dota 2 match tickers and highly viewed live streams produced by Kai Studios."
"league_name_4862"	"ROG MASTERS 2016"
"[english]league_name_4862"	"ROG MASTERS 2016"
"league_description_4862"	"Um evento asiático de Dota 2 e CS:GO que terá lugar de 12 a 13 de novembro no Kuala Lumpur City Centre, na Malásia, e contará com um prémio total de 200.000$."
"[english]league_description_4862"	"All Asian Dota 2 & CS:Go event on 12-13th of November in Kuala Lumpur City Center, Malaysia with a 200.000 USD prize pool."
"league_name_4875"	"Shanghai Dota2 Open S2"
"[english]league_name_4875"	"Shanghai Dota2 Open S2"
"league_description_4875"	"Nesta liga chinesa, várias equipas vão competir por um prémio de 520.000 yuans."
"[english]league_description_4875"	"SDO planned by the Lanyou Culture of Shanghai , various teams compete with the prize pool of 520 thousand yuan."
"league_name_4891"	"The Battle Fury 2016"
"[english]league_name_4891"	"The Battle Fury 2016"
"league_description_4891"	"As melhores equipas do Peru lutam pelo título de campeão da Battle Fury."
"[english]league_description_4891"	"The best teams from Perú fight for consecrated as the champion of  the Battle Fury "
"league_name_4899"	"WePlay League - 4ª Temporada"
"[english]league_name_4899"	"WePlay League Season 4"
"league_description_4899"	"A WePlay League está de volta para a sua 4ª temporada! Grandes equipas de todo o mundo enfrentam-se por um prémio total de mais de $200.000. As 12 melhores equipas enfrentar-se-ão na final em LAN em Kiev."
"[english]league_description_4899"	"The WePlay League is back with Season 4! Top teams from around the world will compete for a prizepool of more than $200,000. Best 12 teams will travel to the LAN finals in Kiev."
"league_name_4909"	"Persian Gulf Cup - 3ª Temporada"
"[english]league_name_4909"	"Persian Gulf Cup Season 3"
"league_description_4909"	"Este torneio conta com as melhores equipas do Médio Oriente a competir entre si por um prémio total de 12000$."
"[english]league_description_4909"	"The Persian Gulf Cup Season 3 Pits The Best Team From The MEA Region Against Each Other For A Prize Pool Of 12000 $ ."
"league_name_4918"	"MarsTV Dota 2 League 2016"
"[english]league_name_4918"	"MarsTV Dota 2 League 2016"
"league_name_4920"	"Dota 2 Professional League 2016"
"[english]league_name_4920"	"Dota 2 Professional League 2016"
"league_name_4951"	"ASUS ROG DreamLeague - 6ª Temporada"
"[english]league_name_4951"	"ASUS ROG DreamLeague Season 6"
"league_description_4951"	"Oito das melhores equipas ocidentais do mundo lutam por um lugar nos playoffs e pelo prémio de 231.000$!"
"[english]league_description_4951"	"Eight of the best western teams in the world will fight for a spot in the playoffs and for the $231,000 prize pool!"
"league_name_4958"	"Royal Arena"
"[english]league_name_4958"	"Royal Arena"
"league_description_4958"	"Uma grande liga profissional de Dota 2 com prémios de até 100.000$ por evento."
"[english]league_description_4958"	"Major Pro League for Dota 2 with prize pools of up to $100K per event."
"league_name_4972"	"World Electronic Sports Games International"
"[english]league_name_4972"	"World Electronic Sports Games International"
"league_description_4974"	"A KeyTV está a levar os e-sports para um novo nível, trazendo o Dota 2 para um cruzeiro. Quatro equipas vão competir no convés e certamente vai ser uma batalha que nunca viste ser travada."
"[english]league_description_4974"	"KeyTV is bringing Esports to a whole new level, taking the dota2 competition to a cruise ship. 4 teams will compete on the deck and it will be a battle you have never seen."
"league_name_4979"	"Dota Pit League - 5ª Temporada"
"[english]league_name_4979"	"Dota Pit League Season Five"
"league_name_5006"	"DOTA2 ACE Provisional"
"[english]league_name_5006"	"DOTA2 ACE Provisional"
"league_name_5008"	"Polupro Ladder League - 1ª Temporada"
"[english]league_name_5008"	"Polupro ladder league season 1"
"league_name_5018"	"ESL One Genting 2017"
"[english]league_name_5018"	"ESL One Genting 2017"
"league_name_5027"	"Boston Major - Eliminatórias Abertas"
"[english]league_name_5027"	"Boston Major Open Qualifier"
"league_description_5027"	"Vê equipas vindas de todas as partes do mundo a competirem por um lugar no Boston Major 2016."
"[english]league_description_5027"	"Witness teams from all around the world compete for a place at The Boston Major 2016."
"league_name_5039"	"NFCups - 5ª Temporada"
"[english]league_name_5039"	"NFCups Season 5"
"league_description_5039"	"Dezasseis equipas vão competir pelo título de campeões e 5000$."
"[english]league_description_5039"	"Sixteen teams will compete for the first place and 5 000$"
"league_name_5044"	"Dota 2 Night"
"[english]league_name_5044"	"Dota 2 Night"
"league_name_5065"	"AEF Season 1 Qualifiers"
"[english]league_name_5065"	"AEF Season 1 Qualifiers"
"league_description_5065"	"A primeira temporada da Australia Esports Federation (AEF) está aberta a todas as equipas da Austrália, Nova Zelândia e Sudeste Asiático. Todas as equipas jogarão num torneio eliminatório onde as 8 melhores equipas serão determinadas e colocadas na 1ª divisão. O torneio principal será jogado no formato round robin duplo ao longo de 14 semanas. A equipa vencedora ganhará 4000$ AUD, aquela no segundo lugar ganhará 2000$ AUD e a equipa em terceiro ganhará 1000$ AUD."
"[english]league_description_5065"	"The Australia Esports Federation (AEF) Season 1 League is open to all teams from Australia, New Zealand and South East Asian regions. All teams will play a qualifying tournament where the best 8 teams will be determined and placed into Division 1. The main tournament will be played in a double round robin format over a 14 week period with the winning team receiving $4000 AUD, second receiving $2000 AUD and third receiving $1000 AUD."
"league_name_5077"	"SL i-League StarSeries - 3ª Temporada"
"[english]league_name_5077"	"SL i-League StarSeries S3"
"league_name_5103"	"BEYOND GODLIKE LEAGUE"
"[english]league_name_5103"	"BEYOND GODLIKE LEAGUE"
"league_name_5115"	"World Cyber Arena 2016 Grande Final"
"[english]league_name_5115"	"World Cyber Arena 2016 Grand Finals"
"league_name_5125"	"AEF - 1ª Temporada"
"[english]league_name_5125"	"AEF Season 1"
"league_description_5125"	"A primeira temporada da Australia Esports Federation (AEF) está aberta a todas as equipas da Austrália, Nova Zelândia e Sudeste Asiático. Todas as equipas jogarão num torneio eliminatório onde as 8 melhores equipas serão determinadas e colocadas na 1ª divisão. O torneio principal será jogado no formato round robin duplo ao longo de 14 semanas. A equipa vencedora ganhará 4000$ AUD, aquela no segundo lugar ganhará 2000$ AUD e a equipa em terceiro ganhará 1000$ AUD."
"[english]league_description_5125"	"The Australia Esports Federation (AEF) Season 1 League is open to all teams from Australia, New Zealand and South East Asian regions. All teams will play a qualifying tournament where the best 8 teams will be determined and placed into Division 1. The main tournament will be played in a double round robin format over a 14 week period with the winning team receiving $4000 AUD, second receiving $2000 AUD and third receiving $1000 AUD."
"league_name_5157"	"Kiev Major"
"[english]league_name_5157"	"Kiev Major"
"league_description_5157"	"Kiev Major"
"[english]league_description_5157"	"Kiev Major"
"league_name_5175"	"The Final Match 2017"
"[english]league_name_5175"	"The Final Match 2017"
"league_name_5187"	"GosuLatam Tournament"
"[english]league_name_5187"	"GosuLatam Tournament"
"league_description_5187"	"O Gosulatam é um torneio no formato de eliminação única para oito equipas promissoras da América Latina."
"[english]league_description_5187"	"Gosulatam is a single elimination tournament for eight up-and-coming LATAM  teams"
"league_name_5196"	"Dota 2 BEAT Invitational - 8ª Temporada"
"[english]league_name_5196"	"Dota 2 BEAT Invitational Season 8"
"league_name_5197"	"Dota 2 Asia Championships 2017"
"[english]league_name_5197"	"Dota 2 Asia Championships 2017"
"league_name_5227"	"ProDotA Cup by Azubu"
"[english]league_name_5227"	"ProDotA Cup by Azubu"
"league_description_5227"	"Um campeonato mensal em que equipas de 2ª categoria de duas regiões diferentes competem pelo título e pelo prémio total de 5000$ por região."
"[english]league_description_5227"	"A monthly Cup for tier 2 teams by two regions to fight for the title and the 5.000$ prize pool for each region."
"league_name_5233"	"Dota 2 The Open Tournament "
"[english]league_name_5233"	"Dota 2 The Open Tournament "
"league_name_5270"	"CZ-SK Dota 2 League - 9ª Temporada"
"[english]league_name_5270"	"CZ-SK Dota 2 League Season 9"
"league_description_5270"	"A nona temporada desta liga checoslovaca decorrerá durante dois meses. A equipa vencedora levará para casa um prémio em dinheiro!"
"[english]league_description_5270"	"The ninth season of Czech-Slovakia league will take place over a two months period. The winner will receive prize money upon victory!"
"league_name_5313"	"Masters Manila 2017"
"[english]league_name_5313"	"Masters Manila 2017"
"league_name_5329"	"Radiance Dota 2 - 2017"
"[english]league_name_5329"	"Radiance Dota 2 -2017"
"league_description_5329"	"Zon@ Cybers volta este ano com o Radiance Dota 2, em que 24 equipas competem entre si em Quito, no Equador."
"[english]league_description_5329"	"Zon@ Cybers returns to this 2017 with Radiance Dota 2, participate in which 24 teams with end face to face Ecuador in Quito."
"league_name_5336"	"DreamLeague - 7ª Temporada"
"[english]league_name_5336"	"DreamLeague season 7"
"league_name_5340"	"SEA vs AUS Invitational"
"[english]league_name_5340"	"SEA vs AUS Invitational"
"league_description_5340"	"O SEA vs AUS Invitational é um torneio transregional em que as melhores equipas do Sudeste Asiático competem contra as melhores equipas da Austrália. As 4 melhores equipas das regiões são convidadas a competir neste torneio de eliminação única durante 2 dias pelo prémio total de 5000$. Na primeira ronda, cada partida contará com uma equipa do Sudeste Asiático a jogar contra uma equipa australiana. As partidas serão jogadas no formato melhor de 3, exceto a da final que será no formato melhor de 5. Se uma equipa do Sudeste Asiático jogar contra uma equipa australiana, então cada equipa terá a oportunidade de escolher o servidor, sendo a partida decisiva jogada em servidores do Sudeste Asiático."
"[english]league_description_5340"	"The SEA vs AUS Invitational is a cross-regional tournament that allows the top teams from SEA to complete against the top teams of Australia. The 4 best teams from each of the regions are invited to participate in this single elimination tournament held over 2 days with a total prize pool of $5000. In the first round, all matches will be a SEA team facing off against an Australian team. Matches are played in a best of 3 format with the final played in a best of 5. If a SEA team is playing against an Australian team, then each team will have the opportunity to choose the server, with the deciding match played on the SEA servers."
"league_name_5353"	"EPICENTER: Moscow - 2ª Temporada"
"[english]league_name_5353"	"EPICENTER: Moscow Season 2"
"league_name_5358"	"CONQUERORS INSIGNIA MINI (Season 1) Online qualifiers"
"[english]league_name_5358"	"CONQUERORS INSIGNIA MINI (Season 1) Online qualifiers"
"league_name_5364"	"SL i-League Invitational - 2ª Temporada"
"[english]league_name_5364"	"SL i-League Invitational Season 2"
"league_name_5375"	"Spring Cup"
"[english]league_name_5375"	"Spring Cup"
"league_name_5388"	"KOD League 2017"
"[english]league_name_5388"	"KOD League 2017"
"league_description_5388"	"O Kings of Dota é uma liga profissional na América."
"[english]league_description_5388"	"Kings of Dota is a professional league in America."
"league_name_5392"	"Niu League 2017 - 2ª Temporada"
"[english]league_name_5392"	"Niu League 2017 Season 2"
"league_name_5396"	"Zotac Cup Masters"
"[english]league_name_5396"	"Zotac Cup Masters"
"league_description_5396"	"O ZOTAC CUP MASTERS é um grande evento onde apenas as melhores equipas profissionais usam toda a sua perícia para chegar ao topo, perante espectadores de todo o mundo. Um torneio aberto a qualquer um corajoso o suficiente para dar tudo por tudo, onde as equipas competem através de uma série de eliminatórias até ao evento principal ao vivo onde as melhores equipas se defrontarão."
"[english]league_description_5396"	"The ZOTAC CUP MASTERS is a grand stage where only the best pro teams push their limits in skill to rise to the top all while the world watches. Open to any to take the challenge and show to all that they have what it takes to be one of the best, teams battle to rise to the top through a series of ZOTAC CUP qualifiers building up to a ZOTAC CUP MASTERS live event where the best meet best."
"league_name_5399"	"NESO 4th National E-Sports ShenZhen Open Tournament- Galaxy Battles"
"[english]league_name_5399"	"NESO 4th National E-Sports ShenZhen Open Tournament- Galaxy Battles"
"league_name_5401"	"The International 2017"
"[english]league_name_5401"	"The International 2017"
"league_description_5401"	"http://www.dota2.com/international/"
"[english]league_description_5401"	"http://www.dota2.com/international/"
"league_name_5407"	"ESL India Premiership - 2017 Edition"
"[english]league_name_5407"	"ESL India Premiership - 2017 Edition"
"league_name_5418"	"WCA Tournament Platform Classic"
"[english]league_name_5418"	"WCA Tournament Platform Classic"
"league_description_5418"	"A WCA 2017 está de volta com 3 temporadas. Os vencedores de cada temporada irão enfrentar-se por 760.000$ nas finais em LAN de Yinchuan neste dezembro. Esta é a grande final da World Cyber Arena 2017."
"[english]league_description_5418"	"WCA 2017 returns . WCA Tournament Platform Classic winners of  will meet and compete for $760,000 at the LAN finals in Yinchuan in this December. This League is World Cyber Arena 2017 Grand Finals"
"league_name_5434"	"Blood In The Streets (BITS)"
"[english]league_name_5434"	"Blood In The Streets (BITS)"
"league_name_5462"	"Niu League 2017 - 3ª Temporada"
"[english]league_name_5462"	"Niu League 2017 Season 3"
"league_name_5466"	"LNEe-WCA America 2017"
"[english]league_name_5466"	"LNEe-WCA America 2017"
"league_description_5466"	"A LNEe e a WCA apresentam uma nova temporada do torneio americano LNEe-WCA America 2017. Assiste ao torneio e apoia as tuas equipas favoritas enquanto competem pelo prémio total de 50.500$. Além disso, as equipas campeãs da América do Norte/Central e da América do Sul serão apuradas para competir na final internacional da WCA 2017, na China."
"[english]league_description_5466"	"LNEe and WCA present a new season of the American tournament LNEe-WCA América 2017. Watch us and support your favourite teams fight fot 50,500 USD prize pool and the first places of North (Central) and South America go to China compete in WCA 2017 International Finals."
"league_name_5481"	"CZ-SK Dota 2 League - 10ª Temporada"
"[english]league_name_5481"	"CZ-SK Dota 2 League Season 10"
"league_description_5481"	"A décima temporada desta liga checoslovaca decorrerá durante dois meses. A equipa vencedora levará para casa um prémio em dinheiro!"
"[english]league_description_5481"	"The tenth season of Czech-Slovakia league will take place over a two months period. The winner will receive prize money upon victory!"
"league_name_5485"	"ROG MASTERS 2017 Open Qualifier Thailand"
"[english]league_name_5485"	"ROG MASTERS 2017 Open Qualifier Thailand"
"league_name_5491"	"AEF - 2ª Temporada"
"[english]league_name_5491"	"AEF Season 2"
"league_description_5491"	"A segunda temporada da Australia Esports Federation (AEF) está disponível para todas as equipas da Austrália, Nova Zelândia e regiões do Sudeste Asiático. A primeira divisão é constituída de 7 equipas a jogar no formato todos contra todos, ao longo de 6 semanas. A equipa vencedora irá ganhar 2000$ AUD, a que estiver em segundo lugar irá ganhar 1000$ AUD e a que estiver em terceiro 500$ AUD."
"[english]league_description_5491"	"The Australia Esports Federation (AEF) Season 2 League is open to all teams from Australia, New Zealand and South East Asian regions. Division 1 consists of 7 teams played in a round robin format over 6 weeks. The winning team will receive $2000 AUD, second receiving $1000 AUD and third receiving $500 AUD."
"league_name_5492"	"Faceit League B"
"[english]league_name_5492"	"Faceit League B"
"league_description_5492"	"A segunda parte da famosa Faceit League!"
"[english]league_description_5492"	"The second part of famous faceit league!"
"league_name_5504"	"2017 Mars Dota 2 League"
"[english]league_name_5504"	"2017 Mars Dota 2 League"
"league_description_5504"	"A Mars Dota 2 League (MDL) de 2017 está de volta na sua quinta edição e conta com um prémio total de 250.000$. Oito das melhores equipas do mundo vão encontrar-se no Optics Valley International Tennis Center in Wuhan, na China, de 5 a 9 de julho. Esta será a última oportunidade para estas equipas aperfeiçoarem as suas estratégias antes do International."
"[english]league_description_5504"	"The 2017 Mars Dota 2 League (MDL) returns with its fifth edition featuring USD$250,000 in prize-money. Eight of the finest teams in the world will meet at the Optics Valley International Tennis Center in Wuhan, China from July 5 to 9. This will be the last chance for these teams to perfect their strategies before The International."
"league_name_5507"	"V Asian Indoor & Martial Arts Games National Qualifications"
"[english]league_name_5507"	"V Asian Indoor & Martial Arts Games National Qualifications"
"league_description_5507"	"Eliminatórias turquemenistanesas do evento V Asian Indoor & Martial Arts Games."
"[english]league_description_5507"	"V Asian Indoor & Martial Arts Games Turkmen National Qualifications. "
"league_name_5512"	"World Eletronic Sports Games"
"[english]league_name_5512"	"World Eletronic Sports Games"
"league_description_5522"	"A WCA 2017 está de volta. As equipas vencedoras das eliminatórias das Américas da WCA 2017 vão competir por 760.000$ nas finais em LAN em Yinchuan neste mês de dezembro. Esta liga é a Grande Final da World Cyber Arena 2017."
"[english]league_description_5522"	"WCA 2017 returns . WCA 2017 America Qualifiers winners will meet and compete for $760,000 at the LAN finals in Yinchuan in this December. This League is World Cyber Arena 2017 Grand Finals"
"league_name_5562"	"ProDotA Cup Series"
"[english]league_name_5562"	"ProDotA Cup Series"
"league_description_5562"	"O ProDotA traz campeonatos mensais para as melhores equipas de 2ª categoria das regiões da Europa, Sudeste Asiático e EUA. As equipas irão jogar no formato de eliminação dupla numa competição cheia de ação. Compra o bilhete para apoiares a tua equipa favorita."
"[english]league_description_5562"	"ProDotA brings you monthly tier 2 cups with the best teams from EU and SEA/US regions. Teams playing double elimination bracket so you can see more DotA action. Support your favourite by purchasing our ticket"
"league_name_5572"	"World Electronic Sports Games 2017"
"[english]league_name_5572"	"World Electronic Sports Games 2017"
"league_name_5579"	"SL i-League Invitational - 3ª Temporada"
"[english]league_name_5579"	"SL i-League Invitational Season 3"
"league_name_5582"	"World Cyber Arena 2017 China Qualifiers"
"[english]league_name_5582"	"World Cyber Arena 2017 China Qualifiers"
"league_name_5609"	"ESL One Hamburg 2017"
"[english]league_name_5609"	"ESL One Hamburg 2017"
"league_name_5614"	"FACEIT Pro League (FPL)"
"[english]league_name_5614"	"FACEIT Pro League (FPL)"
"league_name_5616"	"PGL DOTA2 OPEN"
"[english]league_name_5616"	"PGL DOTA2 OPEN"
"league_description_5616"	"O PGL DOTA2 OPEN em Bucareste conta com a participação de 8 equipas: os EG e os LGD são as equipas convidadas, enquanto que as outras 6 equipas provêm de eliminatórias regionais."
"[english]league_description_5616"	"PGL DOTA2 OPEN Bucharest. 8 participating teams . EG and LGD as invited teams, plus 6 teams from regional qualifiers."
"league_name_5627"	"DreamLeague - 8ª Temporada"
"[english]league_name_5627"	"DreamLeague season 8"
"league_description_5627"	"É com orgulho que a DreamHack apresenta a 8ª temporada da DreamLeague, um Major de Dota 2, que terá lugar de setembro a dezembro, sendo os playoffs jogados de 1 a 3 de dezembro, na DreamHack Winter 2017."
"[english]league_description_5627"	"DreamHack is very proud to present DreamLeague season 7, a Dota 2 major. Played September-December with playoffs on December 1-3 at DreamHack Winter 2017."
"league_name_5637"	"Perfect World Masters"
"[english]league_name_5637"	"Perfect World Masters"
"league_name_5638"	"Asus ROG Masters 2017"
"[english]league_name_5638"	"Asus ROG Masters 2017"
"league_description_5638"	"Neste ano, de junho a novembro, desenrola-se um novo e épico capítulo da jornada da ROG MASTERS. Em 2017, o torneio intercontinental irá abranger mais de 30 países, talentos de alto nível e célebres equipas profissionais de CS:GO e Dota 2. As melhores equipas vão partilhar o grande prémio entre si: 250.000$ para cada título."
"[english]league_description_5638"	"This year, from June through November, a new and epic chapter in the ROG MASTERS journey plays out. In 2017 the cross-continent tournament will encompass more than 30 countries, bringing top-tier talent and renowned pro squads in CS:GO and Dota 2. The best teams will split the grand prize pool between them - $250,000 for each title."
"league_name_5688"	"Captains Draft 4.0 Minor"
"[english]league_name_5688"	"Captains Draft 4.0 Minor"
"league_name_5690"	"AMD SAPPHIRE Dota PIT"
"[english]league_name_5690"	"AMD SAPPHIRE Dota PIT"
"league_name_5850"	"Dota Summit 8"
"[english]league_name_5850"	"Dota Summit 8"
"league_description_5850"	"Dota Summit 8 by Beyond the Summit"
"[english]league_description_5850"	"Dota Summit 8 by Beyond the Summit"
"league_name_8055"	"Galaxy Battles: Emerging Worlds"
"[english]league_name_8055"	"Galaxy Battles: Emerging Worlds"
"league_description_8055"	"Galaxy Battles: Emerging Worlds será o primeiro Major de 2018, que terá lugar no Sudeste Asiático na capital das Filipinas, Manila. O coração do Dota 2 no Sudeste Asiático junta 16 das melhores equipas do mundo, que irão competir pelo prémio de 1.000.000$ e 1500 pontos classificatórios."
"[english]league_description_8055"	"Galaxy Battles: Emerging Worlds will be the first Major of 2018, held in South East Asia at the Capital of Philippines, Manila. The heart of Dota 2 in South East Asia, bringing together 16 of the best teams in the world, competing for a prize pool of USD1,000,000 and 1500 Qualifying Points."
"league_name_8093"	"ESL One Genting 2018"
"[english]league_name_8093"	"ESL One Genting 2018"
"league_name_9579"	"SL i-League Invitational - 4ª Temporada"
"[english]league_name_9579"	"SL i-League Invitational Season 4"
"league_description_9579"	"A StarLadder e a ImbaTV juntam-se mais uma vez para outra competição internacional. Contando com equipas de topo, pontos classificatórios preciosos e um prémio total de 300.000$, a 4ª temporada do SL i-League Dota 2 Invitational é imperdível. As partidas começam no dia 18 de dezembro."
"[english]league_description_9579"	"StarLadder and ImbaTV partner once more for yet another international competition. Featuring top flight teams, precious Qualifying Points and a $300,000 prizepool, the SL i-League Dota 2 Invitational S4 is not to be missed. Matches begin on December 18th."
"league_description_9598"	"A liga de Dota 2 global para toda a gente. Inclui a maioria das partidas da 1ª e 2ª divisões semiprofissionais e algumas partidas das divisões amadoras."
"[english]league_description_9598"	"The global Dota 2 league for everyone. This includes most matches from the semi-pro divisions 1 and 2, and some matches from the amateur divisions."
"league_name_9601"	"EPICENTER XL"
"[english]league_name_9601"	"EPICENTER XL"
"league_description_9601"	"Em maio de 2018, Moscovo vai acolher o maior evento de Dota 2 na Europa de Leste, com um prémio total de 1 milhão de dólares."
"[english]league_description_9601"	"Moscow will host the largest Dota2 event in Eastern Europe with $1 000 000 prize pool in May 2018."
"league_name_9633"	"ESL One Katowice 2018 powered by Intel"
"[english]league_name_9633"	"ESL One Katowice 2018 powered by Intel"
"league_description_9633"	"Assiste a partidas de Dota 2 de primeira classe no primeiro Major de Dota 2 realizado na Polónia e organizado pela ESL! Junta-te a nós em Katowice e vê as melhores equipas do mundo a competir por prestígio, pontos e prémios em dinheiro!"
"[english]league_description_9633"	"Experience world class Dota 2 when ESL brings a Dota2 Major to Poland for the first time! Join us in Katowice and witness the best teams in the world competing for prestige, points and prizemoney!"
"league_name_9643"	"Dota 2 Asia Championships 2018"
"[english]league_name_9643"	"Dota2 Asia Championships 2018"
"league_name_9662"	"GESC: Indonesia"
"[english]league_name_9662"	"GESC: Indonesia"
"league_name_9663"	"GESC: Thailand"
"[english]league_name_9663"	"GESC: Thailand"
"league_description_9675"	"A liga de Dota 2 da AEF está de volta para a sua 4ª temporada! 24 equipas em 3 divisões competem por uma parte do prémio total de 4850 dólares australianos! E pela primeira vez na liga, esta temporada conta com a participação das 4 melhores equipas da 1ª divisão numa final em LAN em Melbourne, assim como a produção de Lycon Studios!"
"[english]league_description_9675"	"The 4th Season of AEF\\'s Dota 2 League returns! 24 teams over 3 Divisions battle it out for a share of a AUD4850 prize pool! Brand new features this Season include a Lan final in Melbourne for the top 4 teams of Division 1, as well as production by Lycon Studios!"
"league_name_9683"	"Corsair DreamLeague - 9ª Temporada"
"[english]league_name_9683"	"Corsair DreamLeague season 9"
"league_description_9683"	"É com orgulho que a DreamHack apresenta a 9ª temporada da Corsair DreamLeague, um Minor de Dota 2, que terá lugar de fevereiro a março de 2018, sendo os playoffs jogados no fim de março em Estocolmo."
"[english]league_description_9683"	"DreamHack is very proud to present Corsair DreamLeague season 9, a Dota 2 minor. Played February-March with playoffs in late March in Stockholm."
"league_name_9807"	"ESL Brasil Premier League"
"[english]league_name_9807"	"ESL Brasil Premier League"
"league_description_9836"	"A liga de Dota 2 global para toda a gente. Inclui a maioria das partidas da 1ª e 2ª divisões semiprofissionais e algumas partidas das divisões amadoras."
"[english]league_description_9836"	"The global Dota 2 league for everyone. This includes most matches from the semi-pro divisions 1 and 2, and some matches from the amateur divisions."
"league_name_9862"	"MDL Changsha"
"[english]league_name_9862"	"MDL Changsha "
"league_description_9862"	"A MDL Changsha vai contar com 12 equipas de topo a competir na China por glória e um grande prémio em dinheiro."
"[english]league_description_9862"	"MDL Changsha will see 12 top teams battle for glory and a big slice of prize money in China."
"league_name_9870"	"The International 2018"
"[english]league_name_9870"	"The International 2018"
"league_name_9880"	"ESL One Birmingham 2018 powered by Intel"
"[english]league_name_9880"	"ESL One Birmingham 2018 powered by Intel"
"league_description_9880"	"A ESL traz o primeiro Major de Dota 2 para o Reino Unido! Birmingham vai ser o campo de batalha onde 12 equipas de renome global vão competir por pontos do Dota Pro Circuit e um prémio em dinheiro no valor de 1.000.000$."
"[english]league_description_9880"	"ESL brings the first Dota 2 Major to the UK! Birmingham is the battleground for 12 world class teams competing for Dota Pro Circuit points and $1,000,000 in prizemoney."
"league_name_9908"	"StarLadder ImbaTV Invitational - 5ª Temporada"
"[english]league_name_9908"	"StarLadder ImbaTV Invitational Season 5"
"league_description_9908"	"A StarLadder e a ImbaTV juntam-se mais uma vez para outra competição internacional, contando com equipas de topo, pontos classificatórios preciosos e um prémio total de 300.000$. As partidas começam no dia 12 de abril."
"[english]league_description_9908"	"StarLadder and ImbaTV partner once more for yet another international competition. Featuring top flight teams, precious Qualifying Points and a $300,000 prizepool. Matches begin on April 12th."
"league_name_9943"	"CHINA DOTA2 SUPER MAJOR"
"[english]league_name_9943"	"CHINA DOTA2 SUPER MAJOR"
"league_description_9943"	"O China Dota 2 Super Major, organizado por Perfect World e PGL, é o último evento do Dota Pro Circuit de 2017-2018. Sendo o torneio com mais pontos classificatórios até agora, este será sem dúvida o campo de batalha mais fervoroso para todas as equipas."
"[english]league_description_9943"	"China Dota 2 Super Major, organised by Perfect World and PGL, is the last event of the 2017-2018 Dota Pro Circuit. Featured with the highest Qualifying Points, the tournament is without doubt the most fierce battleground for all teams."
"league_name_9959"	"World Cyber Arena 2017-18 - Grande Final"
"[english]league_name_9959"	"World Cyber Arena 2017-18 Grand Finals"
"league_name_9972"	"Dota 2 Indonesia Professional"
"[english]league_name_9972"	"Dota 2 Indonesia Professional"
"league_name_9979"	"Push Dota Esport"
"[english]league_name_9979"	"Push Dota Esport"
"league_name_10003"	"Alpha Wolf Arena"
"[english]league_name_10003"	"Alpha wolf arena"
"league_description_10003"	"Alpha Wolf Arena"
"[english]league_description_10003"	"Alpha wolf arena"
"league_name_10048"	"TNeSF Cup"
"[english]league_name_10048"	"TNeSF Cup"
"league_name_10049"	"The International 2018 - Eliminatórias Abertas"
"[english]league_name_10049"	"The International 2018 Open Qualifiers"
"league_name_10087"	"Copa MasGamers"
"[english]league_name_10087"	"Copa MasGamers"
"league_name_65018"	"GameLadders Dota 2 League"
"[english]league_name_65018"	"GameLadders DOTA 2 League "
"league_name_65019"	"BanglaGamer Dota 2 Championship"
"[english]league_name_65019"	"BanglaGamer Dota 2 Championship"
}
