"lang"
{
"Language"	"czech"
"Tokens"
{
"#DOTA_RP_INIT"	"Hlavní nabídka"
"#DOTA_RP_IDLE"	"Hlavní nabídka (nečinný)"
"#DOTA_RP_WAIT_FOR_PLAYERS_TO_LOAD"	"{%param0%}: Čeká na ostatní hráče"
"#DOTA_RP_COACHING"	"{%param0%} (jako trenér)"
"#DOTA_RP_HERO_SELECTION"	"{%param0%}: Výběr hrdiny"
"#DOTA_RP_STRATEGY_TIME"	"{%param0%}: Strategický čas"
"#DOTA_RP_WAIT_FOR_MAP_TO_LOAD"	"{%param0%}: Čeká na načtení hry"
"#DOTA_RP_PRE_GAME"	"{%param0%}: Předehra"
"#DOTA_RP_GAME_IN_PROGRESS"	"{%param0%}: Ve hře"
"#DOTA_RP_GAME_IN_PROGRESS_CUSTOM"	"Hraje %param0%"
"#DOTA_RP_GAME_IN_PROGRESS_CUSTOM_UNNAMED"	"Hraje uživatelský mód"
"#DOTA_RP_LOBBY_CUSTOM"	"V lobby módu %param0%"
"#DOTA_RP_LOBBY_CUSTOM_UNNAMED"	"Lobby uživatelského módu"
"#DOTA_RP_PLAYING_AS"	"{%param0%}: {%param2%} (%param1%. úroveň)"
"#DOTA_RP_POST_GAME"	"{%param0%}: Dohra bitvy"
"#DOTA_RP_DISCONNECT"	"{%param0%}: Odpojuje se"
"#DOTA_RP_SPECTATING"	"Sleduje hru"
"#DOTA_RP_CASTING"	"Komentuje hru"
"#DOTA_RP_PRIVATE_LOBBY"	"Soukromé lobby"
"#DOTA_RP_LEAGUE_MATCH"	"Hraje na turnaji"
"#DOTA_RP_LEAGUE_MATCH_PLAYING_AS"	"{%param0%}: {%param1%} (turnaj)"
"#DOTA_RP_WATCHING_REPLAY"	"Sleduje záznam"
"#DOTA_RP_WATCHING_TOURNAMENT"	"Sleduje turnajový zápas"
"#DOTA_RP_WATCHING_TOURNAMENT_REPLAY"	"Sleduje záznam turnaje"
"#DOTA_RP_FINDING_MATCH"	"Vyhledává zápas"
"#DOTA_RP_FINDING_YEAR_BEAST_BRAWL"	"Vyhledává Bitvu bestií"
"#DOTA_RP_FINDING_EVENT_MATCH"	"Vyhledává zápas {%param0%}"
"#DOTA_RP_UNKNOWN_EVENT_GAME"	"Speciální událost"
"#DOTA_RP_SPECTATING_WHILE_FINDING"	"Vyhledává zápas a sleduje hru"
"#DOTA_RP_PENDING"	"Nevyřízená žádost o přátelství"
"#DOTA_RP_ONLINE"	"Online"
"#DOTA_RP_BUSY"	"Zaneprázdněn"
"#DOTA_RP_AWAY"	"Nepřítomen"
"#DOTA_RP_SNOOZE"	"Neaktivní"
"#DOTA_RP_LOOKING_TO_TRADE"	"Chce obchodovat"
"#DOTA_RP_LOOKING_TO_PLAY"	"Chce hrát"
"#DOTA_RP_PLAYING_OTHER"	"Hraje jinou hru"
"#DOTA_RP_ACCOUNT_DISABLED"	"Vyhledávání zápasů bylo dočasně zakázáno"
"#DOTA_RP_QUEST"	"Na tréninkové misi"
"#DOTA_RP_BOTPRACTICE"	"Hraje proti botům"
"#DOTA_RP_COOPBOT"	"Kooperace s boty"
"#DOTA_RP_TRAINING"	"Na tréninkové misi"
"#DOTA_RP_OPEN_SOLO"	"Hledá otevřené skupiny"
"#DOTA_RP_OPEN_PARTY"	"Hledá členy pro svoji skupinu"
"#DOTA_RP_PLAYING_DOTA_S1"	"Hraje hru Dota 2"
"#custom_game_mode_status"	"Hraje vlastní hru"
"#npc_dota_hero_none"	"––"
"#npc_dota_hero_queenofpain"	"Queen of Pain"
"#npc_dota_hero_antimage"	"Anti-Mage"
"#npc_dota_hero_kunkka"	"Kunkka"
"#npc_dota_hero_lina"	"Lina"
"#npc_dota_hero_mirana"	"Mirana"
"#npc_dota_hero_slardar"	"Slardar"
"#npc_dota_hero_lion"	"Lion"
"#npc_dota_hero_phantom_assassin"	"Phantom Assassin"
"#npc_dota_hero_tidehunter"	"Tidehunter"
"#npc_dota_hero_witch_doctor"	"Witch Doctor"
"#npc_dota_hero_vengefulspirit"	"Vengeful Spirit"
"#npc_dota_hero_juggernaut"	"Juggernaut"
"#npc_dota_hero_earthshaker"	"Earthshaker"
"#npc_dota_hero_pudge"	"Pudge"
"#npc_dota_hero_bane"	"Bane"
"#npc_dota_hero_crystal_maiden"	"Crystal Maiden"
"#npc_dota_hero_sven"	"Sven"
"#npc_dota_hero_skeleton_king"	"Wraith King"
"#npc_dota_hero_storm_spirit"	"Storm Spirit"
"#npc_dota_hero_sand_king"	"Sand King"
"#npc_dota_hero_nevermore"	"Shadow Fiend"
"#npc_dota_hero_drow_ranger"	"Drow Ranger"
"#npc_dota_hero_axe"	"Axe"
"#npc_dota_hero_bloodseeker"	"Bloodseeker"
"#npc_dota_hero_phantom_lancer"	"Phantom Lancer"
"#npc_dota_hero_razor"	"Razor"
"#npc_dota_hero_morphling"	"Morphling"
"#npc_dota_hero_zuus"	"Zeus"
"#npc_dota_hero_tiny"	"Tiny"
"#npc_dota_hero_puck"	"Puck"
"#npc_dota_hero_windrunner"	"Windranger"
"#npc_dota_hero_lich"	"Lich"
"#npc_dota_hero_shadow_shaman"	"Shadow Shaman"
"#npc_dota_hero_riki"	"Riki"
"#npc_dota_hero_enigma"	"Enigma"
"#npc_dota_hero_tinker"	"Tinker"
"#npc_dota_hero_sniper"	"Sniper"
"#npc_dota_hero_necrolyte"	"Necrophos"
"#npc_dota_hero_warlock"	"Warlock"
"#npc_dota_hero_beastmaster"	"Beastmaster"
"#npc_dota_hero_venomancer"	"Venomancer"
"#npc_dota_hero_faceless_void"	"Faceless Void"
"#npc_dota_hero_death_prophet"	"Death Prophet"
"#npc_dota_hero_pugna"	"Pugna"
"#npc_dota_hero_templar_assassin"	"Templar Assassin"
"#npc_dota_hero_viper"	"Viper"
"#npc_dota_hero_luna"	"Luna"
"#npc_dota_hero_dragon_knight"	"Dragon Knight"
"#npc_dota_hero_dazzle"	"Dazzle"
"#npc_dota_hero_rattletrap"	"Clockwerk"
"#npc_dota_hero_leshrac"	"Leshrac"
"#npc_dota_hero_furion"	"Nature's Prophet"
"#npc_dota_hero_life_stealer"	"Lifestealer"
"#npc_dota_hero_dark_seer"	"Dark Seer"
"#npc_dota_hero_clinkz"	"Clinkz"
"#npc_dota_hero_omniknight"	"Omniknight"
"#npc_dota_hero_enchantress"	"Enchantress"
"#npc_dota_hero_huskar"	"Huskar"
"#npc_dota_hero_night_stalker"	"Night Stalker"
"#npc_dota_hero_broodmother"	"Broodmother"
"#npc_dota_hero_bounty_hunter"	"Bounty Hunter"
"#npc_dota_hero_weaver"	"Weaver"
"#npc_dota_hero_jakiro"	"Jakiro"
"#npc_dota_hero_batrider"	"Batrider"
"#npc_dota_hero_chen"	"Chen"
"#npc_dota_hero_spectre"	"Spectre"
"#npc_dota_hero_doom_bringer"	"Doom"
"#npc_dota_hero_ancient_apparition"	"Ancient Apparition"
"#npc_dota_hero_ursa"	"Ursa"
"#npc_dota_hero_spirit_breaker"	"Spirit Breaker"
"#npc_dota_hero_gyrocopter"	"Gyrocopter"
"#npc_dota_hero_alchemist"	"Alchemist"
"#npc_dota_hero_invoker"	"Invoker"
"#npc_dota_hero_silencer"	"Silencer"
"#npc_dota_hero_obsidian_destroyer"	"Outworld Devourer"
"#npc_dota_hero_lycan"	"Lycan"
"#npc_dota_hero_brewmaster"	"Brewmaster"
"#npc_dota_hero_shadow_demon"	"Shadow Demon"
"#npc_dota_hero_lone_druid"	"Lone Druid"
"#npc_dota_hero_chaos_knight"	"Chaos Knight"
"#npc_dota_hero_treant"	"Treant Protector"
"#npc_dota_hero_meepo"	"Meepo"
"#npc_dota_hero_ogre_magi"	"Ogre Magi"
"#npc_dota_hero_undying"	"Undying"
"#npc_dota_hero_rubick"	"Rubick"
"#npc_dota_hero_disruptor"	"Disruptor"
"#npc_dota_hero_nyx_assassin"	"Nyx Assassin"
"#npc_dota_hero_naga_siren"	"Naga Siren"
"#npc_dota_hero_keeper_of_the_light"	"Keeper of the Light"
"#npc_dota_hero_visage"	"Visage"
"#npc_dota_hero_wisp"	"Io"
"#npc_dota_hero_slark"	"Slark"
"#npc_dota_hero_medusa"	"Medusa"
"#npc_dota_hero_troll_warlord"	"Troll Warlord"
"#npc_dota_hero_centaur"	"Centaur Warrunner"
"#npc_dota_hero_magnataur"	"Magnus"
"#npc_dota_hero_shredder"	"Timbersaw"
"#npc_dota_hero_bristleback"	"Bristleback"
"#npc_dota_hero_tusk"	"Tusk"
"#npc_dota_hero_skywrath_mage"	"Skywrath Mage"
"#npc_dota_hero_abaddon"	"Abaddon"
"#npc_dota_hero_elder_titan"	"Elder Titan"
"#npc_dota_hero_legion_commander"	"Legion Commander"
"#npc_dota_hero_ember_spirit"	"Ember Spirit"
"#npc_dota_hero_earth_spirit"	"Earth Spirit"
"#npc_dota_hero_abyssal_underlord"	"Underlord"
"#npc_dota_hero_phoenix"	"Phoenix"
"#npc_dota_hero_terrorblade"	"Terrorblade"
"#npc_dota_hero_oracle"	"Oracle"
"#npc_dota_hero_techies"	"Techies"
"#npc_dota_hero_target_dummy"	"Cvičný terč"
"#npc_dota_hero_winter_wyvern"	"Winter Wyvern"
"#npc_dota_hero_arc_warden"	"Arc Warden"
"#npc_dota_hero_monkey_king"	"Monkey King"
"#npc_dota_hero_pangolier"	"Pangolier"
"#npc_dota_hero_dark_willow"	"Dark Willow"
"#DOTA_lobby_type_name_lobby"	"Lobby"
"#DOTA_lobby_type_name_unranked"	"Nehodnocený"
"#DOTA_lobby_type_name_ranked"	"Hodnocený"
"#DOTA_lobby_type_name_bot_match"	"Zápas s boty"
"#DOTA_lobby_type_name_spectator"	"Divák"
"#demo_hero_mode_name"	"Zkoušení hrdiny"
"#game_mode_lobby_name_0"	"–"
"#game_mode_lobby_name_1"	"Výběr ze všech"
"#game_mode_lobby_name_2"	"Kapitánský režim"
"#game_mode_lobby_name_3"	"Náhodný výběr"
"#game_mode_lobby_name_4"	"Výběr ze tří"
"#game_mode_lobby_name_5"	"Všichni náhodně"
"#game_mode_lobby_name_6"	"–"
"#game_mode_lobby_name_7"	"Diretide"
"#game_mode_lobby_name_8"	"Obrácený kapitánský režim"
"#game_mode_lobby_name_9"	"Greeviling"
"#game_mode_lobby_name_10"	"Tutoriál"
"#game_mode_lobby_name_11"	"Pouze střed"
"#game_mode_lobby_name_12"	"Nejméně hraní"
"#game_mode_lobby_name_13"	"Omezený výběr"
"#game_mode_lobby_name_14"	"Přehled"
"#game_mode_lobby_name_15"	"Uživatelský mód"
"#game_mode_lobby_name_16"	"Kapitánský výběr"
"#game_mode_lobby_name_17"	"Vybalancovaný výběr"
"#game_mode_lobby_name_18"	"Výběr schopností"
"#game_mode_lobby_name_20"	"Deathmatch – všichni náhodně"
"#game_mode_lobby_name_21"	"1 na 1 – prostřední linka"
"#game_mode_lobby_name_22"	"Hodnocený výběr ze všech"
"#game_mode_lobby_name_23"	"Turbo"
"#game_mode_lobby_name_24"	"Mutace"
"#game_mode_24"	"Mutace"
"#DOTA_RP_PLAYING_EVENT_MATCH"	"Hraje {%param0%}"
"#DOTA_EventGameName_International2018"	"Underhollow"
"#npc_dota_hero_grimstroke"	"Grimstroke"
"#DOTA_RP_TOURNEY_REGISTERING"	"Registruje se na víkendový turnaj divize {%param0%}"
"#DOTA_RP_TOURNEY_FINDING_MATCH"	"Vyhledává oponenta pro {%param1%}"
"#DOTA_RP_TOURNEY_BETWEEN_GAMES"	"Hraje {%param1%} víkendového turnaje (přestávka)"
"#DOTA_RP_TOURNEY_GAME_IN_PROGRESS"	"Hraje {%param0%} víkendového turnaje"
"#DOTA_RP_TOURNEY_PLAYING_AS"	"Hraje {%param2%} víkendového turnaje jako {%param1%}"
"#weekendtourney_round_quarterfinals"	"čtvrtfinále"
"#weekendtourney_round_semifinals"	"semifinále"
"#weekendtourney_round_finals"	"velké finále"
"#DOTA_EventName_Frostivus2018"	"Frosthaven"
"#npc_dota_hero_snapfire"	"Snapfire"
"#npc_dota_hero_void_spirit"	"Void Spirit"
"#DOTA_Guilds_message_motd"	"Zpráva dne: %param0%"
"#DOTA_Guilds_message_level"	"Guilda dosáhla %param0%. úrovně"
"#DOTA_Guild_message_promoted"	"%target_persona% byl uživatelem %requester_persona% povýšen na „%guild_role%“"
"#DOTA_Guild_message_demoted"	"%target_persona% byl uživatelem %requester_persona% degradován na „%guild_role%“"
"#dota_rp_playing_event_match_2020"	"Labyrint: {%param0%} (hloubka: %param1%)"
"#DOTA_EventGameName_International2020"	"Aghanimův labyrint"
"#dota_eventgamedifficulty_international2020_0"	"Učedník"
"#dota_eventgamedifficulty_international2020_1"	"Praktikant"
"#dota_eventgamedifficulty_international2020_2"	"Čaroděj"
"#dota_eventgamedifficulty_international2020_3"	"Velký Magus"
"#dota_eventgamedifficulty_international2020_4"	"Vrcholný mág"
"#DOTA_EventGameName_Diretide2020"	"Diretide"
"#DOTA_RP_PLAYING_DIRETIDE_MATCH"	"Diretide: %param0%. kolo jako {%param1%}"
"#npc_dota_hero_mars"	"Mars"
}
}
