"lang"
{
"Language"	"brazilian"
"Tokens"
{
"#DOTA_RP_INIT"	"Menu principal"
"#DOTA_RP_IDLE"	"Menu principal (ausente)"
"#DOTA_RP_WAIT_FOR_PLAYERS_TO_LOAD"	"{%param0%}: Aguardando outros jogadores"
"#DOTA_RP_COACHING"	"{%param0%}: Treinando"
"#DOTA_RP_HERO_SELECTION"	"{%param0%}: Seleção de herói"
"#DOTA_RP_STRATEGY_TIME"	"{%param0%}: Tempo de estratégia"
"#DOTA_RP_WAIT_FOR_MAP_TO_LOAD"	"{%param0%}: Aguardando carregamento"
"#DOTA_RP_PRE_GAME"	"{%param0%}: Pré-partida"
"#DOTA_RP_GAME_IN_PROGRESS"	"{%param0%}: Jogando uma partida"
"#DOTA_RP_GAME_IN_PROGRESS_CUSTOM"	"Jogando %param0%"
"#DOTA_RP_GAME_IN_PROGRESS_CUSTOM_UNNAMED"	"Jogando modo alternativo"
"#DOTA_RP_LOBBY_CUSTOM"	"Sala: %param0%"
"#DOTA_RP_LOBBY_CUSTOM_UNNAMED"	"Sala de modo alternativo"
"#DOTA_RP_PLAYING_AS"	"{%param0%}: {%param2%} (Nv. %param1%)"
"#DOTA_RP_POST_GAME"	"{%param0%}: Pós-partida"
"#DOTA_RP_DISCONNECT"	"{%param0%}: Desconectando"
"#DOTA_RP_SPECTATING"	"Assistindo a uma partida"
"#DOTA_RP_CASTING"	"Narrando uma partida"
"#DOTA_RP_PRIVATE_LOBBY"	"Sala privada"
"#DOTA_RP_LEAGUE_MATCH"	"Disputando um torneio"
"#DOTA_RP_LEAGUE_MATCH_PLAYING_AS"	"{%param0%}: {%param1%} (Torneio)"
"#DOTA_RP_WATCHING_REPLAY"	"Assistindo a um replay"
"#DOTA_RP_WATCHING_TOURNAMENT"	"Assistindo a um torneio"
"#DOTA_RP_WATCHING_TOURNAMENT_REPLAY"	"Assistindo a um replay de torneio"
"#DOTA_RP_FINDING_MATCH"	"Buscando uma partida"
"#DOTA_RP_FINDING_YEAR_BEAST_BRAWL"	"Buscando Confronto de Monstros Temporais"
"#DOTA_RP_FINDING_EVENT_MATCH"	"Buscando partida {%param0%}"
"#DOTA_RP_UNKNOWN_EVENT_GAME"	"Evento personalizado"
"#DOTA_RP_SPECTATING_WHILE_FINDING"	"Buscando uma partida e assistindo"
"#DOTA_RP_PENDING"	"Pedido de amizade pendente"
"#DOTA_RP_ONLINE"	"Disponível"
"#DOTA_RP_BUSY"	"Ocupado(a)"
"#DOTA_RP_AWAY"	"Ausente"
"#DOTA_RP_SNOOZE"	"Cochilando"
"#DOTA_RP_LOOKING_TO_TRADE"	"Querendo trocar"
"#DOTA_RP_LOOKING_TO_PLAY"	"Querendo jogar"
"#DOTA_RP_PLAYING_OTHER"	"Em outro jogo"
"#DOTA_RP_ACCOUNT_DISABLED"	"Criação de partidas temporariamente desativada"
"#DOTA_RP_QUEST"	"Em uma missão de treinamento"
"#DOTA_RP_BOTPRACTICE"	"Jogando contra bots"
"#DOTA_RP_COOPBOT"	"Partida cooperativa contra bots"
"#DOTA_RP_TRAINING"	"Em uma missão de treinamento"
"#DOTA_RP_OPEN_SOLO"	"Buscando membros para o grupo"
"#DOTA_RP_OPEN_PARTY"	"Em grupo buscando membros"
"#DOTA_RP_PLAYING_DOTA_S1"	"Jogando Dota 2"
"#custom_game_mode_status"	"Jogando modo alternativo"
"#npc_dota_hero_none"	"—"
"#npc_dota_hero_queenofpain"	"Queen of Pain"
"#npc_dota_hero_antimage"	"Anti-Mage"
"#npc_dota_hero_kunkka"	"Kunkka"
"#npc_dota_hero_lina"	"Lina"
"#npc_dota_hero_mirana"	"Mirana"
"#npc_dota_hero_slardar"	"Slardar"
"#npc_dota_hero_lion"	"Lion"
"#npc_dota_hero_phantom_assassin"	"Phantom Assassin"
"#npc_dota_hero_tidehunter"	"Tidehunter"
"#npc_dota_hero_witch_doctor"	"Witch Doctor"
"#npc_dota_hero_vengefulspirit"	"Vengeful Spirit"
"#npc_dota_hero_juggernaut"	"Juggernaut"
"#npc_dota_hero_earthshaker"	"Earthshaker"
"#npc_dota_hero_pudge"	"Pudge"
"#npc_dota_hero_bane"	"Bane"
"#npc_dota_hero_crystal_maiden"	"Crystal Maiden"
"#npc_dota_hero_sven"	"Sven"
"#npc_dota_hero_skeleton_king"	"Wraith King"
"#npc_dota_hero_storm_spirit"	"Storm Spirit"
"#npc_dota_hero_sand_king"	"Sand King"
"#npc_dota_hero_nevermore"	"Shadow Fiend"
"#npc_dota_hero_drow_ranger"	"Drow Ranger"
"#npc_dota_hero_axe"	"Axe"
"#npc_dota_hero_bloodseeker"	"Bloodseeker"
"#npc_dota_hero_phantom_lancer"	"Phantom Lancer"
"#npc_dota_hero_razor"	"Razor"
"#npc_dota_hero_morphling"	"Morphling"
"#npc_dota_hero_zuus"	"Zeus"
"#npc_dota_hero_tiny"	"Tiny"
"#npc_dota_hero_puck"	"Puck"
"#npc_dota_hero_windrunner"	"Windranger"
"#npc_dota_hero_lich"	"Lich"
"#npc_dota_hero_shadow_shaman"	"Shadow Shaman"
"#npc_dota_hero_riki"	"Riki"
"#npc_dota_hero_enigma"	"Enigma"
"#npc_dota_hero_tinker"	"Tinker"
"#npc_dota_hero_sniper"	"Sniper"
"#npc_dota_hero_necrolyte"	"Necrophos"
"#npc_dota_hero_warlock"	"Warlock"
"#npc_dota_hero_beastmaster"	"Beastmaster"
"#npc_dota_hero_venomancer"	"Venomancer"
"#npc_dota_hero_faceless_void"	"Faceless Void"
"#npc_dota_hero_death_prophet"	"Death Prophet"
"#npc_dota_hero_pugna"	"Pugna"
"#npc_dota_hero_templar_assassin"	"Templar Assassin"
"#npc_dota_hero_viper"	"Viper"
"#npc_dota_hero_luna"	"Luna"
"#npc_dota_hero_dragon_knight"	"Dragon Knight"
"#npc_dota_hero_dazzle"	"Dazzle"
"#npc_dota_hero_rattletrap"	"Clockwerk"
"#npc_dota_hero_leshrac"	"Leshrac"
"#npc_dota_hero_furion"	"Nature's Prophet"
"#npc_dota_hero_life_stealer"	"Lifestealer"
"#npc_dota_hero_dark_seer"	"Dark Seer"
"#npc_dota_hero_clinkz"	"Clinkz"
"#npc_dota_hero_omniknight"	"Omniknight"
"#npc_dota_hero_enchantress"	"Enchantress"
"#npc_dota_hero_huskar"	"Huskar"
"#npc_dota_hero_night_stalker"	"Night Stalker"
"#npc_dota_hero_broodmother"	"Broodmother"
"#npc_dota_hero_bounty_hunter"	"Bounty Hunter"
"#npc_dota_hero_weaver"	"Weaver"
"#npc_dota_hero_jakiro"	"Jakiro"
"#npc_dota_hero_batrider"	"Batrider"
"#npc_dota_hero_chen"	"Chen"
"#npc_dota_hero_spectre"	"Spectre"
"#npc_dota_hero_doom_bringer"	"Doom"
"#npc_dota_hero_ancient_apparition"	"Ancient Apparition"
"#npc_dota_hero_ursa"	"Ursa"
"#npc_dota_hero_spirit_breaker"	"Spirit Breaker"
"#npc_dota_hero_gyrocopter"	"Gyrocopter"
"#npc_dota_hero_alchemist"	"Alchemist"
"#npc_dota_hero_invoker"	"Invoker"
"#npc_dota_hero_silencer"	"Silencer"
"#npc_dota_hero_obsidian_destroyer"	"Outworld Devourer"
"#npc_dota_hero_lycan"	"Lycan"
"#npc_dota_hero_brewmaster"	"Brewmaster"
"#npc_dota_hero_shadow_demon"	"Shadow Demon"
"#npc_dota_hero_lone_druid"	"Lone Druid"
"#npc_dota_hero_chaos_knight"	"Chaos Knight"
"#npc_dota_hero_treant"	"Treant Protector"
"#npc_dota_hero_meepo"	"Meepo"
"#npc_dota_hero_ogre_magi"	"Ogre Magi"
"#npc_dota_hero_undying"	"Undying"
"#npc_dota_hero_rubick"	"Rubick"
"#npc_dota_hero_disruptor"	"Disruptor"
"#npc_dota_hero_nyx_assassin"	"Nyx Assassin"
"#npc_dota_hero_naga_siren"	"Naga Siren"
"#npc_dota_hero_keeper_of_the_light"	"Keeper of the Light"
"#npc_dota_hero_visage"	"Visage"
"#npc_dota_hero_wisp"	"Io"
"#npc_dota_hero_slark"	"Slark"
"#npc_dota_hero_medusa"	"Medusa"
"#npc_dota_hero_troll_warlord"	"Troll Warlord"
"#npc_dota_hero_centaur"	"Centaur Warrunner"
"#npc_dota_hero_magnataur"	"Magnus"
"#npc_dota_hero_shredder"	"Timbersaw"
"#npc_dota_hero_bristleback"	"Bristleback"
"#npc_dota_hero_tusk"	"Tusk"
"#npc_dota_hero_skywrath_mage"	"Skywrath Mage"
"#npc_dota_hero_abaddon"	"Abaddon"
"#npc_dota_hero_elder_titan"	"Elder Titan"
"#npc_dota_hero_legion_commander"	"Legion Commander"
"#npc_dota_hero_ember_spirit"	"Ember Spirit"
"#npc_dota_hero_earth_spirit"	"Earth Spirit"
"#npc_dota_hero_abyssal_underlord"	"Underlord"
"#npc_dota_hero_phoenix"	"Phoenix"
"#npc_dota_hero_terrorblade"	"Terrorblade"
"#npc_dota_hero_oracle"	"Oracle"
"#npc_dota_hero_techies"	"Techies"
"#npc_dota_hero_target_dummy"	"Saco de Pancada"
"#npc_dota_hero_winter_wyvern"	"Winter Wyvern"
"#npc_dota_hero_arc_warden"	"Arc Warden"
"#npc_dota_hero_monkey_king"	"Monkey King"
"#npc_dota_hero_pangolier"	"Pangolier"
"#npc_dota_hero_dark_willow"	"Dark Willow"
"#DOTA_lobby_type_name_lobby"	"Sala"
"#DOTA_lobby_type_name_unranked"	"Casual"
"#DOTA_lobby_type_name_ranked"	"Competitiva"
"#DOTA_lobby_type_name_bot_match"	"Bots"
"#DOTA_lobby_type_name_spectator"	"Espectador"
"#demo_hero_mode_name"	"Testar herói"
"#game_mode_lobby_name_0"	"-"
"#game_mode_lobby_name_1"	"Escolha Livre"
"#game_mode_lobby_name_2"	"Modo de Capitães"
"#game_mode_lobby_name_3"	"Seleção Aleatória"
"#game_mode_lobby_name_4"	"Seleção Individual"
"#game_mode_lobby_name_5"	"Todos Aleatórios"
"#game_mode_lobby_name_6"	"-"
"#game_mode_lobby_name_7"	"Diretide"
"#game_mode_lobby_name_8"	"Modo de Capitães Inverso"
"#game_mode_lobby_name_9"	"O Greeviling"
"#game_mode_lobby_name_10"	"Tutorial"
"#game_mode_lobby_name_11"	"Somente Meio"
"#game_mode_lobby_name_12"	"Menos Jogados"
"#game_mode_lobby_name_13"	"Modo para Novatos"
"#game_mode_lobby_name_14"	"Compêndio"
"#game_mode_lobby_name_15"	"Personalizado"
"#game_mode_lobby_name_16"	"Seleção dos Capitães"
"#game_mode_lobby_name_17"	"Seleção Equilibrada"
"#game_mode_lobby_name_18"	"Seleção de Habilidades"
"#game_mode_lobby_name_20"	"Mata-mata Aleatório"
"#game_mode_lobby_name_21"	"X1 na Trilha do Meio"
"#game_mode_lobby_name_22"	"Escolha Livre Competitivo"
"#game_mode_lobby_name_23"	"Turbo"
"#game_mode_lobby_name_24"	"Mutação"
"#game_mode_24"	"Mutação"
"#DOTA_RP_PLAYING_EVENT_MATCH"	"Jogando {%param0%}"
"#DOTA_EventGameName_International2018"	"Coviterrâneo"
"#npc_dota_hero_grimstroke"	"Grimstroke"
"#DOTA_RP_TOURNEY_REGISTERING"	"Copa de Batalhas: Inscrevendo-se ({%param0%})"
"#DOTA_RP_TOURNEY_FINDING_MATCH"	"Buscando adversária para {%param1%}"
"#DOTA_RP_TOURNEY_BETWEEN_GAMES"	"Copa de Batalhas: {%param1%} (intervalo)"
"#DOTA_RP_TOURNEY_GAME_IN_PROGRESS"	"Copa de Batalha: {%param0%}"
"#DOTA_RP_TOURNEY_PLAYING_AS"	"Copa de Batalhas: {%param2%} ({%param1%})"
"#weekendtourney_round_quarterfinals"	"Quartas de Final"
"#weekendtourney_round_semifinals"	"Semifinais"
"#weekendtourney_round_finals"	"Grande Final"
"#DOTA_EventName_Frostivus2018"	"Congelito"
"#npc_dota_hero_snapfire"	"Snapfire"
"#npc_dota_hero_void_spirit"	"Void Spirit"
"#DOTA_Guilds_message_motd"	"Mensagem do dia: %param0%"
"#DOTA_Guilds_message_level"	"O clã alcançou o nível %param0%"
"#DOTA_Guild_message_promoted"	"%target_persona% foi promovido(a) a %guild_role% por %requester_persona%"
"#DOTA_Guild_message_demoted"	"%target_persona% foi rebaixado(a) a %guild_role% por %requester_persona%."
"#dota_rp_playing_event_match_2020"	"Labirinto: {%param0%}, profundidade %param1%"
"#DOTA_EventGameName_International2020"	"Labirinto de Aghanim"
"#dota_eventgamedifficulty_international2020_0"	"Aprendiz"
"#dota_eventgamedifficulty_international2020_1"	"Mago"
"#dota_eventgamedifficulty_international2020_2"	"Feiticeiro"
"#dota_eventgamedifficulty_international2020_3"	"Grande Mago"
"#dota_eventgamedifficulty_international2020_4"	"Mago Apogético"
"#DOTA_EventGameName_Diretide2020"	"Diretide"
"#DOTA_RP_PLAYING_DIRETIDE_MATCH"	"Diretide: %param0%ª rodada ({%param1%})"
"#npc_dota_hero_mars"	"Marte"
"#DOTA_RP_PLAYING_DIRETIDE_MATCH_PREGAME"	"Diretide: Seleção de herói"
"#npc_dota_hero_hoodwink"	"Hoodwink"
"#npc_dota_hero_dawnbreaker"	"Dawnbreaker"
"#game_mode_0"	"–"
"#game_mode_1"	"Escolha Livre"
"#game_mode_2"	"Modo de Capitães"
"#game_mode_3"	"Seleção Aleatória"
"#game_mode_4"	"Seleção Individual"
"#game_mode_5"	"Todos Aleatórios"
"#game_mode_6"	"–"
"#game_mode_7"	"Diretide"
"#game_mode_8"	"Modo de Capitães Inverso"
"#game_mode_9"	"Greeviling"
"#game_mode_10"	"Tutorial"
"#game_mode_11"	"Somente Meio"
"#game_mode_12"	"Menos Jogados"
"#game_mode_13"	"Modo para Novatos"
"#game_mode_14"	"Compêndio"
"#game_mode_15"	"Modo alternativo"
"#game_mode_16"	"Seleção dos Capitães"
"#game_mode_17"	"Seleção Equilibrada"
"#game_mode_18"	"Seleção de Habilidades"
"#game_mode_19"	"Modo alternativo"
"#game_mode_20"	"Mata-mata Aleatório"
"#game_mode_21"	"X1 na Trilha do Meio"
"#game_mode_22"	"Escolha Livre"
"#game_mode_23"	"Turbo"
"#npc_dota_hero_marci"	"Marci"
}
}
