"lang"
{
"Language"	"german"
"Tokens"
{
"addon_game_name"	"Aghanims Labyrinth"
"[english]addon_game_name"	"Aghanim's Labyrinth"
"DOTA_GameMode_15"	"Aghanims Labyrinth"
"[english]DOTA_GameMode_15"	"Aghanim's Labyrinth"
"DOTA_GameMode_19"	"Aghanims Labyrinth"
"[english]DOTA_GameMode_19"	"Aghanim's Labyrinth"
"aghanim_bonus_round_time_left"	"VERBLEIBENDE ZEIT"
"[english]aghanim_bonus_round_time_left"	"TIME LEFT"
"aghanim_bonus_round_total_gold"	"Gesamtes Gold"
"[english]aghanim_bonus_round_total_gold"	"Total Gold"
"DOTA_Defeated"	"Ihr Team ist verendet!"
"[english]DOTA_Defeated"	"Your team has perished!"
"dota_game_end_victory_title_radiant"	"Sie haben Aghanims Labyrinth gemeistert"
"[english]dota_game_end_victory_title_radiant"	"You have bested Aghanim's Labyrinth"
"dota_game_end_victory_title_dire"	"Ihr Team fiel Aghanims Labyrinth zum Opfer"
"[english]dota_game_end_victory_title_dire"	"Aghanim's Labyrinth claims your party"
"DOTA_HUD_EnemiesRemaining"	"VERBLEIBENDE GEGNER:"
"[english]DOTA_HUD_EnemiesRemaining"	"ENEMIES REMAINING:"
"DOTA_HUD_TimeRemaining"	"VERBLEIBENDE ZEIT:"
"[english]DOTA_HUD_TimeRemaining"	"TIME REMAINING:"
"DOTA_HUD_Victory"	"SIEG!"
"[english]DOTA_HUD_Victory"	"VICTORY!"
"DOTA_HUD_Defeat"	"NIEDERLAGE!"
"[english]DOTA_HUD_Defeat"	"DEFEAT!"
"DOTA_HUD_Kills"	"KILLS"
"[english]DOTA_HUD_Kills"	"KILLS"
"DOTA_HUD_Deaths"	"TODE"
"[english]DOTA_HUD_Deaths"	"DEATHS"
"DOTA_HUD_Saves"	"RETTUNGEN"
"[english]DOTA_HUD_Saves"	"REVIVES"
"DOTA_HUD_Bags"	"SÄCKE"
"[english]DOTA_HUD_Bags"	"BAGS"
"DOTA_HUD_Mute"	"STUMM"
"[english]DOTA_HUD_Mute"	"MUTE"
"DOTA_HUD_PlayAgain"	"Nochmal spielen?"
"[english]DOTA_HUD_PlayAgain"	"Play Again?"
"DOTA_HUD_Yes"	"JA"
"[english]DOTA_HUD_Yes"	"YES"
"DOTA_HUD_No"	"NEIN"
"[english]DOTA_HUD_No"	"NO"
"DOTA_HUD_Score"	"PUNKTE"
"[english]DOTA_HUD_Score"	"SCORE"
"DOTA_HUD_GoldBags"	"GESAMMELTE GOLDSÄCKE"
"[english]DOTA_HUD_GoldBags"	"GOLD BAGS COLLECTED"
"DOTA_HUD_GoldBagsMissed"	"ENTGANGENE GOLDSÄCKE"
"[english]DOTA_HUD_GoldBagsMissed"	"GOLD BAGS MISSED"
"DOTA_HUD_TeamDeaths"	"TEAMTODE"
"[english]DOTA_HUD_TeamDeaths"	"TEAM DEATHS"
"DOTA_HUD_Rewards"	"ZEPTERSPLITTER"
"[english]DOTA_HUD_Rewards"	"SCEPTER SHARDS"
"DOTA_HUD_Blessings"	"SEGEN"
"[english]DOTA_HUD_Blessings"	"BLESSINGS"
"DOTA_HUD_RoomRewards"	"Raumbelohnungen"
"[english]DOTA_HUD_RoomRewards"	"Room Rewards"
"DOTA_HUD_ShowBlessings"	"Segen anzeigen"
"[english]DOTA_HUD_ShowBlessings"	"Show Blessings"
"DOTA_HUD_HideBlessings"	"Segen ausblenden"
"[english]DOTA_HUD_HideBlessings"	"Hide Blessings"
"DOTA_HUD_Reward_Header"	"Belohnung auswählen"
"[english]DOTA_HUD_Reward_Header"	"Choose your reward"
"DOTA_HUD_Reward_Gold"	"Bonusgold"
"[english]DOTA_HUD_Reward_Gold"	"Bonus Gold"
"DOTA_HUD_Reward_Gold_desc"	"{d:quantity} Gold"
"[english]DOTA_HUD_Reward_Gold_desc"	"{d:quantity} Gold"
"DOTA_HUD_Reward_ExtraLives"	"Extraleben"
"[english]DOTA_HUD_Reward_ExtraLives"	"Extra Live(s)"
"DOTA_HUD_Reward_ExtraLives_desc"	"{d:quantity} Extraleben"
"[english]DOTA_HUD_Reward_ExtraLives_desc"	"{d:quantity} Extra Life"
"DOTA_HUD_Reward_Item"	"Neutraler Gegenstand"
"[english]DOTA_HUD_Reward_Item"	"Neutral Item"
"DOTA_HUD_Reward_TempBuff"	"Temp. Bonus"
"[english]DOTA_HUD_Reward_TempBuff"	"Temp Buff"
"DOTA_HUD_Reward_Aura"	"Aura"
"[english]DOTA_HUD_Reward_Aura"	"Aura"
"DOTA_HUD_Reward_AbilityUpgrade"	"Aghanims Segen"
"[english]DOTA_HUD_Reward_AbilityUpgrade"	"Aghanim's Blessing"
"DOTA_HUD_Reward_MinotrAbilityUpgrade"	"Fähigkeit aufwerten"
"[english]DOTA_HUD_Reward_MinotrAbilityUpgrade"	"Ability Upgrade"
"DOTA_HUD_Reward_AdditionalRewards"	"Zusätzliche Belohnungen erhalten"
"[english]DOTA_HUD_Reward_AdditionalRewards"	"Additional Rewards Granted"
"DOTA_HUD_Game_Mode_Header"	"Willkommen in Aghanims Labyrinth!"
"[english]DOTA_HUD_Game_Mode_Header"	"Welcome To Aghanim's Labyrinth!"
"DOTA_HUD_Rewards_AscensionLevel"	"Stufe: {d:ascension_level}"
"[english]DOTA_HUD_Rewards_AscensionLevel"	"Ascension Level: {d:ascension_level}"
"DOTA_HUD_TopBar_Difficulty"	"{s:difficulty_name}"
"[english]DOTA_HUD_TopBar_Difficulty"	"{s:difficulty_name}"
"boss_shop"	"Borstis Spielereien"
"[english]boss_shop"	"Bristle's Baubles"
"DOTA_Subshop_1"	"Grundlagen"
"[english]DOTA_Subshop_1"	"Basics"
"DOTA_Subshop_2"	"Schmuckstücke"
"[english]DOTA_Subshop_2"	"Trinkets"
"DOTA_HUD_BattleRoyaleDamageStarting"	"Zurück in den Kampf, Feigling!"
"[english]DOTA_HUD_BattleRoyaleDamageStarting"	"Join the battle, coward!"
"DOTA_Tooltip_Ability_item_battle_points"	"Schlachtenpunkte"
"[english]DOTA_Tooltip_Ability_item_battle_points"	"Battle Points"
"DOTA_Tooltip_Ability_item_arcane_fragments"	"Arkanfragmente"
"[english]DOTA_Tooltip_Ability_item_arcane_fragments"	"Arcane Fragments"
"DOTA_RewardTooltip_Gold"	"Gold"
"[english]DOTA_RewardTooltip_Gold"	"Gold"
"DOTA_RewardTooltip_XP"	"EP"
"[english]DOTA_RewardTooltip_XP"	"XP"
"DOTA_HUD_Rewards_ShowRewards"	"ZEPTERSPLITTER VERFÜGBAR"
"[english]DOTA_HUD_Rewards_ShowRewards"	"SCEPTER SHARD AVAILABLE"
"DOTA_HUD_Rewards_Info"	"Zeige gewählte Aufwertungen in der Punktetabelle"
"[english]DOTA_HUD_Rewards_Info"	"View selected upgrades in the scoreboard"
"DOTA_HUD_REWARD_TIER1_Desc"	"Stufe 1"
"[english]DOTA_HUD_REWARD_TIER1_Desc"	"Tier 1"
"DOTA_HUD_REWARD_TIER2_Desc"	"Stufe 2"
"[english]DOTA_HUD_REWARD_TIER2_Desc"	"Tier 2"
"DOTA_HUD_REWARD_TIER3_Desc"	"Stufe 3"
"[english]DOTA_HUD_REWARD_TIER3_Desc"	"Tier 3"
"DOTA_HUD_REWARD_TIER4_Desc"	"Stufe 4"
"[english]DOTA_HUD_REWARD_TIER4_Desc"	"Tier 4"
"DOTA_HUD_REWARD_TIER5_Desc"	"Stufe 5"
"[english]DOTA_HUD_REWARD_TIER5_Desc"	"Tier 5"
"DOTA_Hud_EncounterDepth"	"Raum {s:encounter_depth}"
"[english]DOTA_Hud_EncounterDepth"	"Depth {s:encounter_depth}"
"DOTA_Hud_AscenionAbilitiesTitle"	"Zusätzliche Modifikatoren"
"[english]DOTA_Hud_AscenionAbilitiesTitle"	"Additional Modifiers"
"DOTA_Hud_Elite_Encounter_Discover"	"Elitebegegnung – Doppelte Belohnung"
"[english]DOTA_Hud_Elite_Encounter_Discover"	"Elite Encounter - 2x Rewards"
"DOTA_Hud_Elite_Encounter"	"Elitebegegnung"
"[english]DOTA_Hud_Elite_Encounter"	"Elite Encounter"
"DOTA_HUD_Reward_Rarity_Common"	"Einen <font color='#88A6D9'>GEWÖHNLCHEN</font> Zeptersplitter wählen"
"[english]DOTA_HUD_Reward_Rarity_Common"	"Choose a <font color='#88A6D9'>COMMON</font> Scepter Shard"
"DOTA_HUD_Reward_Rarity_Elite"	"Einen <font color='#D02B29'>ELITE</font>-Zeptersplitter wählen"
"[english]DOTA_HUD_Reward_Rarity_Elite"	"Choose an <font color='#D02B29'>ELITE</font> Scepter Shard"
"DOTA_HUD_Reward_Rarity_Epic"	"Einen <font color='#7266FF'>LEGENDÄREN</font> Zeptersplitter wählen"
"[english]DOTA_HUD_Reward_Rarity_Epic"	"Choose a <font color='#7266FF'>LEGENDARY</font> Scepter Shard"
"DOTA_HUD_REWARD_TYPE_GOLD_Toast"	"{s:player_name} hat {d:int_value} <panel class='CombatEventGoldIcon'/> gewählt"
"[english]DOTA_HUD_REWARD_TYPE_GOLD_Toast"	"{s:player_name} chose {d:int_value} <panel class='CombatEventGoldIcon'/>"
"DOTA_HUD_REWARD_TYPE_ITEM_Toast"	"{s:player_name} hat „{s:locstring_value}“ gewählt"
"[english]DOTA_HUD_REWARD_TYPE_ITEM_Toast"	"{s:player_name} chose {s:locstring_value}"
"DOTA_HUD_REWARD_TYPE_ABILITY_UPGRADE_Toast"	"{s:player_name} hat „{s:locstring_value}“ gewählt"
"[english]DOTA_HUD_REWARD_TYPE_ABILITY_UPGRADE_Toast"	"{s:player_name} chose {s:locstring_value}"
"DOTA_HUD_REWARD_TYPE_EXTRA_LIVES_Toast"	"{s:player_name} hat {d:int_value} gewählt"
"[english]DOTA_HUD_REWARD_TYPE_EXTRA_LIVES_Toast"	"{s:player_name} chose {d:int_value}"
"DOTA_HUD_REWARD_TYPE_MINOR_ABILITY_UPGRADE_Toast"	"{s:player_name} hat „%s1“ gewählt"
"[english]DOTA_HUD_REWARD_TYPE_MINOR_ABILITY_UPGRADE_Toast"	"{s:player_name} chose %s1"
"DOTA_HUD_REWARD_TYPE_MINOR_STATS_UPGRADE_Toast"	"{s:player_name} hat „%s1“ gewählt"
"[english]DOTA_HUD_REWARD_TYPE_MINOR_STATS_UPGRADE_Toast"	"{s:player_name} chose %s1"
"DOTA_HUD_REWARD_TYPE_GOLD_Desc"	"Gold"
"[english]DOTA_HUD_REWARD_TYPE_GOLD_Desc"	"Gold"
"DOTA_HUD_REWARD_TYPE_TREASURE_Desc"	"Schatzkiste"
"[english]DOTA_HUD_REWARD_TYPE_TREASURE_Desc"	"Treasure Chest"
"DOTA_HUD_REWARD_TYPE_EXTRA_LIVES_Desc"	"Extraleben"
"[english]DOTA_HUD_REWARD_TYPE_EXTRA_LIVES_Desc"	"Extra Lives"
"DOTA_HUD_Claimed_Rewards_Header"	"Eingelöste Belohnungen"
"[english]DOTA_HUD_Claimed_Rewards_Header"	"Claimed Rewards"
"DOTA_Hud_Tooltip_Outpost_Title"	"Kampf"
"[english]DOTA_Hud_Tooltip_Outpost_Title"	"Combat"
"DOTA_Hud_Tooltip_Outpost_EliteTitle"	"Elitekampf"
"[english]DOTA_Hud_Tooltip_Outpost_EliteTitle"	"Elite Combat"
"DOTA_Hud_Tooltip_Outpost_TrapTitle"	"Falle"
"[english]DOTA_Hud_Tooltip_Outpost_TrapTitle"	"Trap"
"DOTA_Hud_Tooltip_Outpost_BossTitle"	"Boss"
"[english]DOTA_Hud_Tooltip_Outpost_BossTitle"	"Boss"
"DOTA_Hud_Tooltip_Outpost_BonusTitle"	"Bonus"
"[english]DOTA_Hud_Tooltip_Outpost_BonusTitle"	"Bonus"
"DOTA_Hud_Tooltip_Outpost_TransitionTitle"	"Rast"
"[english]DOTA_Hud_Tooltip_Outpost_TransitionTitle"	"Rest"
"DOTA_Hud_Outpost_ChannelBar_Title"	"KAMPF wählen"
"[english]DOTA_Hud_Outpost_ChannelBar_Title"	"Selecting COMBAT"
"DOTA_Hud_Outpost_ChannelBar_EliteTitle"	"<font color='#D02B29'>ELITE</font>KAMPF auswählen"
"[english]DOTA_Hud_Outpost_ChannelBar_EliteTitle"	"Selecting <font color='#D02B29'>ELITE</font> COMBAT"
"DOTA_Hud_Outpost_ChannelBar_TrapTitle"	"<font color='#FF7F37'>FALLEN</font> auswählen"
"[english]DOTA_Hud_Outpost_ChannelBar_TrapTitle"	"Selecting <font color='#FF7F37'>TRAPS</font>"
"DOTA_Hud_Outpost_ChannelBar_BossTitle"	"<font color='#7266FF'>BOSS</font> auswählen"
"[english]DOTA_Hud_Outpost_ChannelBar_BossTitle"	"Selecting <font color='#7266FF'>BOSS</font>"
"DOTA_Hud_Outpost_ChannelBar_BonusTitle"	"<font color='#f9cb4f'>BONUS</font> auswählen"
"[english]DOTA_Hud_Outpost_ChannelBar_BonusTitle"	"Selecting <font color='#f9cb4f'>BONUS</font>"
"DOTA_Hud_Outpost_ChannelBar_RestTitle"	"<font color='#f9cb4f'>RAST</font> auswählen"
"[english]DOTA_Hud_Outpost_ChannelBar_RestTitle"	"Selecting <font color='#f9cb4f'>REST</font>"
"defeat_all_enemies"	"Besiegen Sie alle Gegner"
"[english]defeat_all_enemies"	"Defeat all enemies"
"destroy_spawning_portals"	"Zerstören Sie die dunklen Portale"
"[english]destroy_spawning_portals"	"Destroy the Dark Portals"
"navigate_the_traps"	"Weichen Sie den Fallen aus und erreichen Sie das Ziel"
"[english]navigate_the_traps"	"Navigate the Traps and Reach the Goal"
"kill_scarab_priests"	"Besiegen Sie die Skarabäus-Priester"
"[english]kill_scarab_priests"	"Defeat the Scarab Priests"
"defeat_the_alchemists"	"Besiegen Sie die Alchemisten"
"[english]defeat_the_alchemists"	"Defeat the Alchemists"
"defeat_boss_npc_dota_boss_void_spirit"	"Besiegen Sie den Schatten von Inai"
"[english]defeat_boss_npc_dota_boss_void_spirit"	"Defeat the Shadow of Inai"
"defeat_boss_npc_dota_creature_temple_guardian"	"Besiegen Sie die Tempelwächter"
"[english]defeat_boss_npc_dota_creature_temple_guardian"	"Defeat the Temple Guardians"
"defeat_boss_npc_dota_creature_storegga"	"Besiegen Sie Storegga"
"[english]defeat_boss_npc_dota_creature_storegga"	"Defeat Storegga"
"defeat_boss_npc_dota_boss_aghanim"	"Besiegen Sie Aghanim"
"[english]defeat_boss_npc_dota_boss_aghanim"	"Defeat Aghanim"
"defeat_boss_npc_dota_boss_visage"	"Besiegen Sie den Wächter des Verschlungenen Labyrinths"
"[english]defeat_boss_npc_dota_boss_visage"	"Defeat Warden of the Narrow Maze"
"kill_tinies"	"Zerstören Sie Freundschaften"
"[english]kill_tinies"	"Destroy Friendships"
"defeat_shadow_demons"	"Besiegen Sie die Schattendämonen"
"[english]defeat_shadow_demons"	"Defeat the Shadow Demons"
"rescue_sheep"	"Retten Sie die Schafe"
"[english]rescue_sheep"	"Rescue the Sheep"
"save_gary"	"Beschützen Sie Gary"
"[english]save_gary"	"Protect Gary"
"destroy_all_mines"	"Zerstören Sie die Unterwasserminen"
"[english]destroy_all_mines"	"Destroy the Underwater Mines"
"objective_stand_on_buttons"	"Gehen Sie zu den Startflächen"
"[english]objective_stand_on_buttons"	"Stand On Starting Buttons"
"defeat_blazhan"	"Besiegen Sie Blazhan"
"[english]defeat_blazhan"	"Defeat Blazhan"
"defeat_frozhan"	"Besiegen Sie Frozhan"
"[english]defeat_frozhan"	"Defeat Frozhan"
"defeat_portly"	"Besiegen Sie Portly"
"[english]defeat_portly"	"Defeat Portly"
"hint_ride_morty"	"{s:keybind} oder {s:alternate_keybind}, um aufzusteigen!"
"[english]hint_ride_morty"	"{s:keybind} or {s:alternate_keybind} to Saddle Up!"
"hint_ride_penguin"	"{s:keybind} oder {s:alternate_keybind}, um aufzusteigen!"
"[english]hint_ride_penguin"	"{s:keybind} or {s:alternate_keybind} to Saddle Up!"
"DOTA_Tooltip_modifier_aghsfort_firefly_burn"	"Feuerteufel"
"[english]DOTA_Tooltip_modifier_aghsfort_firefly_burn"	"Pyromaniac"
"DOTA_Tooltip_modifier_aghsfort_firefly_burn_Description"	"Sie brennen."
"[english]DOTA_Tooltip_modifier_aghsfort_firefly_burn_Description"	"You are on fire."
"npc_dota_creature_brewmaster_boss"	"Pandabär"
"[english]npc_dota_creature_brewmaster_boss"	"Panda Bear Guy"
"npc_dota_brewmaster_earth_unit"	"Erddrittel"
"[english]npc_dota_brewmaster_earth_unit"	"Earth Third"
"npc_dota_brewmaster_storm_unit"	"Sturmdrittel"
"[english]npc_dota_brewmaster_storm_unit"	"Storm Third"
"npc_dota_brewmaster_fire_unit"	"Glutdrittel"
"[english]npc_dota_brewmaster_fire_unit"	"Ember Third"
"npc_dota_creature_dire_hound"	"Schreckenshund-Welpe"
"[english]npc_dota_creature_dire_hound"	"Dire Hound Cub"
"npc_dota_creature_dire_hound_boss"	"Schreckenshund"
"[english]npc_dota_creature_dire_hound_boss"	"Dire Hound"
"npc_dota_creature_ogre_tank"	"Knochenmehlpanzer"
"[english]npc_dota_creature_ogre_tank"	"Bonemeal Tank"
"npc_dota_creature_ogre_magi"	"Knochenmehlmagier"
"[english]npc_dota_creature_ogre_magi"	"Bonemeal Mage"
"npc_dota_creature_baby_ogre_tank"	"Baby-Knochenmehlpanzer"
"[english]npc_dota_creature_baby_ogre_tank"	"Baby Bonemeal Tank"
"npc_dota_creature_baby_ogre_magi"	"Baby-Knochenmehlmagier"
"[english]npc_dota_creature_baby_ogre_magi"	"Baby Bonemeal Mage"
"npc_dota_creature_small_hellbear"	"Waldhöllenbär"
"[english]npc_dota_creature_small_hellbear"	"Woodland Hellbear"
"npc_dota_creature_hellbear"	"Höllenbär-Krieger"
"[english]npc_dota_creature_hellbear"	"Hellbear Warrior"
"npc_dota_pinecone_champion"	"Kiefernchampion"
"[english]npc_dota_pinecone_champion"	"Pinecone Champ"
"npc_dota_pinecone_warrior"	"Kiefernkrieger"
"[english]npc_dota_pinecone_warrior"	"Pinecone Warrior"
"npc_dota_creature_small_ogre_seal"	"Ogerrobbenjunges"
"[english]npc_dota_creature_small_ogre_seal"	"Baby Ogre Seal"
"npc_dota_creature_large_ogre_seal"	"Grummlige Ogerrobbe"
"[english]npc_dota_creature_large_ogre_seal"	"Grumpy Ogre Seal"
"npc_dota_creature_wandering_ogre_seal"	"Wandernde Ogerrobbe"
"[english]npc_dota_creature_wandering_ogre_seal"	"Wandering Ogre Seal"
"npc_dota_creature_dazzle"	"Gehilfe von Dezun"
"[english]npc_dota_creature_dazzle"	"Acolyte of Dezun"
"npc_dota_creature_wildwing_laborer"	"Gebändigte Wildschwinge"
"[english]npc_dota_creature_wildwing_laborer"	"Tamed Wildwing"
"npc_dota_creature_tusk_skeleton"	"Walrosslakai"
"[english]npc_dota_creature_tusk_skeleton"	"Odobenus Footman"
"npc_dota_creature_spectral_tusk_mage"	"Walross-Frostmagier"
"[english]npc_dota_creature_spectral_tusk_mage"	"Odobenus Frost Mage"
"npc_dota_holdout_tower"	"Wachturm"
"[english]npc_dota_holdout_tower"	"Watchtower"
"npc_dota_undead_tusk_tombstone"	"Walrossgrabstein"
"[english]npc_dota_undead_tusk_tombstone"	"Odobenus Tombstone"
"npc_dota_creature_friendly_baby_ogre_tank"	"Blug"
"[english]npc_dota_creature_friendly_baby_ogre_tank"	"Blug"
"npc_dota_creature_friendly_ogre_seal"	"Gary"
"[english]npc_dota_creature_friendly_ogre_seal"	"Gary"
"npc_dota_creature_sand_king"	"Rhyzik"
"[english]npc_dota_creature_sand_king"	"Rhyzik"
"npc_dota_sand_king_sandstorm"	"Rhyziks Sandsturm"
"[english]npc_dota_sand_king_sandstorm"	"Rhyzik's Sandstorm"
"npc_dota_creature_big_exploding_burrower"	"Königlicher Sandschwarmberster"
"[english]npc_dota_creature_big_exploding_burrower"	"King Sandswarm Burster"
"npc_dota_creature_healing_burrower"	"Sandschwarmpriester"
"[english]npc_dota_creature_healing_burrower"	"Sandswarm Sacrifice"
"npc_dota_creature_storegga"	"Storegga"
"[english]npc_dota_creature_storegga"	"Storegga"
"npc_dota_creature_small_storegga"	"Kiesel"
"[english]npc_dota_creature_small_storegga"	"Pebble"
"npc_dota_creature_temple_guardian"	"Tempelwächter"
"[english]npc_dota_creature_temple_guardian"	"Temple Guardian"
"npc_dota_creature_morphling_big"	"Sturmflutelementar"
"[english]npc_dota_creature_morphling_big"	"Riptide Elemental"
"npc_dota_creature_tiny_crab"	"Kleiner Kneifer"
"[english]npc_dota_creature_tiny_crab"	"Little Pincher"
"npc_dota_creature_warlock"	"Dämonenbezwinger"
"[english]npc_dota_creature_warlock"	"Demon Charmer"
"npc_dota_creature_grimstroke"	"Verkannter Künstler"
"[english]npc_dota_creature_grimstroke"	"Misunderstood Artist"
"npc_dota_creature_life_stealer"	"Zahnfletscher"
"[english]npc_dota_creature_life_stealer"	"Toothy Toothums"
"npc_dota_creature_demon_golem"	"Verhexter Golem"
"[english]npc_dota_creature_demon_golem"	"Enthralled Golem"
"npc_dota_creature_bomber"	"Bomber"
"[english]npc_dota_creature_bomber"	"Bomber"
"npc_dota_creature_gyrocopter"	"Tollkühner Flieger"
"[english]npc_dota_creature_gyrocopter"	"Audacious Aeronaut"
"npc_dota_creature_gyrocopter_homing_missile"	"Zielsuchende Rakete"
"[english]npc_dota_creature_gyrocopter_homing_missile"	"Homing Missile"
"npc_dota_creature_zealot_scarab"	"Skarabäus-Fanatiker"
"[english]npc_dota_creature_zealot_scarab"	"Scarab Zealot"
"npc_dota_creature_zealot_mound"	"Eingegrabene Einheit"
"[english]npc_dota_creature_zealot_mound"	"Burrowed Unit"
"npc_dota_creature_scarab_priest"	"Skarabäus-Priester"
"[english]npc_dota_creature_scarab_priest"	"Scarab Priest"
"npc_dota_creature_rock_golem_a"	"Riesiger Steingolem"
"[english]npc_dota_creature_rock_golem_a"	"Giant Rock Golem"
"npc_dota_creature_rock_golem_b"	"Steingolem"
"[english]npc_dota_creature_rock_golem_b"	"Rock Golem"
"npc_dota_creature_rock_golem_c"	"Steingolem-Fragment"
"[english]npc_dota_creature_rock_golem_c"	"Rock Golem Fragment"
"npc_dota_creature_mirana"	"Herumtreiber des Nachtsilbers"
"[english]npc_dota_creature_mirana"	"Nightsilver Prowler"
"npc_dota_creature_alchemist"	"Al der Chemiker"
"[english]npc_dota_creature_alchemist"	"Al, the chemist"
"npc_dota_creature_broodmother"	"Seidenmorast-Spucker"
"[english]npc_dota_creature_broodmother"	"Silkmire Spitter"
"npc_dota_creature_huge_broodmother"	"Monströser Vielfraß"
"[english]npc_dota_creature_huge_broodmother"	"Monstrous Glutton"
"npc_dota_creature_newborn_spider"	"Seidenmorast-Schwärmer"
"[english]npc_dota_creature_newborn_spider"	"Silkmire Swarmer"
"npc_dota_creature_broodmother_baby"	"Winziger Spinnling"
"[english]npc_dota_creature_broodmother_baby"	"Tiny Spiderling"
"npc_dota_creature_broodmother_baby_b"	"Kleiner Spinnling"
"[english]npc_dota_creature_broodmother_baby_b"	"Small Spiderling"
"npc_dota_creature_broodmother_baby_c"	"Spinnling"
"[english]npc_dota_creature_broodmother_baby_c"	"Spiderling"
"npc_dota_creature_broodmother_baby_d"	"Pelziger Spinnling"
"[english]npc_dota_creature_broodmother_baby_d"	"Furry Spiderling"
"npc_dota_creature_kidnap_spider"	"Seidenmorast-Plünderer"
"[english]npc_dota_creature_kidnap_spider"	"Silkmire Marauder"
"npc_dota_creature_lina"	"Brennende Zauberin"
"[english]npc_dota_creature_lina"	"Inflamed Sorceress"
"npc_dota_creature_puck"	"Reverie"
"[english]npc_dota_creature_puck"	"Reverie"
"npc_dota_creature_wolf"	"Roter Wolf"
"[english]npc_dota_creature_wolf"	"Red Wolf"
"npc_dota_creature_large_elder_titan"	"Weltenvernichter"
"[english]npc_dota_creature_large_elder_titan"	"World Ender"
"npc_dota_creature_spectre"	"Ahnenseele"
"[english]npc_dota_creature_spectre"	"Soul Ascendant"
"npc_dota_creature_dragon_knight"	"Erfrorener Ritter"
"[english]npc_dota_creature_dragon_knight"	"Frostbitten Lord"
"npc_dota_creature_underlord"	"Obsidianteufel"
"[english]npc_dota_creature_underlord"	"Obsidian Devil"
"npc_dota_creature_pudge_miniboss"	"Portly"
"[english]npc_dota_creature_pudge_miniboss"	"Portly"
"npc_dota_creature_pudge_miniboss_minion"	"Kadaver"
"[english]npc_dota_creature_pudge_miniboss_minion"	"Cadaver"
"npc_dota_creature_friendly_ogre_tank"	"Grunch"
"[english]npc_dota_creature_friendly_ogre_tank"	"Grunch"
"npc_aghsfort_morty"	"Marty"
"[english]npc_aghsfort_morty"	"Marty"
"npc_dota_sled_penguin"	"Pinguin"
"[english]npc_dota_sled_penguin"	"Peng-wing"
"npc_dota_creature_bonus_chicken"	"Goldene Gans"
"[english]npc_dota_creature_bonus_chicken"	"Golden Goose"
"npc_dota_creature_bonus_greevil"	"Gieriger Gierling"
"[english]npc_dota_creature_bonus_greevil"	"Greedy Greevil"
"npc_dota_breathe_fire_trap"	"Odem des Rho"
"[english]npc_dota_breathe_fire_trap"	"Breath of Rho"
"npc_dota_arrow_trap"	"Herzsucher"
"[english]npc_dota_arrow_trap"	"Heartseeker"
"npc_dota_vase"	"Antike Vase"
"[english]npc_dota_vase"	"Antique Vase"
"npc_dota_crate"	"Holzkiste"
"[english]npc_dota_crate"	"Wooden Crate"
"npc_treasure_chest"	"Schatzkiste"
"[english]npc_treasure_chest"	"Treasure Chest"
"npc_dota_explosive_barrel"	"Explosives Fass"
"[english]npc_dota_explosive_barrel"	"Explosive Barrel"
"npc_aghsfort_dark_portal"	"Aghanims Portal"
"[english]npc_aghsfort_dark_portal"	"Aghanim's Portal"
"npc_dota_creature_ice_roshan"	"Frozhan"
"[english]npc_dota_creature_ice_roshan"	"Frozhan"
"npc_dota_creature_fire_roshan"	"Blazhan"
"[english]npc_dota_creature_fire_roshan"	"Blazhan"
"npc_dota_creature_baby_roshan"	"Roshling"
"[english]npc_dota_creature_baby_roshan"	"Roshling"
"npc_dota_creature_ogre_tank_boss"	"Bogdugg"
"[english]npc_dota_creature_ogre_tank_boss"	"Bogdugg"
"npc_dota_creature_ogre_seer"	"Knochenmehlschamane"
"[english]npc_dota_creature_ogre_seer"	"Bonemeal Seer"
"npc_dota_creature_phoenix"	"Glückliche Sonne"
"[english]npc_dota_creature_phoenix"	"Fortunate Sun"
"npc_dota_creature_ember_spirit"	"Flammenträger"
"[english]npc_dota_creature_ember_spirit"	"Flamebearer"
"npc_dota_creature_bandit"	"Sabaku-Dieb"
"[english]npc_dota_creature_bandit"	"Sabaku Thief"
"npc_dota_creature_bandit_archer"	"Sabaku-Bogenschütze"
"[english]npc_dota_creature_bandit_archer"	"Sabaku Archer"
"npc_dota_creature_bandit_captain"	"Sabaku-Anführer"
"[english]npc_dota_creature_bandit_captain"	"Sabaku Captain"
"npc_aghsfort_creature_wave_blaster_ghost"	"Eisgeist"
"[english]npc_aghsfort_creature_wave_blaster_ghost"	"Ice Spirit"
"npc_dota_creature_frost_kobold"	"Frostkobold"
"[english]npc_dota_creature_frost_kobold"	"Frost Kobold"
"npc_dota_creature_lich"	"Väterchen Frost"
"[english]npc_dota_creature_lich"	"Old Ice Lord"
"npc_dota_creature_dark_seer"	"Verdorbener Seher"
"[english]npc_dota_creature_dark_seer"	"Corrupted Seer"
"npc_dota_undead_woods_skeleton_king"	"König der Knochen"
"[english]npc_dota_undead_woods_skeleton_king"	"King of the Bones"
"npc_dota_creature_upheaval_urn"	"Urne der Verdammten"
"[english]npc_dota_creature_upheaval_urn"	"Urn of the Damned"
"npc_dota_creature_shadow_demon"	"Dämonischer Verbanner"
"[english]npc_dota_creature_shadow_demon"	"Demonic Banisher"
"npc_dota_creature_doom"	"Dämonenbiest"
"[english]npc_dota_creature_doom"	"Demon Brute"
"npc_dota_creature_necro_warrior"	"Teuflischer Speichellecker"
"[english]npc_dota_creature_necro_warrior"	"Infernal Lickspittle"
"npc_dota_creature_drow_ranger_skeleton_archer"	"Skelettbogenschütze"
"[english]npc_dota_creature_drow_ranger_skeleton_archer"	"Skeleton Archer"
"npc_dota_creature_drow_ranger_skeleton_warrior"	"Skelettkrieger"
"[english]npc_dota_creature_drow_ranger_skeleton_warrior"	"Skeleton Warrior"
"npc_dota_creature_beastmaster_boss"	"Pelzhändler"
"[english]npc_dota_creature_beastmaster_boss"	"Fur Trader"
"npc_dota_creature_beastmaster_boar"	"Pelzspender"
"[english]npc_dota_creature_beastmaster_boar"	"Fur Contributor"
"npc_dota_creature_troll_warlord_melee"	"Handelspostenschläger"
"[english]npc_dota_creature_troll_warlord_melee"	"Trading Post Brute"
"npc_dota_cage"	"Tierkäfig"
"[english]npc_dota_cage"	"Animal Cage"
"npc_dota_creature_sheep_hostage"	"Schaf"
"[english]npc_dota_creature_sheep_hostage"	"Sheep"
"npc_dota_creature_gladiator_creep"	"Amateur"
"[english]npc_dota_creature_gladiator_creep"	"Amateur"
"npc_dota_creature_skywrath_mage"	"Neuling"
"[english]npc_dota_creature_skywrath_mage"	"Rookie"
"npc_dota_creature_legion_commander"	"Champion"
"[english]npc_dota_creature_legion_commander"	"All Star"
"npc_dota_creature_shroom_giant"	"Pilzriese"
"[english]npc_dota_creature_shroom_giant"	"Shroom Giant"
"npc_dota_creature_naga_siren_illusion"	"Erster Akt"
"[english]npc_dota_creature_naga_siren_illusion"	"Opening Act"
"npc_dota_underwater_mine"	"Malorkianische Minen"
"[english]npc_dota_underwater_mine"	"Bobbin' for Apples"
"npc_dota_creature_elemental_io"	"Elementarirrwisch"
"[english]npc_dota_creature_elemental_io"	"Elemental Wisp"
"npc_dota_creature_catapult"	"Sturmschleuder"
"[english]npc_dota_creature_catapult"	"Assault Catapult"
"npc_dota_creature_tidehunter_mini"	"Strandbarsch"
"[english]npc_dota_creature_tidehunter_mini"	"Beach Comber"
"npc_dota_creature_tidehunter_medium"	"Schildkrötentrupp"
"[english]npc_dota_creature_tidehunter_medium"	"Turtle Patrol"
"npc_dota_creature_tidehunter_large"	"Meeresbiologe"
"[english]npc_dota_creature_tidehunter_large"	"Ocean Guide"
"npc_dota_creature_kunkka_medium"	"Naturschützer"
"[english]npc_dota_creature_kunkka_medium"	"Conservationist"
"npc_dota_shop_keeper"	"Reisender Händler"
"[english]npc_dota_shop_keeper"	"Traveling Merchant"
"npc_dota_creature_aghanim_minion"	"Splittergolem"
"[english]npc_dota_creature_aghanim_minion"	"Shard Golem"
"npc_dota_boss_aghanim_crystal"	"Zaubersplitter"
"[english]npc_dota_boss_aghanim_crystal"	"Spell Shard"
"npc_dota_dummy_caster"	"Henry, Aghanims Assistent"
"[english]npc_dota_dummy_caster"	"Aghanim's Assistant, Henry"
"npc_aghsfort_creature_bomb_squad"	"Bombentruppe"
"[english]npc_aghsfort_creature_bomb_squad"	"Bomb Squad"
"npc_aghsfort_creature_enraged_wildwing"	"Wütender Vogel"
"[english]npc_aghsfort_creature_enraged_wildwing"	"Angry Bird"
"npc_aghsfort_creature_tornado_harpy"	"Tornadoharpyie"
"[english]npc_aghsfort_creature_tornado_harpy"	"Tornado Harpy"
"npc_dota_boss_timbersaw"	"Rizzrick"
"[english]npc_dota_boss_timbersaw"	"Rizzrick"
"npc_dota_creature_timbersaw_treant"	"Kleiner Ent"
"[english]npc_dota_creature_timbersaw_treant"	"Little Ent"
"npc_dota_boss_void_spirit"	"Schatten von Inai"
"[english]npc_dota_boss_void_spirit"	"Shadow of Inai"
"npc_dota_earth_spirit_boss"	"Kaolin-Wächter"
"[english]npc_dota_earth_spirit_boss"	"Kaolin Guardian"
"npc_dota_boss_visage"	"Wächter des Verschlungenen Labyrinths"
"[english]npc_dota_boss_visage"	"Warden of the Narrow Maze"
"npc_dota_boss_visage_familiar"	"Verlorenes Gespenst"
"[english]npc_dota_boss_visage_familiar"	"Lost Revenant"
"npc_dota_boss_visage_familiar_state"	"Aufseher des Labyrinths"
"[english]npc_dota_boss_visage_familiar_state"	"Maze Watcher"
"DOTA_Tooltip_Ability_item_health_potion"	"Heiltrank"
"[english]DOTA_Tooltip_Ability_item_health_potion"	"Health Potion"
"DOTA_Tooltip_Ability_item_mana_potion"	"Manatrank"
"[english]DOTA_Tooltip_Ability_item_mana_potion"	"Mana Potion"
"DOTA_Tooltip_ability_item_bag_of_gold"	"Sack voll Gold"
"[english]DOTA_Tooltip_ability_item_bag_of_gold"	"Bag of Gold"
"DOTA_Tooltip_Ability_item_life_rune"	"Lebensrune"
"[english]DOTA_Tooltip_Ability_item_life_rune"	"Life Rune"
"DOTA_Tooltip_Ability_item_small_scepter_fragment"	"Kleiner Zeptersplitter"
"[english]DOTA_Tooltip_Ability_item_small_scepter_fragment"	"Small Scepter Shard"
"DOTA_Tooltip_ability_item_tombstone"	"Teammitglied wiederbeleben"
"[english]DOTA_Tooltip_ability_item_tombstone"	"Resurrect Teammate"
"DOTA_Chat_Tombstone_Pinged"	"Gefallenes Teammitglied hier."
"[english]DOTA_Chat_Tombstone_Pinged"	"Fallen teammate here."
"Aghanim_FoundChestItem"	"{s:player_name} hat einen Schatz gefunden: {s:locstring_value}"
"[english]Aghanim_FoundChestItem"	"{s:player_name} found a treasure containing: {s:locstring_value}"
"Aghanim_FoundChestGold"	"{s:player_name} hat einen Schatz gefunden: <font color='#ffd825'>{s:value}</font><panel class='CombatEventGoldIcon'/>"
"[english]Aghanim_FoundChestGold"	"{s:player_name} found a treasure containing: <font color='#ffd825'>{s:value}</font><panel class='CombatEventGoldIcon'/>"
"Aghanim_FoundChestTrap"	"{s:player_name} hat einen Schatz gefunden: <font color='#ffd825'>{s:locstring_value}</font>!"
"[english]Aghanim_FoundChestTrap"	"{s:player_name} found a treasure containing: <font color='#ffd825'>{s:locstring_value}</font>!"
"Aghanim_FoundLifeRune"	"{s:player_name} hat eine {s:locstring_value} gefunden!"
"[english]Aghanim_FoundLifeRune"	"{s:player_name} found a {s:locstring_value}!"
"Aghanim_FoundItem"	"{s:player_name} hat einen neuen Gegenstand gefunden: <font color='#4ae0bf'>{s:locstring_value}</font>!"
"[english]Aghanim_FoundItem"	"{s:player_name} found a new item: <font color='#4ae0bf'>{s:locstring_value}</font>!"
"Aghanim_FoundConsumableItem"	"{s:player_name} hat einen Konsumgegenstand gefunden: <font color='#0CF1F1'>{s:locstring_value}</font>!"
"[english]Aghanim_FoundConsumableItem"	"{s:player_name} found a consumable item: <font color='#0CF1F1'>{s:locstring_value}</font>!"
"Aghanim_KilledByCreature"	"{s:player_name} wurde von {s:locstring_value} getötet"
"[english]Aghanim_KilledByCreature"	"{s:player_name} was killed by {s:locstring_value}"
"Aghanim_BattlePointsFound"	"{s:player_name} hat {d:int_value} Schlachtenpunkte für das Team gefunden!"
"[english]Aghanim_BattlePointsFound"	"{s:player_name} found {d:int_value} Battle Points for the team!"
"Aghanim_ArcaneFragmentsFound"	"{s:player_name} hat {d:int_value} Arkanfragmente für das Team gefunden!"
"[english]Aghanim_ArcaneFragmentsFound"	"{s:player_name} found {d:int_value} Arcane Fragments for the team!"
"DOTA_Tooltip_ability_item_bottle_Description"	"<h1>Aktiv: Regeneration</h1>Ihr Held nimmt einen Schluck und regeneriert über %restore_time% Sekunden %health_restore_pct% %% der maximalen Lebenspunkte und %mana_restore_pct% %% des maximalen Manavorrats."
"[english]DOTA_Tooltip_ability_item_bottle_Description"	"<h1>Active: Regenerate</h1>Consumes a charge to restore %health_restore_pct%%% max health and %mana_restore_pct%%% max mana over %restore_time% seconds.  At the end of each encounter, a charge is restored."
"DOTA_Tooltip_ability_item_bottle_max_charges"	"MAX. AUFLADUNGEN:"
"[english]DOTA_Tooltip_ability_item_bottle_max_charges"	"MAX CHARGES:"
"DOTA_Tooltip_ability_item_shadow_amulet_Description"	"<h1>Aktiv: Verblassen</h1>Sie oder der ausgewählte verbündete Held werden nach %fade_time% Sekunden unsichtbar. <br><br>Bewegung hebt die Unsichtbarkeit wieder auf. Reichweite: %abilitycastrange%"
"[english]DOTA_Tooltip_ability_item_shadow_amulet_Description"	"<h1>Active: Fade</h1>Grants invisibility to you or a target allied hero as long as the target unit remains still.  <br><br>Has a %fade_time% second fade time, and breaks instantly upon moving. Range: %abilitycastrange%"
"DOTA_Tooltip_ability_item_shadow_amulet_fade_duration"	"MAX. ÜBERGANGSZEIT:"
"[english]DOTA_Tooltip_ability_item_shadow_amulet_fade_duration"	"MAX FADE TIME:"
"DOTA_Tooltip_ability_item_vladmir_Lore"	"Eine unheimliche Maske, die mit der Böswilligkeit eines gefallenen Vampirs verflucht ist."
"[english]DOTA_Tooltip_ability_item_vladmir_Lore"	"An eerie mask that is haunted with the malice of a fallen vampire."
"DOTA_Tooltip_modifier_item_vladmir_aura"	"Vladmirs Aura"
"[english]DOTA_Tooltip_modifier_item_vladmir_aura"	"Vladmir's Aura"
"DOTA_Tooltip_ability_item_satanic_Description"	"<h1>Aktiv: Gottlose Wut</h1>Erhöht für %unholy_duration% Sekunden den Lebensraub um <font color='#F40000'>%unholy_lifesteal_total_tooltip% %%</font>.\n<h1>Passiv: Lebensraub</h1>Heilt den Angreifer um <font color='#F40000'>%lifesteal_percent% %%</font> des ausgeteilten Angriffsschadens."
"[english]DOTA_Tooltip_ability_item_satanic_Description"	"<h1>Active: Unholy Rage</h1>Increases Lifesteal percentage to <font color='#F40000'>%unholy_lifesteal_total_tooltip%%%</font> for %unholy_duration% seconds. \n<h1>Passive: Lifesteal</h1>Heals the attacker for <font color='#F40000'>%lifesteal_percent%%%</font> of attack damage dealt."
"DOTA_Tooltip_ability_item_satanic_Lore"	"Ungeheure Macht auf Kosten Ihrer Seele."
"[english]DOTA_Tooltip_ability_item_satanic_Lore"	"Immense power at the cost of your soul."
"DOTA_Tooltip_ability_item_satanic_bonus_strength"	"+$str"
"[english]DOTA_Tooltip_ability_item_satanic_bonus_strength"	"+$str"
"DOTA_Tooltip_ability_item_satanic_bonus_damage"	"+$damage"
"[english]DOTA_Tooltip_ability_item_satanic_bonus_damage"	"+$damage"
"DOTA_Tooltip_ability_item_satanic_status_resistance"	"%+Statusresistenz"
"[english]DOTA_Tooltip_ability_item_satanic_status_resistance"	"%+Status Resistance"
"DOTA_Tooltip_modifier_item_satanic_unholy"	"Gottlose Wut"
"[english]DOTA_Tooltip_modifier_item_satanic_unholy"	"Unholy Rage"
"DOTA_Tooltip_modifier_item_satanic_unholy_Description"	"Lebensraub um <font color='#F40000'>%dMODIFIER_PROPERTY_TOOLTIP% %%</font> erhöht."
"[english]DOTA_Tooltip_modifier_item_satanic_unholy_Description"	"Lifesteal increased by <font color='#F40000'>%dMODIFIER_PROPERTY_TOOLTIP%%%</font>."
"DOTA_Tooltip_modifier_creature_pudge_miniboss_armor_corruption_debuff_Description"	"Verliert %dMODIFIER_PROPERTY_PHYSICAL_ARMOR_BONUS% Rüstung."
"[english]DOTA_Tooltip_modifier_creature_pudge_miniboss_armor_corruption_debuff_Description"	"Losing %dMODIFIER_PROPERTY_PHYSICAL_ARMOR_BONUS% armor."
"DOTA_Tooltip_Ability_aghanim_empty_spell1"	"Fähigkeit gesperrt"
"[english]DOTA_Tooltip_Ability_aghanim_empty_spell1"	"Ability Locked"
"DOTA_Tooltip_Ability_aghanim_empty_spell1_Description"	"Aghanim hat Ihre Fähigkeit gesperrt – zerstören Sie den Splitter, um sie zurückzuerhalten!"
"[english]DOTA_Tooltip_Ability_aghanim_empty_spell1_Description"	"Aghanim has locked your ability - destroy the shard to get it back!"
"DOTA_Tooltip_Ability_aghanim_empty_spell2"	"Fähigkeit gesperrt"
"[english]DOTA_Tooltip_Ability_aghanim_empty_spell2"	"Ability Locked"
"DOTA_Tooltip_Ability_aghanim_empty_spell2_Description"	"Aghanim hat Ihre Fähigkeit gesperrt – zerstören Sie den Splitter, um sie zurückzuerhalten!"
"[english]DOTA_Tooltip_Ability_aghanim_empty_spell2_Description"	"Aghanim has locked your ability - destroy the shard to get it back!"
"DOTA_Tooltip_Ability_aghanim_empty_spell3"	"Fähigkeit gesperrt"
"[english]DOTA_Tooltip_Ability_aghanim_empty_spell3"	"Ability Locked"
"DOTA_Tooltip_Ability_aghanim_empty_spell3_Description"	"Aghanim hat Ihre Fähigkeit gesperrt – zerstören Sie den Splitter, um sie zurückzuerhalten!"
"[english]DOTA_Tooltip_Ability_aghanim_empty_spell3_Description"	"Aghanim has locked your ability - destroy the shard to get it back!"
"DOTA_Tooltip_Ability_aghanim_empty_spell4"	"Fähigkeit gesperrt"
"[english]DOTA_Tooltip_Ability_aghanim_empty_spell4"	"Ability Locked"
"DOTA_Tooltip_Ability_aghanim_empty_spell4_Description"	"Aghanim hat Ihre Fähigkeit gesperrt – zerstören Sie den Splitter, um sie zurückzuerhalten!"
"[english]DOTA_Tooltip_Ability_aghanim_empty_spell4_Description"	"Aghanim has locked your ability - destroy the shard to get it back!"
"DOTA_Tooltip_modifier_aghanim_spell_swap"	"Fähigkeit gesperrt"
"[english]DOTA_Tooltip_modifier_aghanim_spell_swap"	"Ability Locked"
"DOTA_Tooltip_modifier_aghanim_spell_swap_Description"	"Aghanim hat Ihre Fähigkeit gesperrt – zerstören Sie den Splitter, um sie zurückzuerhalten!"
"[english]DOTA_Tooltip_modifier_aghanim_spell_swap_Description"	"Aghanim has locked your ability - destroy the shard to get it back!"
"DOTA_Tooltip_modifier_aghanim_crystal_attack_debuff"	"Kristallkühlung"
"[english]DOTA_Tooltip_modifier_aghanim_crystal_attack_debuff"	"Crystal Chill"
"DOTA_Tooltip_ability_creature_brewmaster_fire_permanent_immolation"	"Feueraura"
"[english]DOTA_Tooltip_ability_creature_brewmaster_fire_permanent_immolation"	"Permanent Immolation"
"DOTA_Tooltip_ability_creature_brewmaster_fire_permanent_immolation_Lore"	"
"
"[english]DOTA_Tooltip_ability_creature_brewmaster_fire_permanent_immolation_Lore"	""
"DOTA_Tooltip_ability_creature_brewmaster_fire_permanent_immolation_Description"	"Verbrennt in der Nähe befindliche gegnerische Einheiten."
"[english]DOTA_Tooltip_ability_creature_brewmaster_fire_permanent_immolation_Description"	"Burns nearby enemy units."
"DOTA_Tooltip_ability_creature_brewmaster_fire_permanent_immolation_damage"	"SCHADEN PRO SEKUNDE:"
"[english]DOTA_Tooltip_ability_creature_brewmaster_fire_permanent_immolation_damage"	"DAMAGE PER SECOND:"
"DOTA_Tooltip_ability_creature_brewmaster_fire_permanent_immolation_radius"	"RADIUS:"
"[english]DOTA_Tooltip_ability_creature_brewmaster_fire_permanent_immolation_radius"	"RADIUS:"
"DOTA_Tooltip_Ability_item_greater_salve"	"Große Salbe"
"[english]DOTA_Tooltip_Ability_item_greater_salve"	"Greater Salve"
"DOTA_Tooltip_ability_item_greater_salve_Description"	"<h1>Benutzen: Salbe</h1> Das Ziel regeneriert für %buff_duration% Sekunden %hp_per_tick% Lebenspunkte pro Sekunde.<br><br>Wenn das Ziel von einem gegnerischen Helden oder Roshan Schaden zugefügt bekommt, geht der Effekt verloren.<br><br>Reichweite: %abilitycastrange%"
"[english]DOTA_Tooltip_ability_item_greater_salve_Description"	"<h1>Use: Salve</h1> Grants %hp_per_tick% health regeneration to the target for %buff_duration% seconds.<br><br>If the unit is attacked by an enemy hero or Roshan, the effect is lost.<br><br>Range: %abilitycastrange%"
"DOTA_Tooltip_ability_item_greater_salve_Lore"	"Eine magische Salbe, die sogar die tiefsten Wunden schnell heilen kann."
"[english]DOTA_Tooltip_ability_item_greater_salve_Lore"	"A magical salve that can quickly mend even the deepest of wounds."
"DOTA_Tooltip_modifier_item_greater_salve_Description"	"Diese Einheit regeneriert Lebenspunkte."
"[english]DOTA_Tooltip_modifier_item_greater_salve_Description"	"This unit is regenerating health."
"DOTA_Tooltip_ability_item_greater_clarity_Lore"	"Klares Wasser, das die Meditationsfähigkeit verstärkt."
"[english]DOTA_Tooltip_ability_item_greater_clarity_Lore"	"Clear water that enhances the ability to meditate."
"DOTA_Tooltip_modifier_item_greater_clarity_Description"	"Diese Einheit regeneriert Mana."
"[english]DOTA_Tooltip_modifier_item_greater_clarity_Description"	"This unit is regenerating mana."
"DOTA_Tooltip_Ability_item_double_damage_potion"	"Trank des doppelten Schadens"
"[english]DOTA_Tooltip_Ability_item_double_damage_potion"	"Double Damage Potion"
"DOTA_Tooltip_Ability_item_double_damage_potion_Description"	"Verdoppelt für %buff_duration% Sekunden den Angriffsschaden."
"[english]DOTA_Tooltip_Ability_item_double_damage_potion_Description"	"Grants double damage for %buff_duration% seconds."
"DOTA_Tooltip_modifier_item_double_damage_potion"	"Trank des doppelten Schadens"
"[english]DOTA_Tooltip_modifier_item_double_damage_potion"	"Double Damage Potion"
"DOTA_Tooltip_modifier_item_double_damage_potion_Description"	"Diese Einheit verursacht doppelten Schaden."
"[english]DOTA_Tooltip_modifier_item_double_damage_potion_Description"	"This unit has double damage."
"DOTA_Tooltip_Ability_item_spell_amp_potion"	"Trank der Zauberverstärkung"
"[english]DOTA_Tooltip_Ability_item_spell_amp_potion"	"Spell Amp Potion"
"DOTA_Tooltip_modifier_item_spell_amp_potion"	"Trank der Zauberverstärkung"
"[english]DOTA_Tooltip_modifier_item_spell_amp_potion"	"Spell Amp Potion"
"DOTA_Tooltip_Ability_item_evasion_potion"	"Trank des Ausweichens"
"[english]DOTA_Tooltip_Ability_item_evasion_potion"	"Evasion Potion"
"DOTA_Tooltip_Ability_item_evasion_potion_Description"	"Gewährt für %buff_duration% Sekunden eine %evasion_bonus_pct%%%ige Chance, Angriffen auszuweichen."
"[english]DOTA_Tooltip_Ability_item_evasion_potion_Description"	"Grants %evasion_bonus_pct%%% bonus evasion for %buff_duration% seconds."
"DOTA_Tooltip_modifier_item_evasion_potion"	"Trank des Ausweichens"
"[english]DOTA_Tooltip_modifier_item_evasion_potion"	"Evasion Potion"
"DOTA_Tooltip_modifier_item_evasion_potion_Description"	"Diese Einheit weicht allen Angriffen aus."
"[english]DOTA_Tooltip_modifier_item_evasion_potion_Description"	"This unit has 100 bonus evasion."
"DOTA_Tooltip_Ability_item_purification_potion"	"Trank der Reinigung"
"[english]DOTA_Tooltip_Ability_item_purification_potion"	"Purification Potion"
"DOTA_Tooltip_Ability_item_purification_potion_Description"	"<h1>Benutzen: Große Reinigung</h1>Heilt Sie sofort um %heal% und fügt in der Nähe befindlichen Gegnern %heal% Schaden zu."
"[english]DOTA_Tooltip_Ability_item_purification_potion_Description"	"<h1>Use: Greater Purification</h1>Instantly heals you for %heal% health and damages enemies around you for %heal%."
"DOTA_Tooltip_ability_item_purification_potion_heal"	"HEILUNG/SCHADEN:"
"[english]DOTA_Tooltip_ability_item_purification_potion_heal"	"HEAL/DAMAGE:"
"DOTA_Tooltip_ability_item_purification_potion_radius"	"SCHADENSRADIUS:"
"[english]DOTA_Tooltip_ability_item_purification_potion_radius"	"DAMAGE RADIUS:"
"DOTA_Tooltip_Ability_item_ravage_potion"	"Trank der Verwüstung"
"[english]DOTA_Tooltip_Ability_item_ravage_potion"	"Ravage Potion"
"DOTA_Tooltip_ability_item_ravage_potion_radius"	"RADIUS:"
"[english]DOTA_Tooltip_ability_item_ravage_potion_radius"	"RADIUS:"
"DOTA_Tooltip_ability_item_ravage_potion_duration"	"DAUER:"
"[english]DOTA_Tooltip_ability_item_ravage_potion_duration"	"DURATION:"
"DOTA_Tooltip_ability_item_dragon_potion_duration"	"DAUER:"
"[english]DOTA_Tooltip_ability_item_dragon_potion_duration"	"DURATION:"
"DOTA_Tooltip_ability_item_dragon_potion_bonus_movement_speed"	"BONUSBEWEGUNGSTEMPO:"
"[english]DOTA_Tooltip_ability_item_dragon_potion_bonus_movement_speed"	"BONUS MOVE SPEED:"
"DOTA_Tooltip_ability_item_dragon_potion_bonus_attack_range"	"BONUSANGRIFFSREICHWEITE:"
"[english]DOTA_Tooltip_ability_item_dragon_potion_bonus_attack_range"	"BONUS ATTACK RANGE:"
"DOTA_Tooltip_ability_item_dragon_potion_bonus_attack_damage"	"BONUSSCHADEN:"
"[english]DOTA_Tooltip_ability_item_dragon_potion_bonus_attack_damage"	"BONUS DAMAGE:"
"DOTA_Tooltip_ability_item_dragon_potion_magic_resistance"	"MAGIERESISTENZ:"
"[english]DOTA_Tooltip_ability_item_dragon_potion_magic_resistance"	"MAGIC RESISTANCE:"
"DOTA_Tooltip_ability_item_dragon_potion_splash_radius"	"RADIUS (FLÄCHENSCHADEN):"
"[english]DOTA_Tooltip_ability_item_dragon_potion_splash_radius"	"SPLASH RADIUS:"
"DOTA_Tooltip_ability_item_arcanist_potion_duration"	"DAUER:"
"[english]DOTA_Tooltip_ability_item_arcanist_potion_duration"	"DURATION:"
"DOTA_Tooltip_ability_item_arcanist_potion_cooldown_reduction_pct"	"%ABKLINGZEITREDUZIERUNG:"
"[english]DOTA_Tooltip_ability_item_arcanist_potion_cooldown_reduction_pct"	"%COOLDOWN REDUCTION:"
"DOTA_Tooltip_ability_item_echo_slam_potion_echo_slam_echo_damage"	"ECHOSCHADEN:"
"[english]DOTA_Tooltip_ability_item_echo_slam_potion_echo_slam_echo_damage"	"ECHO DAMAGE:"
"DOTA_Tooltip_ability_item_echo_slam_potion_echo_slam_damage_range"	"RADIUS:"
"[english]DOTA_Tooltip_ability_item_echo_slam_potion_echo_slam_damage_range"	"RADIUS:"
"DOTA_Tooltip_ability_item_echo_slam_potion_echo_slam_initial_damage"	"GRUNDSCHADEN:"
"[english]DOTA_Tooltip_ability_item_echo_slam_potion_echo_slam_initial_damage"	"INITIAL DAMAGE:"
"DOTA_Tooltip_ability_item_torrent_effect_potion_stun_duration"	"BETÄUBUNGSDAUER:"
"[english]DOTA_Tooltip_ability_item_torrent_effect_potion_stun_duration"	"STUN DURATION:"
"DOTA_Tooltip_ability_item_shadow_wave_effect_potion_Note0"	"Zieht verbündete Helden gegenüber Dienern vor."
"[english]DOTA_Tooltip_ability_item_shadow_wave_effect_potion_Note0"	"Prioritizes allied heroes over creeps."
"DOTA_Tooltip_ability_item_shadow_wave_effect_potion_Note1"	"Wenn sich ein Gegner in der Nähe mehrerer Einheiten befindet, während diese durch die Schattenwelle geheilt werden, erleidet er mehrfachen Schaden."
"[english]DOTA_Tooltip_ability_item_shadow_wave_effect_potion_Note1"	"If enemies are near multiple allied units affected by Shadow Wave, they will take multiple instances of damage."
"DOTA_Tooltip_ability_item_shadow_wave_effect_potion_cast_range"	"REICHWEITE:"
"[english]DOTA_Tooltip_ability_item_shadow_wave_effect_potion_cast_range"	"RANGE:"
"DOTA_Tooltip_ability_item_shadow_wave_effect_potion_damage_radius"	"SCHADENSRADIUS:"
"[english]DOTA_Tooltip_ability_item_shadow_wave_effect_potion_damage_radius"	"DAMAGE RADIUS:"
"DOTA_Tooltip_ability_item_shadow_wave_effect_potion_damage"	"HEILUNG/SCHADEN:"
"[english]DOTA_Tooltip_ability_item_shadow_wave_effect_potion_damage"	"HEAL/DAMAGE:"
"DOTA_Tooltip_modifier_bonus_room_start"	"Bonusraum"
"[english]DOTA_Tooltip_modifier_bonus_room_start"	"Bonus Room"
"DOTA_Tooltip_Ability_item_aghsfort_refresher_shard_lore"	"Auch nach einer Ära der unentwegten Kämpfe ist der Siegeswille der Unsterblichen ungebrochen."
"[english]DOTA_Tooltip_Ability_item_aghsfort_refresher_shard_lore"	"Across an epoch of endless battle, the Immortal's will to triumph never faltered."
"DOTA_Tooltip_modifier_aghsfort_firefly"	"Feuerteufel"
"[english]DOTA_Tooltip_modifier_aghsfort_firefly"	"Pyromaniac"
"DOTA_Tooltip_modifier_ascension_crit"	"Glückstreffer"
"[english]DOTA_Tooltip_modifier_ascension_crit"	"Lucky Strike"
"DOTA_Tooltip_modifier_ascension_magic_resist_Description"	"Diese Einheit hat %dMODIFIER_PROPERTY_MAGICAL_RESISTANCE_BONUS%&nbsp;%% zusätzliche Magieresistenz."
"[english]DOTA_Tooltip_modifier_ascension_magic_resist_Description"	"This unit has %dMODIFIER_PROPERTY_MAGICAL_RESISTANCE_BONUS%%% additional magic resist."
"DOTA_Tooltip_modifier_ascension_plasma_field_display"	"Galvanischer Abschied"
"[english]DOTA_Tooltip_modifier_ascension_plasma_field_display"	"Galvanic Farewell"
"DOTA_Tooltip_modifier_ascension_flicker_display"	"Blitzen"
"[english]DOTA_Tooltip_modifier_ascension_flicker_display"	"Flicker"
"DOTA_Tooltip_modifier_ascension_armor_sapping_display"	"Todesfluch"
"[english]DOTA_Tooltip_modifier_ascension_armor_sapping_display"	"Death Curse"
"DOTA_Tooltip_modifier_aghsfort_ascension_silence"	"Ruhe bitte!"
"[english]DOTA_Tooltip_modifier_aghsfort_ascension_silence"	"Quiet, please!"
"DOTA_Tooltip_modifier_aghsfort_ascension_silence_Description"	"Kann keine Zauber einsetzen."
"[english]DOTA_Tooltip_modifier_aghsfort_ascension_silence_Description"	"Cannot cast spells."
"DOTA_Tooltip_modifier_aghsfort_ascension_silence_display"	"Ruhe bitte!"
"[english]DOTA_Tooltip_modifier_aghsfort_ascension_silence_display"	"Quiet, please!"
"DOTA_Tooltip_modifier_aghsfort_ascension_magnetic_field_evasion"	"Leben in einer Blase"
"[english]DOTA_Tooltip_modifier_aghsfort_ascension_magnetic_field_evasion"	"Living In A Bubble"
"DOTA_Tooltip_modifier_ascension_drunken_display"	"Betrunken"
"[english]DOTA_Tooltip_modifier_ascension_drunken_display"	"Drunken"
"DOTA_Tooltip_modifier_ascension_damage"	"Tödlich"
"[english]DOTA_Tooltip_modifier_ascension_damage"	"Deadly"
"DOTA_Tooltip_modifier_ascension_attack_speed"	"Letztes Gefecht"
"[english]DOTA_Tooltip_modifier_ascension_attack_speed"	"Last Stand"
"DOTA_Tooltip_modifier_ascension_magic_immunity"	"Avatar"
"[english]DOTA_Tooltip_modifier_ascension_magic_immunity"	"Avatar"
"DOTA_Tooltip_modifier_ascension_armor"	"Dickhäutig"
"[english]DOTA_Tooltip_modifier_ascension_armor"	"Thick Skinned"
"DOTA_Tooltip_modifier_ascension_armor_Description"	"Rüstung um %dMODIFIER_PROPERTY_PHYSICAL_ARMOR_BONUS% erhöht."
"[english]DOTA_Tooltip_modifier_ascension_armor_Description"	"Armor increased by %dMODIFIER_PROPERTY_PHYSICAL_ARMOR_BONUS%"
"DOTA_Tooltip_modifier_ascension_extra_fast_Description"	"%dMODIFIER_PROPERTY_MOVESPEED_BONUS_PERCENTAGE% %% erhöhtes Bewegungstempo, das nicht verlangsamt werden kann."
"[english]DOTA_Tooltip_modifier_ascension_extra_fast_Description"	"%dMODIFIER_PROPERTY_MOVESPEED_BONUS_PERCENTAGE%%% increased movement speed and cannot be slowed."
"DOTA_Tooltip_modifier_ascension_vampiric"	"Vampirisch"
"[english]DOTA_Tooltip_modifier_ascension_vampiric"	"Vampiric"
"DOTA_Tooltip_modifier_ascension_vampiric_Description"	"%dMODIFIER_PROPERTY_TOOLTIP% %% Lebensraub."
"[english]DOTA_Tooltip_modifier_ascension_vampiric_Description"	"%dMODIFIER_PROPERTY_TOOLTIP%%% lifesteal."
"DOTA_Tooltip_modifier_battle_royale_damage"	"Aghanims Enttäuschung"
"[english]DOTA_Tooltip_modifier_battle_royale_damage"	"Aghanim's Disappointment"
"DOTA_Tooltip_modifier_sand_king_boss_caustic_finale"	"Ätzendes Finale"
"[english]DOTA_Tooltip_modifier_sand_king_boss_caustic_finale"	"Caustic Finale"
"DOTA_Tooltip_modifier_lifestealer_damage_counter"	"Aufkochender Zorn"
"[english]DOTA_Tooltip_modifier_lifestealer_damage_counter"	"Brewing Rage"
"DOTA_Tooltip_modifier_lifestealer_damage_counter_Description"	"Verfällt in Raserei, wenn in kurzer Zeit viel Schaden erlitten wird."
"[english]DOTA_Tooltip_modifier_lifestealer_damage_counter_Description"	"Enrages when receiving heavy damage in a short period."
"DOTA_Tooltip_modifier_lifestealer_enraged"	"Erzürnt"
"[english]DOTA_Tooltip_modifier_lifestealer_enraged"	"Enraged"
"DOTA_Tooltip_modifier_lifestealer_enraged_Description"	"Hat stark erhöhtes Bewegungs- und Angriffstempo."
"[english]DOTA_Tooltip_modifier_lifestealer_enraged_Description"	"Has greatly increased movement speed and attack speed."
"DOTA_Tooltip_ability_morty_hop"	"Keks verfüttern"
"[english]DOTA_Tooltip_ability_morty_hop"	"Feed Cookie"
"DOTA_Tooltip_ability_morty_hop_Description"	"Füttern Sie Marty mit einem Keks! Je länger Sie kanalisieren, desto weiter geht Ihr Sprung!"
"[english]DOTA_Tooltip_ability_morty_hop_Description"	"Feed Marty a cookie!  The longer you channel, the farther your jump goes!"
"DOTA_Tooltip_ability_aghsfort_luna_lucent_beam_Description"	"Luna lässt einen gebündelten Strahl aus Mondenergie auf <font color='#70EA72'>Gegner im Umkreis von %radius% Einheiten um das Ziel</font> niederfahren, der den Zielen Schaden zufügt und sie kurz betäubt."
"[english]DOTA_Tooltip_ability_aghsfort_luna_lucent_beam_Description"	"Calls a beam of lunar energy down upon <font color='#70EA72'>enemies within %radius% units of the target</font>, damaging and briefly stunning them."
"DOTA_Tooltip_ability_aghsfort_luna_lucent_beam_Lore"	"Selemene zerschmettert all jene, welche den Boden der Nachtsilberwälder beschmutzen."
"[english]DOTA_Tooltip_ability_aghsfort_luna_lucent_beam_Lore"	"Selemene smites those who encroach upon the Nightsilver Woods."
"DOTA_Tooltip_ability_aghsfort_luna_lucent_beam_stun_duration"	"BETÄUBUNGSDAUER:"
"[english]DOTA_Tooltip_ability_aghsfort_luna_lucent_beam_stun_duration"	"STUN DURATION:"
"DOTA_Tooltip_ability_aghsfort_luna_lucent_beam_radius"	"<font color='#70EA72'>RADIUS:</font>"
"[english]DOTA_Tooltip_ability_aghsfort_luna_lucent_beam_radius"	"<font color='#70EA72'>RADIUS:</font>"
"DOTA_Tooltip_ability_aghsfort_luna_eclipse"	"Eklipse"
"[english]DOTA_Tooltip_ability_aghsfort_luna_eclipse"	"Eclipse"
"DOTA_Tooltip_ability_aghsfort_luna_eclipse_Lore"	"In Zeiten großer Not steigt Selemene selbst in diese Welt hinab und und nimmt ihren Feinden alles Licht und Hoffnung."
"[english]DOTA_Tooltip_ability_aghsfort_luna_eclipse_Lore"	"In times of great need, Selemene herself descends into the world, blocking out the light and hope of the opposed."
"DOTA_Tooltip_ability_aghsfort_luna_eclipse_Description"	"Ruft eine Sonnenfinsternis herbei, worauf Lucent Beams des aktuell erlernten Levels auf nahe Gegner niederfahren. Die Treffer pro Ziel sind begrenzt und die getroffenen Einheiten werden nicht betäubt. Eclipse erzeugt eine 10-sekündige Nachtphase.\n\nKann mit Aghanim's Scepter verbessert werden."
"[english]DOTA_Tooltip_ability_aghsfort_luna_eclipse_Description"	"Showers random nearby enemies with strikes from Luna's current level of Lucent Beam. These beams do not stun their targets, and there is a maximum number of times that a single target can be struck. Also turns day into night for 10 seconds.\n\nUpgradable by Aghanim's Scepter."
"DOTA_Tooltip_ability_aghsfort_luna_eclipse_Note0"	"Eklipse verursacht keinen Schaden, wenn Luna keinen Punkt in Gleißender Strahl hat."
"[english]DOTA_Tooltip_ability_aghsfort_luna_eclipse_Note0"	"Eclipse doesn't work if Luna doesn't have any points in Lucent Beam."
"DOTA_Tooltip_ability_aghsfort_luna_eclipse_Note1"	"Strahlen stoppen, wenn Luna stirbt."
"[english]DOTA_Tooltip_ability_aghsfort_luna_eclipse_Note1"	"Beams will stop if Luna is killed."
"DOTA_Tooltip_ability_aghsfort_luna_eclipse_Note3"	"Unsichtbare Einheiten werden nicht getroffen."
"[english]DOTA_Tooltip_ability_aghsfort_luna_eclipse_Note3"	"Will not hit invisible units."
"DOTA_Tooltip_ability_aghsfort_luna_eclipse_Note4"	"Das Intervall zwischen zwei Strahlen beträgt 0,6 Sekunden. Mit Aghanim's Scepter nur 0,3 Sekunden."
"[english]DOTA_Tooltip_ability_aghsfort_luna_eclipse_Note4"	"There is a .6 seconds gap between beams, .3 seconds with scepter."
"DOTA_Tooltip_ability_aghsfort_luna_eclipse_beams"	"STRAHLEN:"
"[english]DOTA_Tooltip_ability_aghsfort_luna_eclipse_beams"	"TOTAL BEAMS:"
"DOTA_Tooltip_ability_aghsfort_luna_eclipse_hit_count"	"MAX. TREFFER PRO EINHEIT:"
"[english]DOTA_Tooltip_ability_aghsfort_luna_eclipse_hit_count"	"MAX BEAMS PER UNIT:"
"DOTA_Tooltip_ability_aghsfort_luna_eclipse_radius"	"RADIUS:"
"[english]DOTA_Tooltip_ability_aghsfort_luna_eclipse_radius"	"RADIUS:"
"DOTA_Tooltip_ability_aghsfort_luna_eclipse_duration_tooltip"	"DAUER:"
"[english]DOTA_Tooltip_ability_aghsfort_luna_eclipse_duration_tooltip"	"ECLIPSE DURATION:"
"DOTA_Tooltip_ability_aghsfort_luna_eclipse_beams_scepter"	"STRAHLEN (SCEPTER):"
"[english]DOTA_Tooltip_ability_aghsfort_luna_eclipse_beams_scepter"	"SCEPTER TOTAL BEAMS:"
"DOTA_Tooltip_ability_aghsfort_luna_eclipse_duration_tooltip_scepter"	"DAUER (SCEPTER):"
"[english]DOTA_Tooltip_ability_aghsfort_luna_eclipse_duration_tooltip_scepter"	"SCEPTER DURATION:"
"DOTA_Tooltip_ability_aghsfort_luna_eclipse_cast_range_tooltip_scepter"	"ZAUBERREICHWEITE (SCEPTER):"
"[english]DOTA_Tooltip_ability_aghsfort_luna_eclipse_cast_range_tooltip_scepter"	"SCEPTER CAST RANGE:"
"DOTA_Tooltip_ability_monkey_king_jingu_mastery_aghsfort"	"Jingumeister"
"[english]DOTA_Tooltip_ability_monkey_king_jingu_mastery_aghsfort"	"Jingu Mastery"
"DOTA_Tooltip_ability_monkey_king_jingu_mastery_aghsfort_Description"	"<font color='#70EA72'>Aktive Fähigkeit.</font> Die nächsten vier Angriffe verursachen Bonusschaden und rauben Leben."
"[english]DOTA_Tooltip_ability_monkey_king_jingu_mastery_aghsfort_Description"	"<font color='#70EA72'>Active ability.</font> Monkey King gains four charged attacks that have bonus damage and lifesteal."
"DOTA_Tooltip_Ability_rock_golem_split_a"	"Bröckeln"
"[english]DOTA_Tooltip_Ability_rock_golem_split_a"	"Crumble"
"DOTA_Tooltip_ability_rock_golem_split_a_Description"	"Der Geist des Golems geht in die Fragmente seines zertrümmerten Körpers über."
"[english]DOTA_Tooltip_ability_rock_golem_split_a_Description"	"The spirit from the golem is transferred into the pieces of his shattered body."
"DOTA_Tooltip_Ability_rock_golem_split_b"	"Bröckeln"
"[english]DOTA_Tooltip_Ability_rock_golem_split_b"	"Crumble"
"DOTA_Tooltip_ability_rock_golem_split_b_Description"	"Der Geist des Golems geht in die Fragmente seines zertrümmerten Körpers über."
"[english]DOTA_Tooltip_ability_rock_golem_split_b_Description"	"The spirit from the golem is transferred into the pieces of his shattered body."
"DOTA_Tooltip_modifier_aghsfort_player_transform"	"Transformiert"
"[english]DOTA_Tooltip_modifier_aghsfort_player_transform"	"Transformed"
"DOTA_Tooltip_modifier_aghsfort_player_transform_Description"	"Ihr inneres Ich ist allen offenbart. Heilung, das Wirken von Zaubern und Gegenstandsnutzung nicht möglich."
"[english]DOTA_Tooltip_modifier_aghsfort_player_transform_Description"	"Your inner self is revealed for all to see. Cannot heal, cast spells, or use items."
"DOTA_Tooltip_modifier_bandit_archer_arrow_debuff"	"Pfeil des Sabaku-Bogenschützen"
"[english]DOTA_Tooltip_modifier_bandit_archer_arrow_debuff"	"Sabaku Archer Arrow"
"DOTA_Tooltip_ability_item_book_of_strength"	"Buch der Stärke"
"[english]DOTA_Tooltip_ability_item_book_of_strength"	"Book of Strength"
"DOTA_Tooltip_ability_item_book_of_strength_Description"	"Gewährt permanent 3 Bonusstärke."
"[english]DOTA_Tooltip_ability_item_book_of_strength_Description"	"Consume to gain 3 Strength permanently."
"DOTA_Tooltip_ability_item_book_of_agility"	"Buch der Agilität"
"[english]DOTA_Tooltip_ability_item_book_of_agility"	"Book of Agility"
"DOTA_Tooltip_ability_item_book_of_agility_Description"	"Gewährt permanent 3 Bonusagilität."
"[english]DOTA_Tooltip_ability_item_book_of_agility_Description"	"Consume to gain 3 Agility permanently."
"DOTA_Tooltip_ability_item_book_of_intelligence"	"Buch der Intelligenz"
"[english]DOTA_Tooltip_ability_item_book_of_intelligence"	"Book of Intelligence"
"DOTA_Tooltip_ability_item_book_of_intelligence_Description"	"Gewährt permanent 3 Bonusintelligenz."
"[english]DOTA_Tooltip_ability_item_book_of_intelligence_Description"	"Consume to gain 3 Intelligence permanently."
"DOTA_Tooltip_ability_item_book_of_greater_strength"	"Buch der Tapferkeit"
"[english]DOTA_Tooltip_ability_item_book_of_greater_strength"	"Book of Fortitude"
"DOTA_Tooltip_ability_item_book_of_greater_strength_Description"	"Gewährt permanent 5 Bonusstärke."
"[english]DOTA_Tooltip_ability_item_book_of_greater_strength_Description"	"Consume to gain 5 Strength permanently."
"DOTA_Tooltip_ability_item_book_of_greater_agility"	"Buch der Rasanz"
"[english]DOTA_Tooltip_ability_item_book_of_greater_agility"	"Book of Celerity"
"DOTA_Tooltip_ability_item_book_of_greater_agility_Description"	"Gewährt permanent 5 Bonusagilität."
"[english]DOTA_Tooltip_ability_item_book_of_greater_agility_Description"	"Consume to gain 5 Agility permanently."
"DOTA_Tooltip_ability_item_book_of_greater_intelligence"	"Buch der Einsicht"
"[english]DOTA_Tooltip_ability_item_book_of_greater_intelligence"	"Book of Insight"
"DOTA_Tooltip_ability_item_book_of_greater_intelligence_Description"	"Gewährt permanent 5 Bonusintelligenz."
"[english]DOTA_Tooltip_ability_item_book_of_greater_intelligence_Description"	"Consume to gain 5 Intelligence permanently."
"DOTA_Tooltip_ability_item_creed_of_omniscience"	"Wappen des Allwissenden"
"[english]DOTA_Tooltip_ability_item_creed_of_omniscience"	"Creed of Omniscience"
"DOTA_Tooltip_ability_item_creed_of_omniscience_Description"	"<h1>Passiv: Studieren</h1>Gewährt Bonuserfahrung.\n"
"[english]DOTA_Tooltip_ability_item_creed_of_omniscience_Description"	"<h1>Passive: Study</h1>Grants bonus experience.\n"
"DOTA_Tooltip_ability_item_creed_of_omniscience_bonus_xp"	"%BONUS-EP:"
"[english]DOTA_Tooltip_ability_item_creed_of_omniscience_bonus_xp"	"%BONUS XP:"
"DOTA_Tooltip_ability_item_creed_of_omniscience_Lore"	"Der Allwissende ehrt mich!"
"[english]DOTA_Tooltip_ability_item_creed_of_omniscience_Lore"	"The Omniscience honors me!"
"DOTA_Tooltip_ability_item_oblivions_locket"	"Oblivions Medaillon"
"[english]DOTA_Tooltip_ability_item_oblivions_locket"	"Oblivion's Locket"
"DOTA_Tooltip_ability_item_oblivions_locket_Description"	"<h1>Aktiv: Geist</h1>KANALISIEREND – Ätherische Form. Sie werden immun gegenüber physischen Angriffen, erleiden jedoch %extra_spell_damage_percent% %% zusätzlichen Magieschaden für bis zu 1 Sekunde.\n"
"[english]DOTA_Tooltip_ability_item_oblivions_locket_Description"	"<h1>Active: Spook</h1>CHANNELLED - Become ethereal, immune to physical but taking %extra_spell_damage_percent%%% extra magic damage for up to 1 second.\n"
"DOTA_Tooltip_ability_item_oblivions_locket_bonus_all_stats"	"BONUS AUF ALLE ATTRIBUTE:"
"[english]DOTA_Tooltip_ability_item_oblivions_locket_bonus_all_stats"	"BONUS ALL STATS:"
"DOTA_Tooltip_ability_item_oblivions_locket_Lore"	"Amulett eines Skeletts. Hat Schlechtes vom Träger abgewendet."
"[english]DOTA_Tooltip_ability_item_oblivions_locket_Lore"	"A skeleton's charm. Used to prevent having a bad time."
"DOTA_Tooltip_ability_item_pelt_of_the_old_wolf"	"Fell des alten Wolfs"
"[english]DOTA_Tooltip_ability_item_pelt_of_the_old_wolf"	"Pelt of the Old Wolf"
"DOTA_Tooltip_ability_item_pelt_of_the_old_wolf_Description"	"

"
"[english]DOTA_Tooltip_ability_item_pelt_of_the_old_wolf_Description"	""
"DOTA_Tooltip_ability_item_pelt_of_the_old_wolf_Lore"	"Die Wildnis kann ein trügerischer Ort sein, bleibt wachsam."
"[english]DOTA_Tooltip_ability_item_pelt_of_the_old_wolf_Lore"	"The wild can be a treachorous place; don't let your guard down."
"DOTA_Tooltip_ability_item_pelt_of_the_old_wolf_bonus_armor"	"BONUSRÜSTUNG:"
"[english]DOTA_Tooltip_ability_item_pelt_of_the_old_wolf_bonus_armor"	"BONUS ARMOR:"
"DOTA_Tooltip_ability_item_pelt_of_the_old_wolf_bonus_move_speed"	"BONUSBEWEGUNGSTEMPO:"
"[english]DOTA_Tooltip_ability_item_pelt_of_the_old_wolf_bonus_move_speed"	"BONUS MOVE SPEED:"
"DOTA_Tooltip_ability_item_pelt_of_the_old_wolf_bonus_evasion"	"%BONUSAUSWEICHCHANCE:"
"[english]DOTA_Tooltip_ability_item_pelt_of_the_old_wolf_bonus_evasion"	"%BONUS EVASION:"
"DOTA_Tooltip_Ability_item_keen_optic"	"Scharfe Optik"
"[english]DOTA_Tooltip_Ability_item_keen_optic"	"Keen Optic"
"DOTA_Tooltip_ability_item_paw_of_lucius"	"Lucius' Pfote"
"[english]DOTA_Tooltip_ability_item_paw_of_lucius"	"Paw of Lucius"
"DOTA_Tooltip_ability_item_paw_of_lucius_Description"	"<h1>Passiv: Scharfe Klauen</h1>Angriffe haben eine %rupture_chance%%%ige Chance, Gegner mit Rupture zu belegen.\n\n"
"[english]DOTA_Tooltip_ability_item_paw_of_lucius_Description"	"<h1>Passive: Sharp Claws</h1>Attacks have a %rupture_chance%%% chance to inflict Rupture.\n"
"DOTA_Tooltip_ability_item_paw_of_lucius_Lore"	"Die Klaue schneidet tief."
"[english]DOTA_Tooltip_ability_item_paw_of_lucius_Lore"	"This claw cuts deep."
"DOTA_Tooltip_ability_item_paw_of_lucius_bonus_strength"	"BONUSSTÄRKE:"
"[english]DOTA_Tooltip_ability_item_paw_of_lucius_bonus_strength"	"BONUS STRENGTH:"
"DOTA_Tooltip_ability_item_paw_of_lucius_bonus_attack_speed"	"BONUSANGRIFFSTEMPO:"
"[english]DOTA_Tooltip_ability_item_paw_of_lucius_bonus_attack_speed"	"BONUS ATTACK SPEED:"
"DOTA_Tooltip_ability_item_longclaws_amulet"	"Amulett der Langklaue"
"[english]DOTA_Tooltip_ability_item_longclaws_amulet"	"Longclaw's Amulet"
"DOTA_Tooltip_ability_item_longclaws_amulet_Description"	""
"[english]DOTA_Tooltip_ability_item_longclaws_amulet_Description"	""
"DOTA_Tooltip_ability_item_longclaws_amulet_Lore"	"Magie ist etwas Ungewöhnliches im Wald und ihre Geheimnisse werden streng bewacht."
"[english]DOTA_Tooltip_ability_item_longclaws_amulet_Lore"	"Magic is somewhat uncommon in the Weald, its secrets closely guarded."
"DOTA_Tooltip_ability_item_longclaws_amulet_spell_lifesteal_pct"	"%ZAUBERLEBENSRAUB:"
"[english]DOTA_Tooltip_ability_item_longclaws_amulet_spell_lifesteal_pct"	"%SPELL LIFESTEAL:"
"DOTA_Tooltip_ability_item_longclaws_amulet_cooldown_reduction_pct"	"%ABKLINGZEITREDUZIERUNG:"
"[english]DOTA_Tooltip_ability_item_longclaws_amulet_cooldown_reduction_pct"	"%COOLDOWN REDUCTION:"
"DOTA_Tooltip_ability_item_longclaws_amulet_mana_cost_reduction_pct"	"%MANAKOSTENREDUZIERUNG:"
"[english]DOTA_Tooltip_ability_item_longclaws_amulet_mana_cost_reduction_pct"	"%MANA COST REDUCTION:"
"DOTA_Tooltip_ability_item_bogduggs_cudgel"	"Bogduggs Knüppel"
"[english]DOTA_Tooltip_ability_item_bogduggs_cudgel"	"Bogdugg's Cudgel"
"DOTA_Tooltip_ability_item_bogduggs_cudgel_Description"	"<h1>Passiv: Smash</h1>NUR NAHKAMPF – Angriffstempo wird halbiert, aber Angriffe verursachen Flächenschaden in einem Radius von %damage_radius% Einheiten um das Ziel herum und betäuben für %stun_duration% Sekunde.\n"
"[english]DOTA_Tooltip_ability_item_bogduggs_cudgel_Description"	"<h1>Passive: Smash</h1>MELEE ONLY - All attack speed is halved, but attacks deal splash damage in a %damage_radius% area around the target and stun for %stun_duration% second.\n"
"DOTA_Tooltip_ability_item_bogduggs_cudgel_Lore"	"Bogdugg wurde zum Chef des Knochenmehlkamms, weil er den längsten Knüppel hatte."
"[english]DOTA_Tooltip_ability_item_bogduggs_cudgel_Lore"	"Bogdugg came to lord over Bonemeal Ridge by carrying the biggest stick."
"DOTA_Tooltip_ability_item_bogduggs_cudgel_bonus_strength"	"BONUSSTÄRKE:"
"[english]DOTA_Tooltip_ability_item_bogduggs_cudgel_bonus_strength"	"BONUS STRENGTH:"
"DOTA_Tooltip_ability_item_bogduggs_cudgel_bonus_damage"	"BONUSSCHADEN:"
"[english]DOTA_Tooltip_ability_item_bogduggs_cudgel_bonus_damage"	"BONUS DAMAGE:"
"DOTA_Tooltip_ability_item_bogduggs_baldric"	"Bogduggs Bandelier"
"[english]DOTA_Tooltip_ability_item_bogduggs_baldric"	"Bogdugg's Baldric"
"DOTA_Tooltip_ability_item_bogduggs_baldric_Description"	""
"[english]DOTA_Tooltip_ability_item_bogduggs_baldric_Description"	""
"DOTA_Tooltip_ability_item_bogduggs_baldric_Lore"	"Laufen macht nicht so viel Spaß wie Schlagen. Lange nicht so viel."
"[english]DOTA_Tooltip_ability_item_bogduggs_baldric_Lore"	"Running's not as fun as hitting.  Not one bit."
"DOTA_Tooltip_ability_item_bogduggs_baldric_bonus_armor"	"BONUSRÜSTUNG:"
"[english]DOTA_Tooltip_ability_item_bogduggs_baldric_bonus_armor"	"BONUS ARMOR:"
"DOTA_Tooltip_ability_item_bogduggs_baldric_disable_resist_pct"	"%BETÄUBUNGSDAUERREDUZIERUNG:"
"[english]DOTA_Tooltip_ability_item_bogduggs_baldric_disable_resist_pct"	"%STUN DURATION REDUCTION:"
"DOTA_Tooltip_ability_item_bogduggs_baldric_move_speed_penalty"	"BEWEGUNGSTEMPOREDUZIERUNG:"
"[english]DOTA_Tooltip_ability_item_bogduggs_baldric_move_speed_penalty"	"MOVE SPEED REDUCTION:"
"DOTA_Tooltip_ability_item_bogduggs_lucky_femur"	"Bogduggs Glücksknochen"
"[english]DOTA_Tooltip_ability_item_bogduggs_lucky_femur"	"Bogdugg's Lucky Femur"
"DOTA_Tooltip_ability_item_bogduggs_lucky_femur_Description"	"<h1>Passiv: Gekonnt</h1>Nachdem eine Fähigkeit eingesetzt wurde, hat diese eine %refresh_pct%%%ige Chance sofort wieder zur Verfügung zu stehen. Der Glücksknochen kann für die Dauer der Abklingzeit der zurückgesetzten Fähigkeit nicht erneut ausgelöst werden.\n"
"[english]DOTA_Tooltip_ability_item_bogduggs_lucky_femur_Description"	"<h1>Passive: Skillshot</h1>After an ability is cast, it has a %refresh_pct%%% chance to be immediately refreshed, and Lucky Femur is placed on cooldown for the duration of cooldown of the refreshed ability.\n"
"DOTA_Tooltip_ability_item_bogduggs_lucky_femur_Lore"	"Und noch einer!"
"[english]DOTA_Tooltip_ability_item_bogduggs_lucky_femur_Lore"	"And another!"
"DOTA_Tooltip_ability_item_bogduggs_lucky_femur_max_mana_penalty"	"MAX. MANAREDUZIERUNG:"
"[english]DOTA_Tooltip_ability_item_bogduggs_lucky_femur_max_mana_penalty"	"MAX MANA REDUCTION:"
"DOTA_Tooltip_ability_item_bogduggs_lucky_femur_intelligence_penalty"	"INTELLIGENZREDUZIERUNG:"
"[english]DOTA_Tooltip_ability_item_bogduggs_lucky_femur_intelligence_penalty"	"INTELLIGENCE REDUCTION:"
"DOTA_Tooltip_ability_item_bogduggs_lucky_femur_mana_regen_sec"	"BONUSMANAREGENERATION:"
"[english]DOTA_Tooltip_ability_item_bogduggs_lucky_femur_mana_regen_sec"	"BONUS MANA REGEN:"
"DOTA_Tooltip_ability_item_sign_of_the_arachnid"	"Zeichen der Arachnida"
"[english]DOTA_Tooltip_ability_item_sign_of_the_arachnid"	"Sign of the Arachnid"
"DOTA_Tooltip_ability_item_sign_of_the_arachnid_Description"	"<h1>Passiv: Spinnenaura</h1>Verbündete erhalten Bewegungs- und Angriffstempo."
"[english]DOTA_Tooltip_ability_item_sign_of_the_arachnid_Description"	"<h1>Passive: Arachnid Aura</h1>Allies gain bonus movement and attack speed."
"DOTA_Tooltip_ability_item_sign_of_the_arachnid_bonus_agility"	"BONUSAGILITÄT:"
"[english]DOTA_Tooltip_ability_item_sign_of_the_arachnid_bonus_agility"	"BONUS AGILITY:"
"DOTA_Tooltip_ability_item_sign_of_the_arachnid_bonus_move_speed_pct"	"%BONUSBEWEGUNGSTEMPO (AURA):"
"[english]DOTA_Tooltip_ability_item_sign_of_the_arachnid_bonus_move_speed_pct"	"%AURA BONUS MOVE SPEED:"
"DOTA_Tooltip_ability_item_sign_of_the_arachnid_attack_speed"	"BONUSANGRIFFSTEMPO (AURA):"
"[english]DOTA_Tooltip_ability_item_sign_of_the_arachnid_attack_speed"	"AURA BONUS ATTACK SPEED:"
"DOTA_Tooltip_modifier_item_sign_of_the_arachnid_effect"	"Spinnenaura"
"[english]DOTA_Tooltip_modifier_item_sign_of_the_arachnid_effect"	"Arachnid Aura"
"DOTA_Tooltip_modifier_item_sign_of_the_arachnid_effect_Description"	"Erhält Bewegungs- und Angriffstempo."
"[english]DOTA_Tooltip_modifier_item_sign_of_the_arachnid_effect_Description"	"Gaining bonus movement and attack speed."
"DOTA_Tooltip_ability_item_unhallowed_icon"	"Unheiliges Zeichen"
"[english]DOTA_Tooltip_ability_item_unhallowed_icon"	"Unhallowed Icon"
"DOTA_Tooltip_ability_item_unhallowed_icon_Description"	"<h1>Passiv: Blutpaktaura</h1>Verbündete erhalten einen Lebensregenerationsbonus. Wenn eine Einheit unter dem Einfluss des Unheiligen Zeichens angreift, werden %lifesteal_pct% %% des Schadens als Lebenspunkte geraubt und auf alle, die unter dem Einfluss der Aura stehen, verteilt."
"[english]DOTA_Tooltip_ability_item_unhallowed_icon_Description"	"<h1>Passive: Bloodbond Aura</h1>Allies gain bonus health regeneration. When any unit affected by Unhallowed Icon attacks, %lifesteal_pct%%% of the damage dealt is stolen as life and distributed among all affected by the aura."
"DOTA_Tooltip_ability_item_unhallowed_icon_bonus_strength"	"BONUSSTÄRKE:"
"[english]DOTA_Tooltip_ability_item_unhallowed_icon_bonus_strength"	"BONUS STRENGTH:"
"DOTA_Tooltip_ability_item_unhallowed_icon_lifesteal_pct"	"%LEBENSRAUB (AURA):"
"[english]DOTA_Tooltip_ability_item_unhallowed_icon_lifesteal_pct"	"%AURA LINKED LIFESTEAL:"
"DOTA_Tooltip_ability_item_unhallowed_icon_hp_regen"	"LP-REGENERATION (AURA):"
"[english]DOTA_Tooltip_ability_item_unhallowed_icon_hp_regen"	"AURA HP REGEN:"
"DOTA_Tooltip_modifier_item_unhallowed_icon_effect"	"Blutpaktaura"
"[english]DOTA_Tooltip_modifier_item_unhallowed_icon_effect"	"Bloodbond Aura"
"DOTA_Tooltip_modifier_item_unhallowed_icon_effect_Description"	"Gewährt Bonuslebensregeneration. Physische Angriffe rauben Lebenspunkte und verteilen diese auf alle Einheiten, die unter dem Einfluss der Blutpaktaura stehen."
"[english]DOTA_Tooltip_modifier_item_unhallowed_icon_effect_Description"	"Gaining bonus HP regen. Physical attacks steal life and distribute it among others affected by Bloodbond Aura."
"DOTA_Tooltip_ability_item_preserved_skull"	"Konservierter Schädel"
"[english]DOTA_Tooltip_ability_item_preserved_skull"	"Preserved Skull"
"DOTA_Tooltip_ability_item_preserved_skull_Description"	"<h1>Passiv: Beschwöreraura</h1>Verbündete erhalten Manaregeneration und Abklingzeitreduzierung."
"[english]DOTA_Tooltip_ability_item_preserved_skull_Description"	"<h1>Passive: Conjuration Aura</h1>Allies gain bonus mana regen and cooldown reduction."
"DOTA_Tooltip_ability_item_preserved_skull_Lore"	"Wo sind nun deine Schwänke?"
"[english]DOTA_Tooltip_ability_item_preserved_skull_Lore"	"Where be your gibes now?"
"DOTA_Tooltip_ability_item_preserved_skull_bonus_intelligence"	"BONUSINTELLIGENZ:"
"[english]DOTA_Tooltip_ability_item_preserved_skull_bonus_intelligence"	"BONUS INTELLIGENCE:"
"DOTA_Tooltip_ability_item_preserved_skull_cooldown_reduction_pct"	"%ABKLINGZEITREDUZIERUNG (AURA):"
"[english]DOTA_Tooltip_ability_item_preserved_skull_cooldown_reduction_pct"	"%AURA COOLDOWN REDUCTION:"
"DOTA_Tooltip_ability_item_preserved_skull_aura_mana_regen"	"MANAREGENERATION (AURA):"
"[english]DOTA_Tooltip_ability_item_preserved_skull_aura_mana_regen"	"AURA MANA REGEN:"
"DOTA_Tooltip_modifier_item_preserved_skull_effect"	"Beschwöreraura"
"[english]DOTA_Tooltip_modifier_item_preserved_skull_effect"	"Conjuration Aura"
"DOTA_Tooltip_modifier_item_preserved_skull_effect_Description"	"Erhält Bonusmanaregeneration und Abklingzeitreduzierung."
"[english]DOTA_Tooltip_modifier_item_preserved_skull_effect_Description"	"Gaining bonus mana regen and cooldown reduction."
"DOTA_Tooltip_ability_item_treads_of_ermacor"	"Ermacors Treter"
"[english]DOTA_Tooltip_ability_item_treads_of_ermacor"	"Treads of Ermacor"
"DOTA_Tooltip_ability_item_treads_of_ermacor_Description"	"Absolute Bewegungstempoboni mehrerer Schuhpaare werden nicht aufsummiert."
"[english]DOTA_Tooltip_ability_item_treads_of_ermacor_Description"	"Flat movement speed bonuses from multiple pairs of boots do not stack."
"DOTA_Tooltip_ability_item_treads_of_ermacor_Lore"	"Mit dem Segen des Pfadfinders können wir einen Weg finden."
"[english]DOTA_Tooltip_ability_item_treads_of_ermacor_Lore"	"With the Pathfinder's blessing, we shall find a way."
"DOTA_Tooltip_ability_item_treads_of_ermacor_bonus_movement_speed"	"BONUSBEWEGUNGSTEMPO:"
"[english]DOTA_Tooltip_ability_item_treads_of_ermacor_bonus_movement_speed"	"BONUS MOVEMENT SPEED:"
"DOTA_Tooltip_ability_item_treads_of_ermacor_bonus_attack_speed"	"BONUSANGRIFFSTEMPO:"
"[english]DOTA_Tooltip_ability_item_treads_of_ermacor_bonus_attack_speed"	"BONUS ATTACK SPEED:"
"DOTA_Tooltip_ability_item_treads_of_ermacor_bonus_all_stats"	"BONUS AUF ALLE ATTRIBUTE:"
"[english]DOTA_Tooltip_ability_item_treads_of_ermacor_bonus_all_stats"	"BONUS ALL STATS:"
"DOTA_Tooltip_ability_item_rhyziks_eye"	"Rhyziks Auge"
"[english]DOTA_Tooltip_ability_item_rhyziks_eye"	"Rhyzik's Eye"
"DOTA_Tooltip_ability_item_rhyziks_eye_Description"	"

"
"[english]DOTA_Tooltip_ability_item_rhyziks_eye_Description"	""
"DOTA_Tooltip_ability_item_rhyziks_eye_Lore"	"Im Auge des Schänders steckt große Macht."
"[english]DOTA_Tooltip_ability_item_rhyziks_eye_Lore"	"There is power in the eye of the Corruptor."
"DOTA_Tooltip_ability_item_rhyziks_eye_bonus_all_stats"	"BONUS AUF ALLE ATTRIBUTE:"
"[english]DOTA_Tooltip_ability_item_rhyziks_eye_bonus_all_stats"	"BONUS ALL STATS:"
"DOTA_Tooltip_ability_item_rhyziks_eye_bonus_damage_pct"	"%BONUSSCHADEN:"
"[english]DOTA_Tooltip_ability_item_rhyziks_eye_bonus_damage_pct"	"%BONUS DAMAGE:"
"DOTA_Tooltip_ability_item_rhyziks_eye_damage_reduction"	"%SCHADENRESISTENZ:"
"[english]DOTA_Tooltip_ability_item_rhyziks_eye_damage_reduction"	"%INCOMING DAMAGE REDUCTION:"
"DOTA_Tooltip_ability_item_rhyziks_eye_mana_regen_sec"	"BONUSMANAREGENERATION:"
"[english]DOTA_Tooltip_ability_item_rhyziks_eye_mana_regen_sec"	"BONUS MANA REGEN:"
"DOTA_Tooltip_ability_item_rhyziks_eye_hp_regen_sec"	"BONUSLEBENSREGENERATION:"
"[english]DOTA_Tooltip_ability_item_rhyziks_eye_hp_regen_sec"	"BONUS HP REGEN:"
"DOTA_Tooltip_ability_item_guardian_shell"	"Schützende Hülle"
"[english]DOTA_Tooltip_ability_item_guardian_shell"	"Guardian Shell"
"DOTA_Tooltip_ability_item_guardian_shell_Description"	"<h1>Passiv: Unbeirrt</h1>Bewegungstempo des Trägers kann nicht verlangsamt und er kann nicht festgesetzt werden."
"[english]DOTA_Tooltip_ability_item_guardian_shell_Description"	"<h1>Passive: Unwavering</h1>Movement Speed cannot be slowed and wearer cannot be rooted."
"DOTA_Tooltip_ability_item_guardian_shell_Lore"	"Schreite stets voran, ohne die sterblichen Ängste."
"[english]DOTA_Tooltip_ability_item_guardian_shell_Lore"	"Push ever onward, unburdened by mortal cares."
"DOTA_Tooltip_ability_item_guardian_shell_bonus_armor"	"BONUSRÜSTUNG:"
"[english]DOTA_Tooltip_ability_item_guardian_shell_bonus_armor"	"BONUS ARMOR:"
"DOTA_Tooltip_ability_item_guardian_shell_magic_resistance"	"%BONUSMAGIERESISTENZ:"
"[english]DOTA_Tooltip_ability_item_guardian_shell_magic_resistance"	"%BONUS MAGIC RESISTANCE:"
"DOTA_Tooltip_ability_item_watchers_gaze"	"Blick des Wächters"
"[english]DOTA_Tooltip_ability_item_watchers_gaze"	"Watcher's Gaze"
"DOTA_Tooltip_ability_item_watchers_gaze_Description"	"<h1>Aktiv: Versteinernder Blick</h1>Gegner in Ihrem Sichtfeld werden zu Stein und erleiden so zusätzlichen physischen Schaden.\n"
"[english]DOTA_Tooltip_ability_item_watchers_gaze_Description"	"<h1>Active: Stone Gaze</h1>Enemies within your frontal cone are turned to stone and take additional physical damage.\n"
"DOTA_Tooltip_ability_item_watchers_gaze_Lore"	"Schaut in eure Gegner und seht, wie sie vor euch zu Stein werden."
"[english]DOTA_Tooltip_ability_item_watchers_gaze_Lore"	"Look upon thine enemies and see them petrify before you."
"DOTA_Tooltip_ability_item_watchers_gaze_bonus_stats"	"BONUS AUF ALLE ATTRIBUTE:"
"[english]DOTA_Tooltip_ability_item_watchers_gaze_bonus_stats"	"BONUS ALL STATS:"
"DOTA_Tooltip_ability_item_carapace_of_qaldin"	"Qaldins Panzer"
"[english]DOTA_Tooltip_ability_item_carapace_of_qaldin"	"Carapace of Qaldin"
"DOTA_Tooltip_ability_item_carapace_of_qaldin_Description"	"<h1>Passiv: Saure Regeneration</h1> Jegliche Mana- und Lebensregeneration wird verdoppelt und ein Prozentsatz des erlittenen Schadens wird auf den Angreifer reflektiert.\n"
"[english]DOTA_Tooltip_ability_item_carapace_of_qaldin_Description"	"<h1>Passive: Acidic Regeneration</h1>All mana and health gained are doubled, and a percentage of all damage taken is reflected back upon the attacker.\n"
"DOTA_Tooltip_ability_item_carapace_of_qaldin_Lore"	"Lasst sie euch angreifen, da jeder Treffer mit einem Blutzoll bezahlt wird."
"[english]DOTA_Tooltip_ability_item_carapace_of_qaldin_Lore"	"Let them attack you, for each blow comes at a blood price."
"DOTA_Tooltip_ability_item_carapace_of_qaldin_bonus_hp"	"BONUS-LP:"
"[english]DOTA_Tooltip_ability_item_carapace_of_qaldin_bonus_hp"	"BONUS HP:"
"DOTA_Tooltip_ability_item_carapace_of_qaldin_bonus_mana"	"BONUSMANA:"
"[english]DOTA_Tooltip_ability_item_carapace_of_qaldin_bonus_mana"	"BONUS MANA:"
"DOTA_Tooltip_ability_item_carapace_of_qaldin_bonus_restore_pct"	"%BONUSWIEDERHERSTELLUNG:"
"[english]DOTA_Tooltip_ability_item_carapace_of_qaldin_bonus_restore_pct"	"%BONUS RESTORE:"
"DOTA_Tooltip_ability_item_carapace_of_qaldin_damage_return_pct"	"%ZURÜCKGEWORFENER SCHADEN:"
"[english]DOTA_Tooltip_ability_item_carapace_of_qaldin_damage_return_pct"	"%DAMAGE RETURNED:"
"DOTA_Tooltip_ability_item_the_caustic_finale"	"Ätzendes Finale"
"[english]DOTA_Tooltip_ability_item_the_caustic_finale"	"The Caustic Finale"
"DOTA_Tooltip_ability_item_the_caustic_finale_Description"	"<h1>Passiv: Ätzendes Finale</h1>Angriffe reduzieren die Rüstung des Ziels prozentual. Dieser Effekt summiert sich bis zu %max_stack_count%-mal auf. Wenn eine betroffene Einheit stirbt, explodiert sie und verursacht Flächenschaden.\n"
"[english]DOTA_Tooltip_ability_item_the_caustic_finale_Description"	"<h1>Passive: Caustic Finale</h1>Attacks reduce a percentage of the target's armor.  This effect stacks up to %max_stack_count% times.  If the target dies under this effect, it explodes, dealing damage in an area of effect.\n"
"DOTA_Tooltip_ability_item_the_caustic_finale_Lore"	"Das Geschenk der Kali wird immer im Voraus bezahlt."
"[english]DOTA_Tooltip_ability_item_the_caustic_finale_Lore"	"The caustic gift is always paid forward."
"DOTA_Tooltip_ability_item_the_caustic_finale_bonus_damage"	"BONUSSCHADEN:"
"[english]DOTA_Tooltip_ability_item_the_caustic_finale_bonus_damage"	"BONUS DAMAGE:"
"DOTA_Tooltip_ability_item_the_caustic_finale_bonus_attack_speed"	"BONUSANGRIFFSTEMPO:"
"[english]DOTA_Tooltip_ability_item_the_caustic_finale_bonus_attack_speed"	"BONUS ATTACK SPEED:"
"DOTA_Tooltip_ability_item_the_caustic_finale_caustic_armor_reduction_pct"	"%RÜSTUNGSREDUZIERUNG PRO INSTANZ:"
"[english]DOTA_Tooltip_ability_item_the_caustic_finale_caustic_armor_reduction_pct"	"%ARMOR REDUCTION PER STACK:"
"DOTA_Tooltip_ability_item_the_caustic_finale_caustic_radius"	"CAUSTIC-RADIUS:"
"[english]DOTA_Tooltip_ability_item_the_caustic_finale_caustic_radius"	"CAUSTIC RADIUS:"
"DOTA_Tooltip_ability_item_the_caustic_finale_caustic_damage"	"CAUSTIC-SCHADEN:"
"[english]DOTA_Tooltip_ability_item_the_caustic_finale_caustic_damage"	"CAUSTIC DAMAGE:"
"DOTA_Tooltip_ability_item_the_caustic_finale_max_stack_count"	"MAX. ANZAHL:"
"[english]DOTA_Tooltip_ability_item_the_caustic_finale_max_stack_count"	"MAX STACK COUNT:"
"DOTA_Tooltip_ability_item_winter_embrace"	"Umarmung des Winters"
"[english]DOTA_Tooltip_ability_item_winter_embrace"	"Winter's Embrace"
"DOTA_Tooltip_ability_item_winter_embrace_Description"	"<h1>Passiv: Eisige Schale</h1>Physischer Schaden bewirkt beim Angreifer eine Verringerung des Angriffs- und Bewegungstempos für %slow_duration% Sekunden.\n"
"[english]DOTA_Tooltip_ability_item_winter_embrace_Description"	"<h1>Passive: Icy Shell</h1>Physical attackers have their attack speed and movement speed slowed for %slow_duration% seconds.\n"
"DOTA_Tooltip_ability_item_winter_embrace_Lore"	"Wer ist jetzt die Nummer 1?"
"[english]DOTA_Tooltip_ability_item_winter_embrace_Lore"	"Who's the number one now?"
"DOTA_Tooltip_ability_item_winter_embrace_bonus_intelligence"	"BONUSINTELLIGENZ:"
"[english]DOTA_Tooltip_ability_item_winter_embrace_bonus_intelligence"	"BONUS INTELLIGENCE:"
"DOTA_Tooltip_ability_item_winter_embrace_bonus_armor"	"BONUSRÜSTUNG:"
"[english]DOTA_Tooltip_ability_item_winter_embrace_bonus_armor"	"BONUS ARMOR:"
"DOTA_Tooltip_ability_item_ice_dragon_maw_Description"	"<h1>Passiv: Eisiger Biss</h1>Angriffe haben eine %chance_to_freeze%%%ige Chance, das Ziel für %freeze_duration% Sekunden einzufrieren.\n"
"[english]DOTA_Tooltip_ability_item_ice_dragon_maw_Description"	"<h1>Passive: Chilling Bite</h1>Your attacks have a %chance_to_freeze%%% chance to freeze the target for %freeze_duration% seconds.\n"
"DOTA_Tooltip_ability_item_ice_dragon_maw_Lore"	"Da ist Frost in deinen Augen!"
"[english]DOTA_Tooltip_ability_item_ice_dragon_maw_Lore"	"Here's frost in your eye!"
"DOTA_Tooltip_ability_item_ice_dragon_maw_bonus_attack_range"	"BONUSANGRIFFSREICHWEITE (NUR FERNKAMPF):"
"[english]DOTA_Tooltip_ability_item_ice_dragon_maw_bonus_attack_range"	"BONUS ATTACK RANGE(RANGED ONLY):"
"DOTA_Tooltip_ability_item_ice_dragon_maw_bonus_damage"	"BONUSSCHADEN:"
"[english]DOTA_Tooltip_ability_item_ice_dragon_maw_bonus_damage"	"BONUS DAMAGE:"
"DOTA_Tooltip_ability_item_precious_egg"	"Kostbares Ei"
"[english]DOTA_Tooltip_ability_item_precious_egg"	"Precious Egg"
"DOTA_Tooltip_ability_item_precious_egg_Description"	"<h1>Passiv: Letzte Chance</h1>Falls ein Angriff tödlichen Schaden verursachen würde, gibt es eine %chance_to_resist_death%%%ige Chance, dass der Träger mit 1 LP überlebt.\n"
"[english]DOTA_Tooltip_ability_item_precious_egg_Description"	"<h1>Passive: Last Chance</h1>If an attack would deal lethal damage, it has a %chance_to_resist_death%%% chance to leave the wearer at 1 health.\n"
"DOTA_Tooltip_ability_item_precious_egg_Lore"	"Auf ihrer Suche nach neuem Wissen lernten die uralten Eldwürmer Techniken, die das eigene Ableben aufzuschieben vermochten."
"[english]DOTA_Tooltip_ability_item_precious_egg_Lore"	"Ancient eldwurms, in their search to acquire knowledge, have learned techniques for staving off the loss of life's breath."
"DOTA_Tooltip_ability_item_precious_egg_bonus_all_stats"	"BONUS AUF ALLE ATTRIBUTE:"
"[english]DOTA_Tooltip_ability_item_precious_egg_bonus_all_stats"	"BONUS ALL STATS:"
"DOTA_Tooltip_ability_item_stony_coat"	"Steinerner Mantel"
"[english]DOTA_Tooltip_ability_item_stony_coat"	"Stony Coat"
"DOTA_Tooltip_ability_item_stony_coat_Description"	"<h1>Passiv: Sperrfeuer</h1>Wenn der Träger Schaden erleidet, hat dieser eine %boulder_chance%%%ige Chance, einen Felsbrocken zurückzuschleudern, welcher %boulder_damage% Schaden verursacht und für %boulder_stun_duration% Sekunden betäubt.\n"
"[english]DOTA_Tooltip_ability_item_stony_coat_Description"	"<h1>Passive: Barrage</h1>When the wearer takes damage, there is a %boulder_chance%%% to retaliate with a thrown boulder, which deals %boulder_damage% and stuns for %boulder_stun_duration% seconds.\n"
"DOTA_Tooltip_ability_item_stony_coat_Lore"	"Nur einen Steinwurf entfernt."
"[english]DOTA_Tooltip_ability_item_stony_coat_Lore"	"Just a stone's throw away."
"DOTA_Tooltip_ability_item_stony_coat_bonus_strength"	"BONUSSTÄRKE:"
"[english]DOTA_Tooltip_ability_item_stony_coat_bonus_strength"	"BONUS STRENGTH:"
"DOTA_Tooltip_ability_item_stony_coat_bonus_armor"	"BONUSRÜSTUNG:"
"[english]DOTA_Tooltip_ability_item_stony_coat_bonus_armor"	"BONUS ARMOR:"
"DOTA_Tooltip_ability_item_stonework_pendant"	"Steinzeugamulett"
"[english]DOTA_Tooltip_ability_item_stonework_pendant"	"Stonework Pendant"
"DOTA_Tooltip_ability_item_stonework_pendant_Description"	"<h1>Passiv: Blutende Steine</h1>Zauber kosten jetzt Lebenspunkte in %hp_cost_multiplier%-facher Höhe ihrer Manakosten. Der Träger erhält Bonuslebenspunkte und Lebensregeneration in Höhe seines Manavorrats und seiner Manaregeneration.\n"
"[english]DOTA_Tooltip_ability_item_stonework_pendant_Description"	"<h1>Passive: Blood From a Stone</h1>Spells now cost hit points equal to %hp_cost_multiplier% times their mana cost, and the wearer gains bonus hit points and health regen equal to the size of their mana pool and mana regen.\n"
"DOTA_Tooltip_ability_item_stonework_pendant_Lore"	"Auch Steine können bluten."
"[english]DOTA_Tooltip_ability_item_stonework_pendant_Lore"	"You CAN get blood from a stone."
"DOTA_Tooltip_ability_item_stonework_pendant_spell_lifesteal"	"%ZAUBERLEBENSRAUB:"
"[english]DOTA_Tooltip_ability_item_stonework_pendant_spell_lifesteal"	"%SPELL LIFESTEAL:"
"DOTA_Tooltip_ability_item_gravel_foot"	"Kiesfuß"
"[english]DOTA_Tooltip_ability_item_gravel_foot"	"Gravel Foot"
"DOTA_Tooltip_ability_item_gravel_foot_Description"	"
"
"[english]DOTA_Tooltip_ability_item_gravel_foot_Description"	""
"DOTA_Tooltip_ability_item_gravel_foot_Lore"	"Sicheren Fußes über jedes Gelände."
"[english]DOTA_Tooltip_ability_item_gravel_foot_Lore"	"Find sure footing on any terrain."
"DOTA_Tooltip_ability_item_gravel_foot_bonus_movement_speed"	"BONUSBEWEGUNGSTEMPO:"
"[english]DOTA_Tooltip_ability_item_gravel_foot_bonus_movement_speed"	"BONUS MOVEMENT SPEED:"
"DOTA_Tooltip_ability_item_gravel_foot_bonus_all_stats"	"BONUS AUF ALLE ATTRIBUTE:"
"[english]DOTA_Tooltip_ability_item_gravel_foot_bonus_all_stats"	"BONUS ALL STATS:"
"DOTA_Tooltip_ability_item_gravel_foot_bonus_hp_regen"	"BONUSLEBENSREGENERATION:"
"[english]DOTA_Tooltip_ability_item_gravel_foot_bonus_hp_regen"	"BONUS HP REGEN:"
"DOTA_Tooltip_ability_item_gravel_foot_damage_block"	"SCHADENBLOCK:"
"[english]DOTA_Tooltip_ability_item_gravel_foot_damage_block"	"DAMAGE BLOCK:"
"DOTA_Tooltip_modifier_book_of_strength"	"Buch der Stärke"
"[english]DOTA_Tooltip_modifier_book_of_strength"	"Book of Strength"
"DOTA_Tooltip_modifier_book_of_strength_Description"	"Durch gelesene Bücher erhaltene Stärke."
"[english]DOTA_Tooltip_modifier_book_of_strength_Description"	"Strength gained from consumed Books."
"DOTA_Tooltip_modifier_book_of_agility"	"Buch der Agilität"
"[english]DOTA_Tooltip_modifier_book_of_agility"	"Book of Agility"
"DOTA_Tooltip_modifier_book_of_agility_Description"	"Durch gelesene Bücher erhaltene Agilität."
"[english]DOTA_Tooltip_modifier_book_of_agility_Description"	"Agility gained from consumed Books."
"DOTA_Tooltip_modifier_book_of_intelligence"	"Buch der Intelligenz"
"[english]DOTA_Tooltip_modifier_book_of_intelligence"	"Book of Intelligence"
"DOTA_Tooltip_modifier_book_of_intelligence_Description"	"Durch gelesene Bücher erhaltene Intelligenz."
"[english]DOTA_Tooltip_modifier_book_of_intelligence_Description"	"Intelligence gained from consumed Books."
"DOTA_Tooltip_Ability_item_wand_of_the_brine"	"Salziger Zauberstab"
"[english]DOTA_Tooltip_Ability_item_wand_of_the_brine"	"Wand of the Brine"
"DOTA_Tooltip_Ability_item_wand_of_the_brine_Lore"	"Wäre dieser sagenumwobene Zauberstab nicht gewesen, hätte wohl niemand vom Konklave die Schlacht am Steinfischtor überlebt."
"[english]DOTA_Tooltip_Ability_item_wand_of_the_brine_Lore"	"Were it not for this revered wand, there would have been no Conclave survivors at the Battle of Stonefish Gate."
"DOTA_Tooltip_Ability_item_wand_of_the_brine_Description"	"<h1>Aktiv: Salzschaum</h1> Umgibt eine verbündete Einheit für %bubble_duration% Sekunden mit einer schützenden Blase, die das Ziel außerdem alle %heal_tick_interval% Sekunden um %bubble_heal_per_tick% Lebenspunkte heilt."
"[english]DOTA_Tooltip_Ability_item_wand_of_the_brine_Description"	"<h1>Active: Brinefoam</h1> Puts a friendly unit in a protective healing bubble for %bubble_duration% seconds, healing it for %bubble_heal_per_tick% every %heal_tick_interval% second."
"DOTA_Tooltip_Ability_item_wand_of_the_brine_bonus_intelligence"	"+$int"
"[english]DOTA_Tooltip_Ability_item_wand_of_the_brine_bonus_intelligence"	"+$int"
"DOTA_Tooltip_Ability_item_wand_of_the_brine_bonus_mana_regen_pct"	"%+$mana_regen"
"[english]DOTA_Tooltip_Ability_item_wand_of_the_brine_bonus_mana_regen_pct"	"%+$mana_regen"
"DOTA_Tooltip_modifier_item_wand_of_the_brine_bubble"	"Salzschaum"
"[english]DOTA_Tooltip_modifier_item_wand_of_the_brine_bubble"	"Brinefoam"
"DOTA_Tooltip_modifier_item_wand_of_the_brine_bubble_Description"	"Diese Einheit wird von Salzschaum beschützt. Heilt 300 LP/s."
"[english]DOTA_Tooltip_modifier_item_wand_of_the_brine_bubble_Description"	"This unit is protected by Brinefoam.  Healing 300 hp/sec."
"DOTA_Tooltip_Ability_item_slippers_of_the_abyss"	"Latschen des Abgrunds"
"[english]DOTA_Tooltip_Ability_item_slippers_of_the_abyss"	"Slippers of the Abyss"
"DOTA_Tooltip_Ability_item_slippers_of_the_abyss_Lore"	"Wer in den dunklen Tiefen nicht flink unterwegs ist, wird als erstes das Zeitliche segnen."
"[english]DOTA_Tooltip_Ability_item_slippers_of_the_abyss_Lore"	"In the voluminous depths, those who cannot move swiftly will be the first to die."
"DOTA_Tooltip_Ability_item_slippers_of_the_abyss_Description"	"<h1>Aktiv: Wasserschritt</h1> Erhöht das Bewegungstempo %sprint_duration% Sekunden lang um %sprint_bonus_ms%."
"[english]DOTA_Tooltip_Ability_item_slippers_of_the_abyss_Description"	"<h1>Active: Aqueous Rush</h1> Increase movement speed by %sprint_bonus_ms% for %sprint_duration% seconds."
"DOTA_Tooltip_Ability_item_slippers_of_the_abyss_bonus_movement_speed"	"BONUSBEWEGUNGSTEMPO:"
"[english]DOTA_Tooltip_Ability_item_slippers_of_the_abyss_bonus_movement_speed"	"BONUS MOVEMENT SPEED:"
"DOTA_Tooltip_Ability_item_slippers_of_the_abyss_bonus_atk_speed"	"BONUSANGRIFFSTEMPO:"
"[english]DOTA_Tooltip_Ability_item_slippers_of_the_abyss_bonus_atk_speed"	"BONUS ATTACK SPEED:"
"DOTA_Tooltip_Ability_item_slippers_of_the_abyss_bonus_strength"	"+$str"
"[english]DOTA_Tooltip_Ability_item_slippers_of_the_abyss_bonus_strength"	"+$str"
"DOTA_Tooltip_Ability_item_slippers_of_the_abyss_bonus_agility"	"+$agi"
"[english]DOTA_Tooltip_Ability_item_slippers_of_the_abyss_bonus_agility"	"+$agi"
"DOTA_Tooltip_modifier_item_slippers_of_the_abyss_sprint"	"Wasserschritt"
"[english]DOTA_Tooltip_modifier_item_slippers_of_the_abyss_sprint"	"Aqueous Rush"
"DOTA_Tooltip_modifier_item_slippers_of_the_abyss_sprint_Description"	"Diese Einheit hat stark erhöhtes Bewegungstempo."
"[english]DOTA_Tooltip_modifier_item_slippers_of_the_abyss_sprint_Description"	"This unit has greatly increased movement speed."
"DOTA_Tooltip_Ability_item_glimmerdark_shield"	"Dunkelflimmerschild"
"[english]DOTA_Tooltip_Ability_item_glimmerdark_shield"	"Glimmerdark Shield"
"DOTA_Tooltip_Ability_item_glimmerdark_shield_Lore"	"Der erste Träger dieses Schilds dachte, er wäre unsterblich. Bis der nachfolgende Besitzer begann, seine Magie zu wirken."
"[english]DOTA_Tooltip_Ability_item_glimmerdark_shield_Lore"	"This shield's first bearer thought he had gained immortality in battle. Until the second bearer's magic began to flow."
"DOTA_Tooltip_Ability_item_glimmerdark_shield_Description"	"<h1>Aktiv: Schimmern</h1> Sie werden immun gegen physischen Schaden, aber erleiden %tooltip_prism_bonus_magic_dmg% % mehr Magieschaden. Hält %prism_duration% Sekunden an."
"[english]DOTA_Tooltip_Ability_item_glimmerdark_shield_Description"	"<h1>Active: Gleam</h1> Gain immunity to physical damage, but receive +%tooltip_prism_bonus_magic_dmg%%  magic damage. Lasts %prism_duration% seconds."
"DOTA_Tooltip_Ability_item_glimmerdark_shield_bonus_strength"	"+$str"
"[english]DOTA_Tooltip_Ability_item_glimmerdark_shield_bonus_strength"	"+$str"
"DOTA_Tooltip_Ability_item_glimmerdark_shield_bonus_agility"	"+$agi"
"[english]DOTA_Tooltip_Ability_item_glimmerdark_shield_bonus_agility"	"+$agi"
"DOTA_Tooltip_Ability_item_glimmerdark_shield_bonus_intellect"	"+$int"
"[english]DOTA_Tooltip_Ability_item_glimmerdark_shield_bonus_intellect"	"+$int"
"DOTA_Tooltip_Ability_item_glimmerdark_shield_bonus_armor"	"BONUSRÜSTUNG:"
"[english]DOTA_Tooltip_Ability_item_glimmerdark_shield_bonus_armor"	"BONUS ARMOR:"
"DOTA_Tooltip_Ability_item_glimmerdark_shield_bonus_health_regen"	"BONUSLEBENSREGENERATION:"
"[english]DOTA_Tooltip_Ability_item_glimmerdark_shield_bonus_health_regen"	"BONUS HEALTH REGEN:"
"DOTA_Tooltip_modifier_item_glimmerdark_shield_prism"	"Schimmern"
"[english]DOTA_Tooltip_modifier_item_glimmerdark_shield_prism"	"Gleam"
"DOTA_Tooltip_modifier_item_glimmerdark_shield_prism_Description"	"Diese Einheit ist immun gegen physischen Schaden, aber erleidet erheblich mehr Magieschaden."
"[english]DOTA_Tooltip_modifier_item_glimmerdark_shield_prism_Description"	"This unit is immune to physical damage but receives greatly increased magic damage."
"DOTA_Tooltip_Ability_item_dredged_trident"	"Schlickschreckens triefender Dreizack"
"[english]DOTA_Tooltip_Ability_item_dredged_trident"	"Siltbreaker's Dredged Trident"
"DOTA_Tooltip_Ability_item_dredged_trident_Description"	"<h1>Passiv: Kritischer Treffer</h1>Gewährt eine %crit_chance%%%ige Chance, bei einem Angriff %crit_multiplier% %% Schaden zu verursachen."
"[english]DOTA_Tooltip_Ability_item_dredged_trident_Description"	"<h1>Passive: Critical Strike</h1>Grants each attack a %crit_chance%%  chance to deal %crit_multiplier%%% additional damage."
"DOTA_Tooltip_ability_item_dredged_trident_Lore"	"Schlickschrecken hat sich diese vor langer Zeit aus den Tiefen geborgene, zerstörerische Waffe zu Eigen gemacht."
"[english]DOTA_Tooltip_ability_item_dredged_trident_Lore"	"Hauled from the deep long ago, Siltbreaker made this destructive weapon his own."
"DOTA_Tooltip_Ability_item_dredged_trident_bonus_damage"	"+$damage"
"[english]DOTA_Tooltip_Ability_item_dredged_trident_bonus_damage"	"+$damage"
"DOTA_Tooltip_Ability_item_ambient_sorcery"	"Arkane Umgebung"
"[english]DOTA_Tooltip_Ability_item_ambient_sorcery"	"Ambient Sorcery"
"DOTA_Tooltip_Ability_item_ambient_sorcery_Description"	"<h1>Passiv: Arkane Umgebung</h1>Reduziert die Magieresistenz in der Nähe befindlicher Einheiten um %aura_magic_reduction% %."
"[english]DOTA_Tooltip_Ability_item_ambient_sorcery_Description"	"<h1>Passive: Ambient Sorcery</h1>Reduces nearby units' magic resistance by %aura_magic_reduction%%."
"DOTA_Tooltip_Ability_item_ambient_sorcery_bonus_intelligence"	"+$int"
"[english]DOTA_Tooltip_Ability_item_ambient_sorcery_bonus_intelligence"	"+$int"
"DOTA_Tooltip_modifier_item_ambient_sorcery_effect"	"Arkane Umgebung"
"[english]DOTA_Tooltip_modifier_item_ambient_sorcery_effect"	"Ambient Sorcery"
"DOTA_Tooltip_modifier_item_ambient_sorcery_effect_Description"	"Diese Einheit erleidet mehr Magieschaden."
"[english]DOTA_Tooltip_modifier_item_ambient_sorcery_effect_Description"	"This unit is more vulnerable to magic damage."
"DOTA_Tooltip_Ability_item_ogre_seal_totem"	"Ogerrobbentotem"
"[english]DOTA_Tooltip_Ability_item_ogre_seal_totem"	"Ogre Seal Totem"
"DOTA_Tooltip_Ability_item_ogre_seal_totem_Description"	"<h1>Aktiv: Ogerrobbenplatscher</h1>Sie hüpfen wie eine Ogerrobbe, verursachen pro Sprung %damage% Schaden und betäuben getroffene Gegner für %stun_duration% Sekunde."
"[english]DOTA_Tooltip_Ability_item_ogre_seal_totem_Description"	"<h1>Active: Ogre Seal Flop</h1>Flop like an ogre seal, doing %damage% damage and stunning for %stun_duration% second on each bounce."
"DOTA_Tooltip_ability_item_ogre_seal_totem_Lore"	"Ein aus dem Zahn einer Ogerrobbe geschnitztes Totem."
"[english]DOTA_Tooltip_ability_item_ogre_seal_totem_Lore"	"A totem carved from an ogre seal's tooth."
"DOTA_Tooltip_Ability_item_ogre_seal_totem_bonus_strength"	"BONUSSTÄRKE:"
"[english]DOTA_Tooltip_Ability_item_ogre_seal_totem_bonus_strength"	"BONUS STRENGTH:"
"DOTA_Tooltip_Ability_item_ogre_seal_totem_bonus_hp"	"BONUS-LP:"
"[english]DOTA_Tooltip_Ability_item_ogre_seal_totem_bonus_hp"	"BONUS HP:"
"DOTA_Tooltip_Ability_item_bear_cloak"	"Umhang des Bären"
"[english]DOTA_Tooltip_Ability_item_bear_cloak"	"Cloak of the Bear"
"DOTA_Tooltip_Ability_item_bear_cloak_Description"	"<h1>Aura: Dickes Bärenfell</h1>Gewährt in der Nähe befindlichen Verbündeten %aura_bonus_magic_resist% %% Bonusmagieresistenz."
"[english]DOTA_Tooltip_Ability_item_bear_cloak_Description"	"<h1>Aura: Rough Bearskin</h1>Provides %aura_bonus_magic_resist%%  bonus magic resistance to nearby allies."
"DOTA_Tooltip_ability_item_bear_cloak_Lore"	"In der Wildnis gibt es natürliches Rüstzeug im Überfluss."
"[english]DOTA_Tooltip_ability_item_bear_cloak_Lore"	"There's no shortage of natural armor in the wild."
"DOTA_Tooltip_Ability_item_bear_cloak_bonus_magic_resist"	"BONUSMAGIERESISTENZ (SELBST):"
"[english]DOTA_Tooltip_Ability_item_bear_cloak_bonus_magic_resist"	"SELF BONUS MAGIC RESIST:"
"DOTA_Tooltip_modifier_item_bear_cloak_effect"	"Dickes Bärenfell"
"[english]DOTA_Tooltip_modifier_item_bear_cloak_effect"	"Rough Bearskin"
"DOTA_Tooltip_modifier_item_bear_cloak_effect_Description"	"Diese Einheit erhält Bonusmagieresistenz."
"[english]DOTA_Tooltip_modifier_item_bear_cloak_effect_Description"	"This unit has bonus magic resistance."
"DOTA_Tooltip_Ability_item_lifestone"	"Lebensstein"
"[english]DOTA_Tooltip_Ability_item_lifestone"	"Lifestone"
"DOTA_Tooltip_Ability_item_lifestone_Description"	"<h1>Aktiv: Lebenspakt</h1>Wandelt alle 0,5 Sekunden %pact_hp_cost% Leben in %pact_mana_gained% Mana um."
"[english]DOTA_Tooltip_Ability_item_lifestone_Description"	"<h1>Active: Health Pact</h1>Converts %pact_hp_cost% health into %pact_mana_gained% mana every 0.5 seconds."
"DOTA_Tooltip_ability_item_lifestone_Lore"	"Dieser Stein dürstet nach Blut."
"[english]DOTA_Tooltip_ability_item_lifestone_Lore"	"The stone thirsts for blood."
"DOTA_Tooltip_Ability_item_lifestone_hp_regen"	"LP-REGENERATION:"
"[english]DOTA_Tooltip_Ability_item_lifestone_hp_regen"	"HP REGEN:"
"DOTA_Tooltip_modifier_item_lifestone_pact"	"Lebenspakt"
"[english]DOTA_Tooltip_modifier_item_lifestone_pact"	"Health Pact"
"DOTA_Tooltip_modifier_item_lifestone_pact_Description"	"Diese Einheit wandelt Leben in Mana um."
"[english]DOTA_Tooltip_modifier_item_lifestone_pact_Description"	"This unit is converting health into mana."
"DOTA_Tooltip_Ability_item_corrupting_blade"	"Violette Klinge"
"[english]DOTA_Tooltip_Ability_item_corrupting_blade"	"Violet Blade"
"DOTA_Tooltip_Ability_item_corrupting_blade_Description"	"<h1>Passiv: Verwüstung</h1>Angriffe reduzieren die Rüstung des Ziels für %corruption_duration% Sekunden um %corruption_armor%."
"[english]DOTA_Tooltip_Ability_item_corrupting_blade_Description"	"<h1>Passive: Devastation</h1>Your attacks reduce the target's armor by %corruption_armor% for %corruption_duration% seconds."
"DOTA_Tooltip_ability_item_corrupting_blade_Lore"	"Eine furchterregende Waffe, deren Rezept in den violetten Archiven verloren ging."
"[english]DOTA_Tooltip_ability_item_corrupting_blade_Lore"	"A terrifying weapon whose recipe was lost in the Violet Archives."
"DOTA_Tooltip_Ability_item_corrupting_blade_bonus_damage"	"+$damage"
"[english]DOTA_Tooltip_Ability_item_corrupting_blade_bonus_damage"	"+$damage"
"DOTA_Tooltip_modifier_item_corrupting_blade_buff"	"Verwüstung"
"[english]DOTA_Tooltip_modifier_item_corrupting_blade_buff"	"Devastation"
"DOTA_Tooltip_modifier_item_corrupting_blade_buff_Description"	"Angriffe mit Violet Blade haben die Rüstung dieser Einheit um 14 reduziert."
"[english]DOTA_Tooltip_modifier_item_corrupting_blade_buff_Description"	"Violet Blade attacks reduced this unit's armor by 14."
"DOTA_Tooltip_Ability_item_amorphotic_shell"	"Amorphe Schale"
"[english]DOTA_Tooltip_Ability_item_amorphotic_shell"	"Amorphotic Shell"
"DOTA_Tooltip_Ability_item_amorphotic_shell_Description"	"<h1>Passiv: Mitose</h1>Wenn ein Angriff Ihnen mehr als 25 Schaden zufügt, haben Sie eine %amoeba_chance%%%ige Chance, %amoeba_duration% Sekunden lang eine verbündete Amöbenbrut zu beschwören."
"[english]DOTA_Tooltip_Ability_item_amorphotic_shell_Description"	"<h1>Passive: Division</h1>When you take an attack greater than 25 damage, you have a %amoeba_chance%%% to spawn a friendly amoebite for %amoeba_duration% seconds."
"DOTA_Tooltip_ability_item_amorphotic_shell_Lore"	"Ihre Form ist nicht ganz klar."
"[english]DOTA_Tooltip_ability_item_amorphotic_shell_Lore"	"The shape of it can't quite be grasped."
"DOTA_Tooltip_Ability_item_amorphotic_shell_bonus_strength"	"BONUSSTÄRKE:"
"[english]DOTA_Tooltip_Ability_item_amorphotic_shell_bonus_strength"	"BONUS STRENGTH:"
"DOTA_Tooltip_Ability_item_amorphotic_shell_bonus_intelligence"	"BONUSINTELLIGENZ:"
"[english]DOTA_Tooltip_Ability_item_amorphotic_shell_bonus_intelligence"	"BONUS INTELLIGENCE:"
"DOTA_Tooltip_Ability_item_amorphotic_shell_bonus_agility"	"BONUSAGILITÄT:"
"[english]DOTA_Tooltip_Ability_item_amorphotic_shell_bonus_agility"	"BONUS AGILITY:"
"DOTA_Tooltip_ability_aghsfort_aura_reward_hp"	"Granitaura"
"[english]DOTA_Tooltip_ability_aghsfort_aura_reward_hp"	"Granite Aura"
"DOTA_Tooltip_ability_aghsfort_aura_reward_hp_Description"	"Erhöht die maximalen Lebenspunkte verbündeter Einheiten in der Nähe."
"[english]DOTA_Tooltip_ability_aghsfort_aura_reward_hp_Description"	"Increases the health capacity of nearby units."
"DOTA_Tooltip_ability_aghsfort_aura_reward_hp_bonus_hp"	"%BONUS-LP:"
"[english]DOTA_Tooltip_ability_aghsfort_aura_reward_hp_bonus_hp"	"%BONUS HP:"
"DOTA_Tooltip_ability_aghsfort_aura_reward_armor"	"Armadilloaura"
"[english]DOTA_Tooltip_ability_aghsfort_aura_reward_armor"	"Armadillo Aura"
"DOTA_Tooltip_ability_aghsfort_aura_reward_armor_Description"	"Die Haut Ihrer Verbündeten wird dicker, wodurch sich deren Resistenz gegen physischen Schaden erhöht."
"[english]DOTA_Tooltip_ability_aghsfort_aura_reward_armor_Description"	"Your allies hides have become hardened with increased resistance to physical damage."
"DOTA_Tooltip_ability_aghsfort_aura_reward_armor_bonus_armor"	"BONUSRÜSTUNG:"
"[english]DOTA_Tooltip_ability_aghsfort_aura_reward_armor_bonus_armor"	"BONUS ARMOR:"
"DOTA_Tooltip_modifier_aghsfort_aura_reward_armor_bonus"	"Armadilloaura"
"[english]DOTA_Tooltip_modifier_aghsfort_aura_reward_armor_bonus"	"Armadillo Aura"
"DOTA_Tooltip_modifier_aghsfort_aura_reward_armor_bonus_Description"	"Rüstung um %dMODIFIER_PROPERTY_PHYSICAL_ARMOR_BONUS% erhöht."
"[english]DOTA_Tooltip_modifier_aghsfort_aura_reward_armor_bonus_Description"	"Providing additional %dMODIFIER_PROPERTY_PHYSICAL_ARMOR_BONUS% armor."
"DOTA_Tooltip_ability_aghsfort_aura_reward_magic_resist"	"Magischer Umhang"
"[english]DOTA_Tooltip_ability_aghsfort_aura_reward_magic_resist"	"Magical Cloak"
"DOTA_Tooltip_ability_aghsfort_aura_reward_magic_resist_Description"	"Ein magischer Umhang, der die Magieresistenz erhöht."
"[english]DOTA_Tooltip_ability_aghsfort_aura_reward_magic_resist_Description"	"A magic cloak that increases magic resistance."
"DOTA_Tooltip_ability_aghsfort_aura_reward_magic_resist_bonus_magical_armor"	"MAGIERESISTENZ:"
"[english]DOTA_Tooltip_ability_aghsfort_aura_reward_magic_resist_bonus_magical_armor"	"MAGIC RESISTANCE:"
"DOTA_Tooltip_modifier_aghsfort_aura_reward_magic_resist_bonus"	"Magischer Umhang"
"[english]DOTA_Tooltip_modifier_aghsfort_aura_reward_magic_resist_bonus"	"Magical Cloak"
"DOTA_Tooltip_modifier_aghsfort_aura_reward_magic_resist_bonus_Description"	"Magieresistenz um %dMODIFIER_PROPERTY_MAGICAL_RESISTANCE_BONUS% %% erhöht."
"[english]DOTA_Tooltip_modifier_aghsfort_aura_reward_magic_resist_bonus_Description"	"Providing additional %dMODIFIER_PROPERTY_MAGICAL_RESISTANCE_BONUS% Magic Resistance."
"DOTA_Tooltip_ability_aghsfort_aura_reward_crit_chance"	"Präsenz des Klingenmeisters"
"[english]DOTA_Tooltip_ability_aghsfort_aura_reward_crit_chance"	"Blademaster's Presence"
"DOTA_Tooltip_ability_aghsfort_aura_reward_crit_chance_Description"	"Verleiht Verbündeten eine %crit_chance%%%ige Chance, mit einem Angriff %crit_multiplier% %% kritischen Schaden zu verursachen."
"[english]DOTA_Tooltip_ability_aghsfort_aura_reward_crit_chance_Description"	"Allies granted a %crit_chance%%% chance to deal a critical strike doing %crit_multiplier%%% damage."
"DOTA_Tooltip_ability_aghsfort_aura_reward_crit_chance_crit_chance"	"%KRITISCHE TREFFERCHANCE:"
"[english]DOTA_Tooltip_ability_aghsfort_aura_reward_crit_chance_crit_chance"	"%CRITICAL CHANCE:"
"DOTA_Tooltip_ability_aghsfort_aura_reward_crit_chance_crit_multiplier"	"KRITISCHER SCHADEN:"
"[english]DOTA_Tooltip_ability_aghsfort_aura_reward_crit_chance_crit_multiplier"	"CRITICAL DAMAGE:"
"DOTA_Tooltip_modifier_aghsfort_reward_crit_aura_bonus"	"Präsenz des Klingenmeisters"
"[english]DOTA_Tooltip_modifier_aghsfort_reward_crit_aura_bonus"	"Blademaster's Presence"
"DOTA_Tooltip_modifier_aghsfort_reward_crit_aura_bonus_Description"	"Mit jedem Angriff gibt es die Chance, einen kritischen Treffer zu landen."
"[english]DOTA_Tooltip_modifier_aghsfort_reward_crit_aura_bonus_Description"	"Adds a chance that every attack deals a critical strike."
"DOTA_Tooltip_ability_aghsfort_tempbuff_corpse_explosion"	"Leichenexplosion"
"[english]DOTA_Tooltip_ability_aghsfort_tempbuff_corpse_explosion"	"Corpse Explosion"
"DOTA_Tooltip_ability_aghsfort_tempbuff_corpse_explosion_aura_Description"	"Gegnerische Einheiten haben eine Chance, blutig zu explodieren und in ihrem Umkreis 25 %% ihrer max. LP als magischen Schaden zu verursachen."
"[english]DOTA_Tooltip_ability_aghsfort_tempbuff_corpse_explosion_aura_Description"	"Enemy units have a chance to explode in a gory heap, dealing Magic Damage equal to 25%% of their max HP to nearby units."
"DOTA_Tooltip_ability_aghsfort_tempbuff_corpse_explosion_corpse_explosion_radius"	"EXPLOSIONSRADIUS:"
"[english]DOTA_Tooltip_ability_aghsfort_tempbuff_corpse_explosion_corpse_explosion_radius"	"EXPLOSION RADIUS:"
"DOTA_Tooltip_ability_aghsfort_tempbuff_corpse_explosion_corpse_explosion_damage_pct"	"%MAX. LP ALS SCHADEN:"
"[english]DOTA_Tooltip_ability_aghsfort_tempbuff_corpse_explosion_corpse_explosion_damage_pct"	"%MAX HP TO DAMAGE:"
"DOTA_Tooltip_ability_aghsfort_tempbuff_corpse_explosion_corpse_explosion_chance_pct"	"%EXPLOSIONSCHANCE:"
"[english]DOTA_Tooltip_ability_aghsfort_tempbuff_corpse_explosion_corpse_explosion_chance_pct"	"%EXPLOSION CHANCE:"
"DOTA_Tooltip_modifier_aghsfort_tempbuff_corpse_explosion_aura"	"Leichenexplosion"
"[english]DOTA_Tooltip_modifier_aghsfort_tempbuff_corpse_explosion_aura"	"Corpse Explosion"
"DOTA_Tooltip_modifier_aghsfort_tempbuff_corpse_explosion_aura_Description"	"Gegnerische Einheiten haben eine Chance, blutig zu explodieren und in ihrem Umkreis 25&nbsp;%% ihrer max. LP als magischen Schaden zu verursachen."
"[english]DOTA_Tooltip_modifier_aghsfort_tempbuff_corpse_explosion_aura_Description"	"Enemy units have a chance to explode in a gory heap, dealing Magic Damage equal to 25%% of their max HP to nearby units."
"DOTA_Tooltip_modifier_aghsfort_tempbuff_corpse_explosion_debuff_Description"	"Gegnerische Einheiten haben eine Chance, blutig zu explodieren und in ihrem Umkreis 25&nbsp;%% ihrer max. LP als magischen Schaden zu verursachen."
"[english]DOTA_Tooltip_modifier_aghsfort_tempbuff_corpse_explosion_debuff_Description"	"When this unit dies, there is a chance it will explode dealing Magic Damage equal to 25%% of their max HP to nearby units."
"DOTA_Tooltip_modifier_blessing_armor"	"Segen der Rüstung"
"[english]DOTA_Tooltip_modifier_blessing_armor"	"Armor Blessing"
"DOTA_Tooltip_modifier_blessing_armor_Description"	"Rüstung um %dMODIFIER_PROPERTY_PHYSICAL_ARMOR_BONUS% erhöht."
"[english]DOTA_Tooltip_modifier_blessing_armor_Description"	"Providing additional %dMODIFIER_PROPERTY_PHYSICAL_ARMOR_BONUS% armor."
"DOTA_Tooltip_modifier_blessing_attack_speed"	"Segen des Angriffstempos"
"[english]DOTA_Tooltip_modifier_blessing_attack_speed"	"Attack Speed Blessing"
"DOTA_Tooltip_modifier_blessing_attack_speed_Description"	"Angriffstempo um %dMODIFIER_PROPERTY_ATTACKSPEED_BONUS_CONSTANT% erhöht."
"[english]DOTA_Tooltip_modifier_blessing_attack_speed_Description"	"Providing %dMODIFIER_PROPERTY_ATTACKSPEED_BONUS_CONSTANT% attack speed."
"DOTA_Tooltip_modifier_blessing_evasion"	"Segen des Ausweichens"
"[english]DOTA_Tooltip_modifier_blessing_evasion"	"Evasion Blessing"
"DOTA_Tooltip_modifier_blessing_evasion_Description"	"%dMODIFIER_PROPERTY_EVASION_CONSTANT%%%ige Chance, Angriffen auszuweichen."
"[english]DOTA_Tooltip_modifier_blessing_evasion_Description"	"Providing %dMODIFIER_PROPERTY_EVASION_CONSTANT%%% evasion."
"DOTA_Tooltip_modifier_blessing_mana_boost"	"Segen des max. Manas"
"[english]DOTA_Tooltip_modifier_blessing_mana_boost"	"Max Mana Blessing"
"DOTA_Tooltip_modifier_blessing_mana_boost_Description"	"Maximaler Manavorrat um %dMODIFIER_PROPERTY_EXTRA_MANA_PERCENTAGE% %% erhöht."
"[english]DOTA_Tooltip_modifier_blessing_mana_boost_Description"	"Providing %dMODIFIER_PROPERTY_EXTRA_MANA_PERCENTAGE%%% max mana."
"DOTA_Tooltip_modifier_blessing_health_boost"	"Segen der max. LP"
"[english]DOTA_Tooltip_modifier_blessing_health_boost"	"Max Health Blessing"
"DOTA_Tooltip_modifier_blessing_health_boost_Description"	"Maximale Lebenspunkte um %dMODIFIER_PROPERTY_EXTRA_HEALTH_PERCENTAGE% %% erhöht."
"[english]DOTA_Tooltip_modifier_blessing_health_boost_Description"	"Providing %dMODIFIER_PROPERTY_EXTRA_HEALTH_PERCENTAGE%%% max health."
"DOTA_Tooltip_modifier_blessing_magic_resist"	"Segen der Magieresistenz"
"[english]DOTA_Tooltip_modifier_blessing_magic_resist"	"Magic Resist Blessing"
"DOTA_Tooltip_modifier_blessing_magic_resist_Description"	"Magieresistenz um %dMODIFIER_PROPERTY_MAGICAL_RESISTANCE_BONUS% %% erhöht."
"[english]DOTA_Tooltip_modifier_blessing_magic_resist_Description"	"Providing %dMODIFIER_PROPERTY_MAGICAL_RESISTANCE_BONUS%%% magic resistance."
"DOTA_Tooltip_modifier_blessing_magic_damage_bonus"	"Segen der Zauberverstärkung"
"[english]DOTA_Tooltip_modifier_blessing_magic_damage_bonus"	"Spell Amplification Blessing"
"DOTA_Tooltip_modifier_blessing_magic_damage_bonus_Description"	"Zauberverstärkung um %dMODIFIER_PROPERTY_SPELL_AMPLIFY_PERCENTAGE% %% erhöht."
"[english]DOTA_Tooltip_modifier_blessing_magic_damage_bonus_Description"	"Providing %dMODIFIER_PROPERTY_SPELL_AMPLIFY_PERCENTAGE%%% spell amplification."
"DOTA_Tooltip_modifier_blessing_damage_bonus"	"Segen des Bonusschadens"
"[english]DOTA_Tooltip_modifier_blessing_damage_bonus"	"Damage Bonus Blessing"
"DOTA_Tooltip_modifier_blessing_damage_bonus_Description"	"Angriffsschaden um %dMODIFIER_PROPERTY_PREATTACK_BONUS_DAMAGE% erhöht (+%dMODIFIER_PROPERTY_TOOLTIP% pro Level)."
"[english]DOTA_Tooltip_modifier_blessing_damage_bonus_Description"	"Providing %dMODIFIER_PROPERTY_PREATTACK_BONUS_DAMAGE% attack damage (+%dMODIFIER_PROPERTY_TOOLTIP% per level)."
"DOTA_Tooltip_modifier_blessing_movement_speed"	"Segen des Bewegungstempos"
"[english]DOTA_Tooltip_modifier_blessing_movement_speed"	"Movement Speed Blessing"
"DOTA_Tooltip_modifier_blessing_movement_speed_Description"	"Bewegungstempo um %dMODIFIER_PROPERTY_MOVESPEED_BONUS_PERCENTAGE% %% erhöht."
"[english]DOTA_Tooltip_modifier_blessing_movement_speed_Description"	"Providing %dMODIFIER_PROPERTY_MOVESPEED_BONUS_PERCENTAGE%%% movement speed."
"DOTA_Tooltip_modifier_blessing_damage_reflect"	"Schadenreflexion"
"[english]DOTA_Tooltip_modifier_blessing_damage_reflect"	"Damage Reflection"
"DOTA_Tooltip_modifier_blessing_damage_reflect_Description"	"Reflektiert %dMODIFIER_PROPERTY_TOOLTIP% %% des erlittenen Schadens zurück auf den Angreifer."
"[english]DOTA_Tooltip_modifier_blessing_damage_reflect_Description"	"Reflecting %dMODIFIER_PROPERTY_TOOLTIP%%% of damage back on the attacker."
"DOTA_Tooltip_modifier_blessing_spell_life_steal"	"Segen des Zauberlebensraubs"
"[english]DOTA_Tooltip_modifier_blessing_spell_life_steal"	"Spell Life Steal Blessing"
"DOTA_Tooltip_modifier_blessing_spell_life_steal_Description"	"%dMODIFIER_PROPERTY_TOOLTIP% %% des Zauberschadens wird in Heilung umgewandelt."
"[english]DOTA_Tooltip_modifier_blessing_spell_life_steal_Description"	"%dMODIFIER_PROPERTY_TOOLTIP%%% of spell damage dealt is returned as health."
"DOTA_Tooltip_modifier_blessing_life_steal"	"Segen des Lebensraubs"
"[english]DOTA_Tooltip_modifier_blessing_life_steal"	"Life Steal Blessing"
"DOTA_Tooltip_modifier_blessing_life_steal_Description"	"%dMODIFIER_PROPERTY_TOOLTIP% %% des Angriffsschadens wird in Heilung umgewandelt."
"[english]DOTA_Tooltip_modifier_blessing_life_steal_Description"	"%dMODIFIER_PROPERTY_TOOLTIP%%% of attack damage dealt is returned as health."
"DOTA_Tooltip_modifier_blessing_potion_dragon"	"Segen des Drachentranks"
"[english]DOTA_Tooltip_modifier_blessing_potion_dragon"	"Dragon Potion Blessing"
"DOTA_Tooltip_modifier_blessing_potion_dragon_Description"	"Trank des Drachen verwandelt Sie nun in einen Schwarzdrachen, was den Angriffsschaden um weitere %dMODIFIER_PROPERTY_TOOLTIP2% und den Flächenschaden um weitere %dMODIFIER_PROPERTY_TOOLTIP% %% erhöht."
"[english]DOTA_Tooltip_modifier_blessing_potion_dragon_Description"	"Dragon Potions now transform you into a Black Dragon, increasing attack damage by an additional %dMODIFIER_PROPERTY_TOOLTIP2% and splash damage by an additional %dMODIFIER_PROPERTY_TOOLTIP%%%."
"DOTA_Tooltip_modifier_blessing_potion_torrent"	"Segen des Sturzfluttranks"
"[english]DOTA_Tooltip_modifier_blessing_potion_torrent"	"Torrent Potion Blessing"
"DOTA_Tooltip_modifier_blessing_potion_ravage"	"Segen des Verwüstungstranks"
"[english]DOTA_Tooltip_modifier_blessing_potion_ravage"	"Ravage Potion Blessing"
"DOTA_Tooltip_modifier_blessing_potion_ravage_Description"	"Radius von Verwüstungstränken ist %dMODIFIER_PROPERTY_TOOLTIP% größer."
"[english]DOTA_Tooltip_modifier_blessing_potion_ravage_Description"	"Ravage Potions hit enemies in an additional %dMODIFIER_PROPERTY_TOOLTIP% radius."
"DOTA_Tooltip_modifier_blessing_potion_shadow_wave"	"Segen des Schattenwellentranks"
"[english]DOTA_Tooltip_modifier_blessing_potion_shadow_wave"	"Shadow Wave Potion Blessing"
"DOTA_Tooltip_modifier_blessing_potion_purification"	"Segen des Reinigungstranks"
"[english]DOTA_Tooltip_modifier_blessing_potion_purification"	"Purification Potion Blessing"
"DOTA_Tooltip_modifier_blessing_potion_purification_Description"	"Schadensradius von Tränken der Reinigung um %dMODIFIER_PROPERTY_TOOLTIP% erhöht."
"[english]DOTA_Tooltip_modifier_blessing_potion_purification_Description"	"Purification Potions damage enemies in an additional %dMODIFIER_PROPERTY_TOOLTIP% radius."
"DOTA_Tooltip_modifier_blessing_respawn_time_reduction"	"Segen des schnellen Wiedereinstiegs"
"[english]DOTA_Tooltip_modifier_blessing_respawn_time_reduction"	"Respawn Time Reduction Blessing"
"DOTA_Tooltip_modifier_blessing_respawn_time_reduction_Description"	"Wiedereinstiegszeit um %dMODIFIER_PROPERTY_TOOLTIP% %% reduziert."
"[english]DOTA_Tooltip_modifier_blessing_respawn_time_reduction_Description"	"Reducing respawn time by %dMODIFIER_PROPERTY_TOOLTIP%%%."
"DOTA_Tooltip_modifier_blessing_death_detonation"	"Todesexplosion"
"[english]DOTA_Tooltip_modifier_blessing_death_detonation"	"Death Detonation"
"DOTA_Tooltip_modifier_blessing_death_detonation_Description"	"Explodiert beim Tod, was im Umkreis von %dMODIFIER_PROPERTY_TOOLTIP2% Einheiten %dMODIFIER_PROPERTY_TOOLTIP% Schaden pro Level verursacht."
"[english]DOTA_Tooltip_modifier_blessing_death_detonation_Description"	"Create an explosion on death, dealing %dMODIFIER_PROPERTY_TOOLTIP% damage per level in %dMODIFIER_PROPERTY_TOOLTIP2% radius."
"DOTA_Tooltip_modifier_blessing_strength"	"Stärkebonus"
"[english]DOTA_Tooltip_modifier_blessing_strength"	"Strength Bonus"
"DOTA_Tooltip_modifier_blessing_strength_Description"	"Erhöht die Stärke um %dMODIFIER_PROPERTY_STATS_STRENGTH_BONUS%."
"[english]DOTA_Tooltip_modifier_blessing_strength_Description"	"Providing additional %dMODIFIER_PROPERTY_STATS_STRENGTH_BONUS% strength."
"DOTA_Tooltip_modifier_blessing_agility"	"Agilitätsbonus"
"[english]DOTA_Tooltip_modifier_blessing_agility"	"Agility Bonus"
"DOTA_Tooltip_modifier_blessing_agility_Description"	"Erhöht die Agilität um %dMODIFIER_PROPERTY_STATS_AGILITY_BONUS%."
"[english]DOTA_Tooltip_modifier_blessing_agility_Description"	"Providing additional %dMODIFIER_PROPERTY_STATS_AGILITY_BONUS% agility."
"DOTA_Tooltip_modifier_blessing_intelligence"	"Intellektbonus"
"[english]DOTA_Tooltip_modifier_blessing_intelligence"	"Intellect Bonus"
"DOTA_Tooltip_modifier_blessing_intelligence_Description"	"Erhöht den Intellekt um %dMODIFIER_PROPERTY_STATS_INTELLECT_BONUS%."
"[english]DOTA_Tooltip_modifier_blessing_intelligence_Description"	"Providing additional %dMODIFIER_PROPERTY_STATS_INTELLECT_BONUS% intellect."
"DOTA_Tooltip_modifier_blessing_potion_health_Description"	"Heiltränke stellen zusätzlich %dMODIFIER_PROPERTY_TOOLTIP%&nbsp;%% der max. Lebenspunkte wieder her."
"[english]DOTA_Tooltip_modifier_blessing_potion_health_Description"	"Health potions heal you for an additional %dMODIFIER_PROPERTY_TOOLTIP%%% of your max health."
"DOTA_Tooltip_modifier_blessing_potion_mana_Description"	"Manatränke stellen zusätzlich %dMODIFIER_PROPERTY_TOOLTIP%&nbsp;%% des maximalen Manas wieder her."
"[english]DOTA_Tooltip_modifier_blessing_potion_mana_Description"	"Mana potions restore an additional %dMODIFIER_PROPERTY_TOOLTIP%%% of your max mana."
"DOTA_Tooltip_modifier_blessing_restore_mana"	"Segen der Manabeute"
"[english]DOTA_Tooltip_modifier_blessing_restore_mana"	"Mana on Kill Blessing"
"DOTA_Tooltip_modifier_blessing_restore_mana_Description"	"Das Töten eines Gegners stellt %dMODIFIER_PROPERTY_TOOLTIP% Mana wiederher."
"[english]DOTA_Tooltip_modifier_blessing_restore_mana_Description"	"Restore %dMODIFIER_PROPERTY_TOOLTIP% mana each time you kill an enemy."
"DOTA_Tooltip_modifier_blessing_book_strength"	"Segen des Stärkebuchs"
"[english]DOTA_Tooltip_modifier_blessing_book_strength"	"Strength Book Blessing"
"DOTA_Tooltip_modifier_blessing_book_strength_Description"	"Buch der Stärke erhöht beim Benutzen den Stärkewert um %dMODIFIER_PROPERTY_TOOLTIP%."
"[english]DOTA_Tooltip_modifier_blessing_book_strength_Description"	"Books of Strength provide %dMODIFIER_PROPERTY_TOOLTIP% additional strength when used."
"DOTA_Tooltip_modifier_blessing_book_agility"	"Segen des Agilitätsbuchs"
"[english]DOTA_Tooltip_modifier_blessing_book_agility"	"Agility Book Blessing"
"DOTA_Tooltip_modifier_blessing_book_agility_Description"	"Buch der Agilität erhöht beim Benutzen den Agilitätswert um %dMODIFIER_PROPERTY_TOOLTIP%."
"[english]DOTA_Tooltip_modifier_blessing_book_agility_Description"	"Books of Agility provide %dMODIFIER_PROPERTY_TOOLTIP% additional agility when used."
"DOTA_Tooltip_modifier_blessing_book_intelligence"	"Segen des Intelligenzbuchs"
"[english]DOTA_Tooltip_modifier_blessing_book_intelligence"	"Intelligence Book Blessing"
"DOTA_Tooltip_modifier_blessing_book_intelligence_Description"	"Buch der Intelligenz erhöht beim Benutzen den Intelligenzwert um %dMODIFIER_PROPERTY_TOOLTIP%."
"[english]DOTA_Tooltip_modifier_blessing_book_intelligence_Description"	"Books of Intelligence provide %dMODIFIER_PROPERTY_TOOLTIP% additional intelligence when used."
"DOTA_Tooltip_modifier_urn_upheaval"	"Griff der Urne"
"[english]DOTA_Tooltip_modifier_urn_upheaval"	"Urn's Grip"
"DOTA_Tooltip_modifier_urn_upheaval_Description"	"Bewegungstempo stark reduziert."
"[english]DOTA_Tooltip_modifier_urn_upheaval_Description"	"Movement speed is greatly reduced."
}
}
