"lang"
{
"Language"	"turkish"
"Tokens"
{
"addon_game_name"	"Aghanim'in Labirenti"
"[english]addon_game_name"	"Aghanim's Labyrinth"
"DOTA_GameMode_15"	"Aghanim'in Labirenti"
"[english]DOTA_GameMode_15"	"Aghanim's Labyrinth"
"DOTA_GameMode_19"	"Aghanim'in Labirenti"
"[english]DOTA_GameMode_19"	"Aghanim's Labyrinth"
"aghanim_bonus_round_time_left"	"KALAN SÜRE"
"[english]aghanim_bonus_round_time_left"	"TIME LEFT"
"aghanim_bonus_round_total_gold"	"Toplam Altın"
"[english]aghanim_bonus_round_total_gold"	"Total Gold"
"DOTA_Defeated"	"Takımınız hezimete uğradı!"
"[english]DOTA_Defeated"	"Your team has perished!"
"DOTA_HUD_EnemiesRemaining"	"KALAN DÜŞMAN:"
"[english]DOTA_HUD_EnemiesRemaining"	"ENEMIES REMAINING:"
"DOTA_HUD_TimeRemaining"	"KALAN SÜRE:"
"[english]DOTA_HUD_TimeRemaining"	"TIME REMAINING:"
"DOTA_HUD_Victory"	"ZAFER!"
"[english]DOTA_HUD_Victory"	"VICTORY!"
"DOTA_HUD_Defeat"	"YENİLGİ!"
"[english]DOTA_HUD_Defeat"	"DEFEAT!"
"DOTA_HUD_Kills"	"LEŞ"
"[english]DOTA_HUD_Kills"	"KILLS"
"DOTA_HUD_Deaths"	"ÖLÜM"
"[english]DOTA_HUD_Deaths"	"DEATHS"
"DOTA_HUD_Saves"	"CANLANDIRMA"
"[english]DOTA_HUD_Saves"	"REVIVES"
"DOTA_HUD_Bags"	"ÇANTA"
"[english]DOTA_HUD_Bags"	"BAGS"
"DOTA_HUD_Mute"	"SUSTUR"
"[english]DOTA_HUD_Mute"	"MUTE"
"DOTA_HUD_PlayAgain"	"Tekrar Oyna?"
"[english]DOTA_HUD_PlayAgain"	"Play Again?"
"DOTA_HUD_Yes"	"EVET"
"[english]DOTA_HUD_Yes"	"YES"
"DOTA_HUD_No"	"HAYIR"
"[english]DOTA_HUD_No"	"NO"
"DOTA_HUD_Score"	"RAUNT PUANI"
"[english]DOTA_HUD_Score"	"SCORE"
"DOTA_HUD_GoldBags"	"TOPLANAN ALTIN KESESİ"
"[english]DOTA_HUD_GoldBags"	"GOLD BAGS COLLECTED"
"DOTA_HUD_GoldBagsMissed"	"KAÇIRILAN ALTIN KESESİ"
"[english]DOTA_HUD_GoldBagsMissed"	"GOLD BAGS MISSED"
"DOTA_HUD_TeamDeaths"	"TAKIM ÖLÜMLERİ"
"[english]DOTA_HUD_TeamDeaths"	"TEAM DEATHS"
"DOTA_HUD_Rewards"	"SCEPTER PARÇALARI"
"[english]DOTA_HUD_Rewards"	"SCEPTER SHARDS"
"DOTA_HUD_Blessings"	"KUTSAMALAR"
"[english]DOTA_HUD_Blessings"	"BLESSINGS"
"DOTA_HUD_RoomRewards"	"Oda Ödülleri"
"[english]DOTA_HUD_RoomRewards"	"Room Rewards"
"DOTA_HUD_ShowBlessings"	"Kutsamaları Göster"
"[english]DOTA_HUD_ShowBlessings"	"Show Blessings"
"DOTA_HUD_HideBlessings"	"Kutsamaları Gizle"
"[english]DOTA_HUD_HideBlessings"	"Hide Blessings"
"DOTA_HUD_Reward_Header"	"Ödülünü seç"
"[english]DOTA_HUD_Reward_Header"	"Choose your reward"
"DOTA_HUD_Reward_Gold"	"Bonus Altın"
"[english]DOTA_HUD_Reward_Gold"	"Bonus Gold"
"DOTA_HUD_Reward_Gold_desc"	"{d:quantity} Altın"
"[english]DOTA_HUD_Reward_Gold_desc"	"{d:quantity} Gold"
"DOTA_HUD_Reward_ExtraLives"	"Fazladan Can"
"[english]DOTA_HUD_Reward_ExtraLives"	"Extra Live(s)"
"DOTA_HUD_Reward_ExtraLives_desc"	"{d:quantity} Fazladan Can"
"[english]DOTA_HUD_Reward_ExtraLives_desc"	"{d:quantity} Extra Life"
"DOTA_HUD_Reward_Item"	"Tarafsız Yaratık Eşyası"
"[english]DOTA_HUD_Reward_Item"	"Neutral Item"
"DOTA_HUD_Reward_TempBuff"	"Geçici Güçlendirme"
"[english]DOTA_HUD_Reward_TempBuff"	"Temp Buff"
"DOTA_HUD_Reward_Aura"	"Aura"
"[english]DOTA_HUD_Reward_Aura"	"Aura"
"DOTA_HUD_Reward_AbilityUpgrade"	"Aghanim'in Kutsaması"
"[english]DOTA_HUD_Reward_AbilityUpgrade"	"Aghanim's Blessing"
"DOTA_HUD_Reward_MinotrAbilityUpgrade"	"Yetenek Güçlendirme"
"[english]DOTA_HUD_Reward_MinotrAbilityUpgrade"	"Ability Upgrade"
"DOTA_HUD_Reward_AdditionalRewards"	"Verilen Ek Ödüller"
"[english]DOTA_HUD_Reward_AdditionalRewards"	"Additional Rewards Granted"
"DOTA_HUD_Game_Mode_Header"	"Aghanim'in Labirenti'ne Hoş Geldiniz!"
"[english]DOTA_HUD_Game_Mode_Header"	"Welcome To Aghanim's Labyrinth!"
"DOTA_HUD_Rewards_AscensionLevel"	"Yükseliş Seviyesi: {d:ascension_level}"
"[english]DOTA_HUD_Rewards_AscensionLevel"	"Ascension Level: {d:ascension_level}"
"DOTA_HUD_TopBar_Difficulty"	"{s:difficulty_name}"
"[english]DOTA_HUD_TopBar_Difficulty"	"{s:difficulty_name}"
"boss_shop"	"Bristle'ın Süs Dükkânı"
"[english]boss_shop"	"Bristle's Baubles"
"DOTA_Subshop_1"	"Temeller"
"[english]DOTA_Subshop_1"	"Basics"
"DOTA_Subshop_2"	"Takılar"
"[english]DOTA_Subshop_2"	"Trinkets"
"DOTA_HUD_BattleRoyaleDamageStarting"	"Savaşa katıl, korkak!"
"[english]DOTA_HUD_BattleRoyaleDamageStarting"	"Join the battle, coward!"
"DOTA_Tooltip_Ability_item_battle_points"	"Mücadele Puanı"
"[english]DOTA_Tooltip_Ability_item_battle_points"	"Battle Points"
"DOTA_Tooltip_Ability_item_arcane_fragments"	"Büyülü Parça"
"[english]DOTA_Tooltip_Ability_item_arcane_fragments"	"Arcane Fragments"
"DOTA_RewardTooltip_Gold"	"Altın"
"[english]DOTA_RewardTooltip_Gold"	"Gold"
"DOTA_RewardTooltip_XP"	"TP"
"[english]DOTA_RewardTooltip_XP"	"XP"
"DOTA_HUD_Rewards_ShowRewards"	"SCEPTER PARÇASI MEVCUT"
"[english]DOTA_HUD_Rewards_ShowRewards"	"SCEPTER SHARD AVAILABLE"
"DOTA_HUD_Rewards_Info"	"Skor tabelasında seçili güçlendirmeleri göster"
"[english]DOTA_HUD_Rewards_Info"	"View selected upgrades in the scoreboard"
"DOTA_HUD_REWARD_TIER1_Desc"	"Seviye 1"
"[english]DOTA_HUD_REWARD_TIER1_Desc"	"Tier 1"
"DOTA_HUD_REWARD_TIER2_Desc"	"Seviye 2"
"[english]DOTA_HUD_REWARD_TIER2_Desc"	"Tier 2"
"DOTA_HUD_REWARD_TIER3_Desc"	"Seviye 3"
"[english]DOTA_HUD_REWARD_TIER3_Desc"	"Tier 3"
"DOTA_HUD_REWARD_TIER4_Desc"	"Seviye 4"
"[english]DOTA_HUD_REWARD_TIER4_Desc"	"Tier 4"
"DOTA_HUD_REWARD_TIER5_Desc"	"Seviye 5"
"[english]DOTA_HUD_REWARD_TIER5_Desc"	"Tier 5"
"DOTA_Hud_EncounterDepth"	"Derinlik {s:encounter_depth}"
"[english]DOTA_Hud_EncounterDepth"	"Depth {s:encounter_depth}"
"DOTA_Hud_AscenionAbilitiesTitle"	"Ek Değiştiriciler"
"[english]DOTA_Hud_AscenionAbilitiesTitle"	"Additional Modifiers"
"DOTA_Hud_Elite_Encounter_Discover"	"Seçkin Karşılaşma - 2 Kat Ödül"
"[english]DOTA_Hud_Elite_Encounter_Discover"	"Elite Encounter - 2x Rewards"
"DOTA_Hud_Elite_Encounter"	"Seçkin Karşılaşma"
"[english]DOTA_Hud_Elite_Encounter"	"Elite Encounter"
"DOTA_HUD_Reward_Rarity_Common"	"<font color='#88A6D9'>YAYGIN</font> bir Scepter Parçası seçin"
"[english]DOTA_HUD_Reward_Rarity_Common"	"Choose a <font color='#88A6D9'>COMMON</font> Scepter Shard"
"DOTA_HUD_Reward_Rarity_Elite"	"<font color='#D02B29'>SEÇKİN</font> bir Scepter Parçası seçin"
"[english]DOTA_HUD_Reward_Rarity_Elite"	"Choose an <font color='#D02B29'>ELITE</font> Scepter Shard"
"DOTA_HUD_Reward_Rarity_Epic"	"<font color='#7266FF'>EFSANEVİ</font> bir Scepter Parçası seçin"
"[english]DOTA_HUD_Reward_Rarity_Epic"	"Choose a <font color='#7266FF'>LEGENDARY</font> Scepter Shard"
"DOTA_HUD_REWARD_TYPE_GOLD_Toast"	"{s:player_name}, {d:int_value} seçti <panel class='CombatEventGoldIcon'/>"
"[english]DOTA_HUD_REWARD_TYPE_GOLD_Toast"	"{s:player_name} chose {d:int_value} <panel class='CombatEventGoldIcon'/>"
"DOTA_HUD_REWARD_TYPE_ITEM_Toast"	"{s:player_name}, {s:locstring_value} seçti"
"[english]DOTA_HUD_REWARD_TYPE_ITEM_Toast"	"{s:player_name} chose {s:locstring_value}"
"DOTA_HUD_REWARD_TYPE_ABILITY_UPGRADE_Toast"	"{s:player_name}, {s:locstring_value} seçti"
"[english]DOTA_HUD_REWARD_TYPE_ABILITY_UPGRADE_Toast"	"{s:player_name} chose {s:locstring_value}"
"DOTA_HUD_REWARD_TYPE_EXTRA_LIVES_Toast"	"{s:player_name}, {d:int_value} seçti"
"[english]DOTA_HUD_REWARD_TYPE_EXTRA_LIVES_Toast"	"{s:player_name} chose {d:int_value}"
"DOTA_HUD_REWARD_TYPE_MINOR_ABILITY_UPGRADE_Toast"	"{s:player_name}, %s1 seçti"
"[english]DOTA_HUD_REWARD_TYPE_MINOR_ABILITY_UPGRADE_Toast"	"{s:player_name} chose %s1"
"DOTA_HUD_REWARD_TYPE_MINOR_STATS_UPGRADE_Toast"	"{s:player_name}, %s1 seçti"
"[english]DOTA_HUD_REWARD_TYPE_MINOR_STATS_UPGRADE_Toast"	"{s:player_name} chose %s1"
"DOTA_HUD_REWARD_TYPE_GOLD_Desc"	"Altın"
"[english]DOTA_HUD_REWARD_TYPE_GOLD_Desc"	"Gold"
"DOTA_HUD_REWARD_TYPE_TREASURE_Desc"	"Hazine Sandığı"
"[english]DOTA_HUD_REWARD_TYPE_TREASURE_Desc"	"Treasure Chest"
"DOTA_HUD_REWARD_TYPE_EXTRA_LIVES_Desc"	"Ekstra Can"
"[english]DOTA_HUD_REWARD_TYPE_EXTRA_LIVES_Desc"	"Extra Lives"
"DOTA_HUD_Claimed_Rewards_Header"	"Ödüller Alındı"
"[english]DOTA_HUD_Claimed_Rewards_Header"	"Claimed Rewards"
"DOTA_Hud_Tooltip_Outpost_Title"	"Mücadele"
"[english]DOTA_Hud_Tooltip_Outpost_Title"	"Combat"
"DOTA_Hud_Tooltip_Outpost_EliteTitle"	"Seçkin Mücadele"
"[english]DOTA_Hud_Tooltip_Outpost_EliteTitle"	"Elite Combat"
"DOTA_Hud_Tooltip_Outpost_TrapTitle"	"Tuzak"
"[english]DOTA_Hud_Tooltip_Outpost_TrapTitle"	"Trap"
"DOTA_Hud_Tooltip_Outpost_BossTitle"	"Bölüm Sonu Canavarı"
"[english]DOTA_Hud_Tooltip_Outpost_BossTitle"	"Boss"
"DOTA_Hud_Tooltip_Outpost_BonusTitle"	"Bonus"
"[english]DOTA_Hud_Tooltip_Outpost_BonusTitle"	"Bonus"
"DOTA_Hud_Tooltip_Outpost_TransitionTitle"	"Dinlenme"
"[english]DOTA_Hud_Tooltip_Outpost_TransitionTitle"	"Rest"
"DOTA_Hud_Outpost_ChannelBar_Title"	"MÜCADELE Seçiliyor"
"[english]DOTA_Hud_Outpost_ChannelBar_Title"	"Selecting COMBAT"
"DOTA_Hud_Outpost_ChannelBar_EliteTitle"	"<font color='#D02B29'>SEÇKİN</font> MÜCADELE Seçiliyor"
"[english]DOTA_Hud_Outpost_ChannelBar_EliteTitle"	"Selecting <font color='#D02B29'>ELITE</font> COMBAT"
"DOTA_Hud_Outpost_ChannelBar_TrapTitle"	"<font color='#FF7F37'>TUZAK</font> Seçiliyor"
"[english]DOTA_Hud_Outpost_ChannelBar_TrapTitle"	"Selecting <font color='#FF7F37'>TRAPS</font>"
"DOTA_Hud_Outpost_ChannelBar_BossTitle"	"<font color='#7266FF'>Bölüm Sonu Canavarı</font> Seçiliyor"
"[english]DOTA_Hud_Outpost_ChannelBar_BossTitle"	"Selecting <font color='#7266FF'>BOSS</font>"
"DOTA_Hud_Outpost_ChannelBar_BonusTitle"	"<font color='#f9cb4f'>BONUS</font> Seçiliyor"
"[english]DOTA_Hud_Outpost_ChannelBar_BonusTitle"	"Selecting <font color='#f9cb4f'>BONUS</font>"
"DOTA_Hud_Outpost_ChannelBar_RestTitle"	"<font color='#f9cb4f'>DİNLENME</font> Seçiliyor"
"[english]DOTA_Hud_Outpost_ChannelBar_RestTitle"	"Selecting <font color='#f9cb4f'>REST</font>"
"defeat_all_enemies"	"Tüm düşmanları yok et"
"[english]defeat_all_enemies"	"Defeat all enemies"
"survive_waves"	"Düşmanların saldırı dalgalarında hayatta kal"
"[english]survive_waves"	"Survive enemy waves"
"destroy_spawning_portals"	"Karanlık Geçitleri Yok Et"
"[english]destroy_spawning_portals"	"Destroy the Dark Portals"
"navigate_the_traps"	"Tuzaklardan Kurtul Ve Hedefe Ulaş"
"[english]navigate_the_traps"	"Navigate the Traps and Reach the Goal"
"kill_scarab_priests"	"Bok Böceği Rahiplerini Yen"
"[english]kill_scarab_priests"	"Defeat the Scarab Priests"
"defeat_the_alchemists"	"Alchemist'leri Yen"
"[english]defeat_the_alchemists"	"Defeat the Alchemists"
"defeat_boss_npc_dota_boss_void_spirit"	"Inai'nin Gölgesi'ni Yen"
"[english]defeat_boss_npc_dota_boss_void_spirit"	"Defeat the Shadow of Inai"
"defeat_boss_npc_dota_creature_temple_guardian"	"Tapınak Koruyucuları'nı Yen"
"[english]defeat_boss_npc_dota_creature_temple_guardian"	"Defeat the Temple Guardians"
"defeat_boss_npc_dota_creature_storegga"	"Storegga'yı Yen"
"[english]defeat_boss_npc_dota_creature_storegga"	"Defeat Storegga"
"defeat_boss_npc_dota_boss_aghanim"	"Aghanim'i Yen"
"[english]defeat_boss_npc_dota_boss_aghanim"	"Defeat Aghanim"
"defeat_boss_npc_dota_boss_visage"	"Dar Labirentin Koruyucusu'nu Yen"
"[english]defeat_boss_npc_dota_boss_visage"	"Defeat Warden of the Narrow Maze"
"defeat_boss_npc_dota_boss_timbersaw"	"Testerejilet Rizzrick'i Yen"
"[english]defeat_boss_npc_dota_boss_timbersaw"	"Defeat Rizzrick the Razorsaw"
"kill_waveblasters"	"Patlayıcı Yarasaları Yen"
"[english]kill_waveblasters"	"Defeat the Blaster Bats"
"kill_wildwings"	"Kızgın Kuşları Yen"
"[english]kill_wildwings"	"Defeat the Angry Birds"
"kill_tinies"	"Arkadaşlığı Boz"
"[english]kill_tinies"	"Destroy Friendships"
"defeat_shadow_demons"	"Shadow Demon'ları Yen"
"[english]defeat_shadow_demons"	"Defeat the Shadow Demons"
"rescue_sheep"	"Kuzuları Kurtar"
"[english]rescue_sheep"	"Rescue the Sheep"
"save_gary"	"Gary'i Koru"
"[english]save_gary"	"Protect Gary"
"destroy_all_mines"	"Sualtı Mayınlarını Yok Et"
"[english]destroy_all_mines"	"Destroy the Underwater Mines"
"defeat_shadow_shamans"	"Bataklık Şamanları'nı Yen"
"[english]defeat_shadow_shamans"	"Defeat the Bog Shacklers"
"kill_shroom_giants"	"Dev Mantarları Yen"
"[english]kill_shroom_giants"	"Defeat the Shroom Giants"
"objective_select_ascension_level"	"Yükseliş Seviyesi Seçin"
"[english]objective_select_ascension_level"	"Select Ascension Level"
"objective_stand_on_buttons"	"Başlangıç Butonlarının Üzerinde Durun"
"[english]objective_stand_on_buttons"	"Stand On Starting Buttons"
"objective_select_aghanims_fragmants"	"Aghanim Scepter Parçalarını Seçin"
"[english]objective_select_aghanims_fragmants"	"Select Aghanim Scepter Shards"
"objective_saddle_up_on_morty"	"Mortimus'a Bin"
"[english]objective_saddle_up_on_morty"	"Saddle Up On Mortimus"
"objective_jump_to_collect_gold"	"Altın Toplamak İçin Zıpla!"
"[english]objective_jump_to_collect_gold"	"Jump To Collect Gold!"
"objective_saddle_up_on_penguin"	"Penguenlere Bin"
"[english]objective_saddle_up_on_penguin"	"Saddle Up On a Peng-Wing"
"objective_sled_to_collect_gold"	"Altın Toplamak İçin Kay!"
"[english]objective_sled_to_collect_gold"	"Sled To Collect Gold!"
"defeat_blazhan"	"Ateşhan'ı Yen"
"[english]defeat_blazhan"	"Defeat Blazhan"
"defeat_frozhan"	"Buzhan'ı Yen"
"[english]defeat_frozhan"	"Defeat Frozhan"
"defeat_portly"	"Cüsseliyi Yen"
"[english]defeat_portly"	"Defeat Portly"
"hint_ride_morty"	"Binmek için {s:keybind} veya {s:alternate_keybind} tuşuna bas!"
"[english]hint_ride_morty"	"{s:keybind} or {s:alternate_keybind} to Saddle Up!"
"hint_hop_with_morty"	"Kertenkelenle nişan al, güç kazanmak için {s:keybind} tuşuna bas ve zıplamak için yeniden bas!"
"[english]hint_hop_with_morty"	"Aim your lizard, then press {s:keybind} to gain power, and again to jump!"
"hint_ride_penguin"	"Binmek için {s:keybind} veya {s:alternate_keybind} tuşuna bas!"
"[english]hint_ride_penguin"	"{s:keybind} or {s:alternate_keybind} to Saddle Up!"
"DOTA_Tooltip_modifier_aghsfort_firefly_burn"	"Piroman"
"[english]DOTA_Tooltip_modifier_aghsfort_firefly_burn"	"Pyromaniac"
"DOTA_Tooltip_modifier_aghsfort_firefly_burn_Description"	"Yanıyorsun."
"[english]DOTA_Tooltip_modifier_aghsfort_firefly_burn_Description"	"You are on fire."
"DOTA_Tooltip_modifier_item_evasion_potion_Description"	"Bu birim fazladan 100 savuşturmaya sahiptir."
"[english]DOTA_Tooltip_modifier_item_evasion_potion_Description"	"This unit has 100 bonus evasion."
"DOTA_Tooltip_ability_item_dragon_potion_bonus_attack_damage"	"FAZLADAN HASAR:"
"[english]DOTA_Tooltip_ability_item_dragon_potion_bonus_attack_damage"	"BONUS DAMAGE:"
"DOTA_Tooltip_Ability_item_aghsfort_refresher_shard_Description"	"<h1>Kullan: Dolum Sürelerini Sıfırla</h1>Kullananın bütün yeteneklerinin ve eşyalarının dolum süresini sıfırlar."
"[english]DOTA_Tooltip_Ability_item_aghsfort_refresher_shard_Description"	"<h1>Use: Reset Cooldowns</h1>Resets the cooldowns of all your items and abilities."
"DOTA_Tooltip_ability_item_bogduggs_cudgel_bonus_damage"	"FAZLADAN HASAR:"
"[english]DOTA_Tooltip_ability_item_bogduggs_cudgel_bonus_damage"	"BONUS DAMAGE:"
"DOTA_Tooltip_ability_item_bogduggs_lucky_femur_mana_regen_sec"	"FAZLADAN MANA YENİLEMESİ:"
"[english]DOTA_Tooltip_ability_item_bogduggs_lucky_femur_mana_regen_sec"	"BONUS MANA REGEN:"
"DOTA_Tooltip_ability_item_rhyziks_eye_mana_regen_sec"	"FAZLADAN MANA YENİLEMESİ:"
"[english]DOTA_Tooltip_ability_item_rhyziks_eye_mana_regen_sec"	"BONUS MANA REGEN:"
"DOTA_Tooltip_ability_item_carapace_of_qaldin_bonus_mana"	"FAZLADAN MANA:"
"[english]DOTA_Tooltip_ability_item_carapace_of_qaldin_bonus_mana"	"BONUS MANA:"
"DOTA_Tooltip_ability_item_the_caustic_finale_bonus_damage"	"FAZLADAN HASAR:"
"[english]DOTA_Tooltip_ability_item_the_caustic_finale_bonus_damage"	"BONUS DAMAGE:"
"DOTA_Tooltip_ability_item_ice_dragon_maw_bonus_damage"	"FAZLADAN HASAR:"
"[english]DOTA_Tooltip_ability_item_ice_dragon_maw_bonus_damage"	"BONUS DAMAGE:"
"DOTA_Tooltip_modifier_item_bear_cloak_effect_Description"	"Bu birim fazladan büyü direncine sahiptir."
"[english]DOTA_Tooltip_modifier_item_bear_cloak_effect_Description"	"This unit has bonus magic resistance."
"DOTA_Subshop_npc_dota_hero_disruptor"	"Disruptor"
"[english]DOTA_Subshop_npc_dota_hero_disruptor"	"Disruptor"
"DOTA_Subshop_npc_dota_hero_magnataur"	"Magnus"
"[english]DOTA_Subshop_npc_dota_hero_magnataur"	"Magnus"
"DOTA_Subshop_npc_dota_hero_mars"	"Mars"
"[english]DOTA_Subshop_npc_dota_hero_mars"	"Mars"
"DOTA_Subshop_npc_dota_hero_omniknight"	"Omniknight"
"[english]DOTA_Subshop_npc_dota_hero_omniknight"	"Omniknight"
"DOTA_Subshop_npc_dota_hero_queenofpain"	"Queen of Pain"
"[english]DOTA_Subshop_npc_dota_hero_queenofpain"	"Queen of Pain"
"DOTA_Subshop_npc_dota_hero_slark"	"Slark"
"[english]DOTA_Subshop_npc_dota_hero_slark"	"Slark"
"DOTA_Subshop_npc_dota_hero_snapfire"	"Snapfire"
"[english]DOTA_Subshop_npc_dota_hero_snapfire"	"Snapfire"
"DOTA_Subshop_npc_dota_hero_sniper"	"Sniper"
"[english]DOTA_Subshop_npc_dota_hero_sniper"	"Sniper"
"DOTA_Subshop_npc_dota_hero_templar_assassin"	"Templar Assassin"
"[english]DOTA_Subshop_npc_dota_hero_templar_assassin"	"Templar Assassin"
"DOTA_Subshop_npc_dota_hero_tusk"	"Tusk"
"[english]DOTA_Subshop_npc_dota_hero_tusk"	"Tusk"
"DOTA_Subshop_npc_dota_hero_ursa"	"Ursa"
"[english]DOTA_Subshop_npc_dota_hero_ursa"	"Ursa"
"DOTA_Subshop_npc_dota_hero_viper"	"Viper"
"[english]DOTA_Subshop_npc_dota_hero_viper"	"Viper"
"DOTA_Subshop_npc_dota_hero_weaver"	"Weaver"
"[english]DOTA_Subshop_npc_dota_hero_weaver"	"Weaver"
"DOTA_Subshop_npc_dota_hero_winter_wyvern"	"Winter Wyvern"
"[english]DOTA_Subshop_npc_dota_hero_winter_wyvern"	"Winter Wyvern"
"DOTA_Subshop_npc_dota_hero_witch_doctor"	"Witch Doctor"
"[english]DOTA_Subshop_npc_dota_hero_witch_doctor"	"Witch Doctor"
"DOTA_Tooltip_Ability_item_aghsfort_queenofpain_shadow_strike_strike_damage_Description"	"<h1>Yaygın Scepter Parçası</h1>Shadow Strike'ın Strike hasarını %value% artırır."
"[english]DOTA_Tooltip_Ability_item_aghsfort_queenofpain_shadow_strike_strike_damage_Description"	"<h1>Common Scepter Fragment</h1>Increases Shadow Strike Strike Damage by %value%."
"DOTA_Tooltip_Ability_item_aghsfort_queenofpain_shadow_strike_dot_damage"	"Shadow Strike: Tik Hasarı"
"[english]DOTA_Tooltip_Ability_item_aghsfort_queenofpain_shadow_strike_dot_damage"	"Shadow Strike: Tick Damage"
"DOTA_Tooltip_Ability_item_aghsfort_queenofpain_shadow_strike_dot_damage_Description"	"<h1>Yaygın Scepter Parçası</h1>Shadow Strike'ın tik hasarını %value% artırır."
"[english]DOTA_Tooltip_Ability_item_aghsfort_queenofpain_shadow_strike_dot_damage_Description"	"<h1>Common Scepter Fragment</h1>Increases Shadow Strike Tick Damage by %value%."
"DOTA_Tooltip_Ability_item_aghsfort_queenofpain_blink_percent_cooldown"	"Blink: Dolum Süresi"
"[english]DOTA_Tooltip_Ability_item_aghsfort_queenofpain_blink_percent_cooldown"	"Blink: Cooldown"
"DOTA_Tooltip_Ability_item_aghsfort_queenofpain_blink_percent_cooldown_Description"	"<h1>Yaygın Scepter Parçası</h1>Blink'in dolum süresini %%value% azaltır."
"[english]DOTA_Tooltip_Ability_item_aghsfort_queenofpain_blink_percent_cooldown_Description"	"<h1>Common Scepter Fragment</h1>Decreases Blink Cooldown by %value%%."
"DOTA_Tooltip_Ability_item_aghsfort_queenofpain_blink_range"	"Blink: Menzil"
"[english]DOTA_Tooltip_Ability_item_aghsfort_queenofpain_blink_range"	"Blink: Range"
"DOTA_Tooltip_Ability_item_aghsfort_queenofpain_blink_range_Description"	"<h1>Yaygın Scepter Parçası</h1>Blink'in menzilini %value% artırır."
"[english]DOTA_Tooltip_Ability_item_aghsfort_queenofpain_blink_range_Description"	"<h1>Common Scepter Fragment</h1>Increases Blink Range by %value%."
"DOTA_Tooltip_Ability_item_aghsfort_queenofpain_scream_of_pain_damage"	"Scream of Pain: Hasar"
"[english]DOTA_Tooltip_Ability_item_aghsfort_queenofpain_scream_of_pain_damage"	"Scream of Pain: Damage"
"DOTA_Tooltip_Ability_item_aghsfort_queenofpain_scream_of_pain_damage_Description"	"<h1>Yaygın Scepter Parçası</h1>Scream of Pain'in hasarını %value% artırır."
"[english]DOTA_Tooltip_Ability_item_aghsfort_queenofpain_scream_of_pain_damage_Description"	"<h1>Common Scepter Fragment</h1>Increases Scream of Pain Damage by %value%."
"DOTA_Tooltip_Ability_item_aghsfort_queenofpain_scream_of_pain_radius"	"Scream of Pain: Yarıçap"
"[english]DOTA_Tooltip_Ability_item_aghsfort_queenofpain_scream_of_pain_radius"	"Scream of Pain: Radius"
"DOTA_Tooltip_Ability_item_aghsfort_queenofpain_scream_of_pain_radius_Description"	"<h1>Yaygın Scepter Parçası</h1>Scream of Pain'in yarıçapını %value% artırır."
"[english]DOTA_Tooltip_Ability_item_aghsfort_queenofpain_scream_of_pain_radius_Description"	"<h1>Common Scepter Fragment</h1>Increases Scream of Pain Radius by %value%."
"DOTA_Tooltip_Ability_item_aghsfort_queenofpain_sonic_wave_percent_cooldown"	"Sonic Wave: Dolum Süresi"
"[english]DOTA_Tooltip_Ability_item_aghsfort_queenofpain_sonic_wave_percent_cooldown"	"Sonic Wave: Cooldown"
"DOTA_Tooltip_Ability_item_aghsfort_queenofpain_sonic_wave_percent_cooldown_Description"	"<h1>Yaygın Scepter Parçası</h1>Sonic Wave'in dolum süresini %%value% azaltır."
"[english]DOTA_Tooltip_Ability_item_aghsfort_queenofpain_sonic_wave_percent_cooldown_Description"	"<h1>Common Scepter Fragment</h1>Decreases Sonic Wave Cooldown by %value%%."
"DOTA_Tooltip_Ability_item_aghsfort_queenofpain_sonic_wave_damage"	"Sonic Wave: Hasar"
"[english]DOTA_Tooltip_Ability_item_aghsfort_queenofpain_sonic_wave_damage"	"Sonic Wave: Damage"
"DOTA_Tooltip_Ability_item_aghsfort_queenofpain_sonic_wave_damage_Description"	"<h1>Yaygın Scepter Parçası</h1>Sonic Wave'in hasarını %value% artırır."
"[english]DOTA_Tooltip_Ability_item_aghsfort_queenofpain_sonic_wave_damage_Description"	"<h1>Common Scepter Fragment</h1>Increases Sonic Wave Damage by %value%."
"DOTA_Tooltip_Ability_item_aghsfort_slark_dark_pact_cooldown"	"Dark Pact: Dolum Süresi"
"[english]DOTA_Tooltip_Ability_item_aghsfort_slark_dark_pact_cooldown"	"Dark Pact: Cooldown"
"DOTA_Tooltip_Ability_item_aghsfort_slark_dark_pact_cooldown_Description"	"<h1>Yaygın Scepter Parçası</h1>Dark Pact'in dolum süresini %%value% azaltır."
"[english]DOTA_Tooltip_Ability_item_aghsfort_slark_dark_pact_cooldown_Description"	"<h1>Common Scepter Fragment</h1>Decreases Dark Pact Cooldown by %value%%."
"DOTA_Tooltip_Ability_item_aghsfort_slark_dark_pact_total_damage"	"Dark Pact: Hasar"
"[english]DOTA_Tooltip_Ability_item_aghsfort_slark_dark_pact_total_damage"	"Dark Pact: Damage"
"DOTA_Tooltip_Ability_item_aghsfort_slark_dark_pact_total_damage_Description"	"<h1>Yaygın Scepter Parçası</h1>Dark Pact'in hasarını %value% artırır."
"[english]DOTA_Tooltip_Ability_item_aghsfort_slark_dark_pact_total_damage_Description"	"<h1>Common Scepter Fragment</h1>Increases Dark Pact Damage by %value%."
"DOTA_Tooltip_Ability_item_aghsfort_slark_pounce_distance"	"Pounce: Mesafe"
"[english]DOTA_Tooltip_Ability_item_aghsfort_slark_pounce_distance"	"Pounce: Distance"
"DOTA_Tooltip_Ability_item_aghsfort_slark_pounce_distance_Description"	"<h1>Yaygın Scepter Parçası</h1>Pounce'ın mesafesini %value% artırır."
"[english]DOTA_Tooltip_Ability_item_aghsfort_slark_pounce_distance_Description"	"<h1>Common Scepter Fragment</h1>Increases Pounce Distance by %value%."
"DOTA_Tooltip_Ability_item_aghsfort_slark_pounce_damage"	"Pounce: Hasar"
"[english]DOTA_Tooltip_Ability_item_aghsfort_slark_pounce_damage"	"Pounce: Damage"
"DOTA_Tooltip_Ability_item_aghsfort_slark_pounce_damage_Description"	"<h1>Yaygın Scepter Parçası</h1>Pounce'ın hasarını %value% artırır."
"[english]DOTA_Tooltip_Ability_item_aghsfort_slark_pounce_damage_Description"	"<h1>Common Scepter Fragment</h1>Increases Pounce Damage by %value%."
"DOTA_Tooltip_Ability_item_aghsfort_slark_essence_shift_agi_gain"	"Essence Shift: Etkin Çeviklik Kazanımı"
"[english]DOTA_Tooltip_Ability_item_aghsfort_slark_essence_shift_agi_gain"	"Essence Shift: Active Agility Gain"
"DOTA_Tooltip_Ability_item_aghsfort_slark_essence_shift_agi_gain_Description"	"<h1>Yaygın Scepter Parçası</h1>Essence Shift'in etkin çeviklik kazanımını %value% artırır."
"[english]DOTA_Tooltip_Ability_item_aghsfort_slark_essence_shift_agi_gain_Description"	"<h1>Common Scepter Fragment</h1>Increases Essence Shift Active Agility Gain by %value%."
"DOTA_Tooltip_Ability_item_aghsfort_slark_essence_shift_max_stacks"	"Essence Shift: Maks. İstif"
"[english]DOTA_Tooltip_Ability_item_aghsfort_slark_essence_shift_max_stacks"	"Essence Shift: Max Stacks"
"DOTA_Tooltip_Ability_item_aghsfort_slark_essence_shift_max_stacks_Description"	"<h1>Yaygın Scepter Parçası</h1>Essence Shift'in maksimum istifini %value% artırır."
"[english]DOTA_Tooltip_Ability_item_aghsfort_slark_essence_shift_max_stacks_Description"	"<h1>Common Scepter Fragment</h1>Increases Essence Shift Max Stacks by %value%."
"DOTA_Tooltip_Ability_item_aghsfort_slark_shadow_dance_duration"	"Shadow Dance: Süre"
"[english]DOTA_Tooltip_Ability_item_aghsfort_slark_shadow_dance_duration"	"Shadow Dance: Duration"
"DOTA_Tooltip_Ability_item_aghsfort_slark_shadow_dance_duration_Description"	"<h1>Yaygın Scepter Parçası</h1>Shadow Dance'in süresini %value% artırır."
"[english]DOTA_Tooltip_Ability_item_aghsfort_slark_shadow_dance_duration_Description"	"<h1>Common Scepter Fragment</h1>Increases Shadow Dance Duration by %value%."
"DOTA_Tooltip_Ability_item_aghsfort_slark_shadow_dance_bonus_bonus_regen_pct"	"Shadow Dance: Yenilenme Yüzdesi"
"[english]DOTA_Tooltip_Ability_item_aghsfort_slark_shadow_dance_bonus_bonus_regen_pct"	"Shadow Dance: Regen Percent"
"DOTA_Tooltip_Ability_item_aghsfort_slark_shadow_dance_bonus_bonus_regen_pct_Description"	"<h1>Yaygın Scepter Parçası</h1>Shadow Dance'in yenilenme yüzdesini %value% artırır."
"[english]DOTA_Tooltip_Ability_item_aghsfort_slark_shadow_dance_bonus_bonus_regen_pct_Description"	"<h1>Common Scepter Fragment</h1>Increases Shadow Dance Regen Percent by %value%."
"DOTA_Tooltip_Ability_item_aghsfort_snapfire_scatterblast_flat_damage"	"Scatterblast: Hasar"
"[english]DOTA_Tooltip_Ability_item_aghsfort_snapfire_scatterblast_flat_damage"	"Scatterblast: Damage"
"DOTA_Tooltip_Ability_item_aghsfort_snapfire_scatterblast_flat_damage_Description"	"<h1>Yaygın Scepter Parçası</h1>Scatterblast'ın hasarını %value% artırır."
"[english]DOTA_Tooltip_Ability_item_aghsfort_snapfire_scatterblast_flat_damage_Description"	"<h1>Common Scepter Fragment</h1>Increases Scatterblast Damage by %value%."
"DOTA_Tooltip_Ability_item_aghsfort_snapfire_scatterblast_pct_cooldown"	"Scatterblast: Dolum Süresi"
"[english]DOTA_Tooltip_Ability_item_aghsfort_snapfire_scatterblast_pct_cooldown"	"Scatterblast: Cooldown"
"DOTA_Tooltip_Ability_item_aghsfort_snapfire_scatterblast_pct_cooldown_Description"	"<h1>Yaygın Scepter Parçası</h1>Scatterblast'ın dolum süresini %%value% azaltır."
"[english]DOTA_Tooltip_Ability_item_aghsfort_snapfire_scatterblast_pct_cooldown_Description"	"<h1>Common Scepter Fragment</h1>Decreases Scatterblast Cooldown by %value%%."
"DOTA_Tooltip_Ability_item_aghsfort_snapfire_firesnap_cookie_flat_impact_damage"	"Firesnap Cookie: Hasar"
"[english]DOTA_Tooltip_Ability_item_aghsfort_snapfire_firesnap_cookie_flat_impact_damage"	"Firesnap Cookie: Damage"
"DOTA_Tooltip_Ability_item_aghsfort_snapfire_firesnap_cookie_flat_impact_damage_Description"	"<h1>Yaygın Scepter Parçası</h1>Firesnap Cookie'nin hasarını %value% artırır."
"[english]DOTA_Tooltip_Ability_item_aghsfort_snapfire_firesnap_cookie_flat_impact_damage_Description"	"<h1>Common Scepter Fragment</h1>Increases Firesnap Cookie Damage by %value%."
"DOTA_Tooltip_Ability_item_aghsfort_snapfire_firesnap_cookie_flat_stun_duration"	"Firesnap Cookie: Sersemletme Süresi"
"[english]DOTA_Tooltip_Ability_item_aghsfort_snapfire_firesnap_cookie_flat_stun_duration"	"Firesnap Cookie: Stun Duration"
"DOTA_Tooltip_Ability_item_aghsfort_snapfire_firesnap_cookie_flat_stun_duration_Description"	"<h1>Yaygın Scepter Parçası</h1>Firesnap Cookie'nin sersemletme süresini %value% artırır."
"[english]DOTA_Tooltip_Ability_item_aghsfort_snapfire_firesnap_cookie_flat_stun_duration_Description"	"<h1>Common Scepter Fragment</h1>Increases Firesnap Cookie Stun Duration by %value%."
"DOTA_Tooltip_Ability_item_aghsfort_snapfire_lil_shredder_flat_damage"	"Lil' Shredder: Hasar"
"[english]DOTA_Tooltip_Ability_item_aghsfort_snapfire_lil_shredder_flat_damage"	"Lil' Shredder: Damage"
"DOTA_Tooltip_Ability_item_aghsfort_snapfire_lil_shredder_flat_damage_Description"	"<h1>Yaygın Scepter Parçası</h1>Lil' Shredder'ın hasarını %value% artırır."
"[english]DOTA_Tooltip_Ability_item_aghsfort_snapfire_lil_shredder_flat_damage_Description"	"<h1>Common Scepter Fragment</h1>Increases Lil' Shredder Damage by %value%."
"DOTA_Tooltip_Ability_item_aghsfort_snapfire_lil_shredder_flat_attacks"	"Lil' Shredder: Saldırı"
"[english]DOTA_Tooltip_Ability_item_aghsfort_snapfire_lil_shredder_flat_attacks"	"Lil' Shredder: Attacks"
"DOTA_Tooltip_Ability_item_aghsfort_snapfire_lil_shredder_flat_attacks_Description"	"<h1>Yaygın Scepter Parçası</h1>Lil' Shredder'ın saldırılarını %value% artırır."
"[english]DOTA_Tooltip_Ability_item_aghsfort_snapfire_lil_shredder_flat_attacks_Description"	"<h1>Common Scepter Fragment</h1>Increases Lil' Shredder Attacks by %value%."
"DOTA_Tooltip_Ability_item_aghsfort_snapfire_mortimer_kisses_flat_projectile_count"	"Mortimer Kisses: Atış Sayısı"
"[english]DOTA_Tooltip_Ability_item_aghsfort_snapfire_mortimer_kisses_flat_projectile_count"	"Mortimer Kisses: Projectile Count"
"DOTA_Tooltip_Ability_item_aghsfort_snapfire_mortimer_kisses_flat_projectile_count_Description"	"<h1>Yaygın Scepter Parçası</h1>Mortimer Kisses'ın atış sayısını %value% artırır."
"[english]DOTA_Tooltip_Ability_item_aghsfort_snapfire_mortimer_kisses_flat_projectile_count_Description"	"<h1>Common Scepter Fragment</h1>Increases Mortimer Kisses Projectile Count by %value%."
"DOTA_Tooltip_Ability_item_aghsfort_snapfire_mortimer_kisses_flat_burn_damage"	"Mortimer Kisses: Yakma Hasarı"
"[english]DOTA_Tooltip_Ability_item_aghsfort_snapfire_mortimer_kisses_flat_burn_damage"	"Mortimer Kisses: Burn Damage"
"DOTA_Tooltip_Ability_item_aghsfort_snapfire_mortimer_kisses_flat_burn_damage_Description"	"<h1>Yaygın Scepter Parçası</h1>Mortimer Kisses'ın yakma hasarını %value% artırır."
"[english]DOTA_Tooltip_Ability_item_aghsfort_snapfire_mortimer_kisses_flat_burn_damage_Description"	"<h1>Common Scepter Fragment</h1>Increases Mortimer Kisses Burn Damage by %value%."
"DOTA_Tooltip_Ability_item_aghsfort_sniper_shrapnel_flat_damage"	"Shrapnel: Hasar"
"[english]DOTA_Tooltip_Ability_item_aghsfort_sniper_shrapnel_flat_damage"	"Shrapnel: Damage"
"DOTA_Tooltip_Ability_item_aghsfort_sniper_shrapnel_flat_damage_Description"	"<h1>Yaygın Scepter Parçası</h1>Shrapnel'in hasarını %value% artırır."
"[english]DOTA_Tooltip_Ability_item_aghsfort_sniper_shrapnel_flat_damage_Description"	"<h1>Common Scepter Fragment</h1>Increases Shrapnel Damage by %value%."
"DOTA_Tooltip_Ability_item_aghsfort_sniper_shrapnel_flat_radius"	"Shrapnel: Yarıçap"
"[english]DOTA_Tooltip_Ability_item_aghsfort_sniper_shrapnel_flat_radius"	"Shrapnel: Radius"
"DOTA_Tooltip_Ability_item_aghsfort_sniper_shrapnel_flat_radius_Description"	"<h1>Yaygın Scepter Parçası</h1>Shrapnel'in yarıçapını %value% artırır."
"[english]DOTA_Tooltip_Ability_item_aghsfort_sniper_shrapnel_flat_radius_Description"	"<h1>Common Scepter Fragment</h1>Increases Shrapnel Radius by %value%."
"DOTA_Tooltip_Ability_item_aghsfort_sniper_shrapnel_duration"	"Shrapnel: Süre"
"[english]DOTA_Tooltip_Ability_item_aghsfort_sniper_shrapnel_duration"	"Shrapnel: Duration"
"DOTA_Tooltip_Ability_item_aghsfort_sniper_shrapnel_duration_Description"	"<h1>Yaygın Scepter Parçası</h1>Shrapnel'in süresini %value% artırır."
"[english]DOTA_Tooltip_Ability_item_aghsfort_sniper_shrapnel_duration_Description"	"<h1>Common Scepter Fragment</h1>Increases Shrapnel Duration by %value%."
"DOTA_Tooltip_Ability_item_aghsfort_sniper_headshot_flat_damage"	"Headshot: Hasar"
"[english]DOTA_Tooltip_Ability_item_aghsfort_sniper_headshot_flat_damage"	"Headshot: Damage"
"DOTA_Tooltip_Ability_item_aghsfort_sniper_headshot_flat_damage_Description"	"<h1>Yaygın Scepter Parçası</h1>Headshot'ın hasarını %value% artırır."
"[english]DOTA_Tooltip_Ability_item_aghsfort_sniper_headshot_flat_damage_Description"	"<h1>Common Scepter Fragment</h1>Increases Headshot Damage by %value%."
"DOTA_Tooltip_Ability_item_aghsfort_sniper_headshot_proc_chance"	"Headshot: Etkinleşme Şansı"
"[english]DOTA_Tooltip_Ability_item_aghsfort_sniper_headshot_proc_chance"	"Headshot: Proc Chance"
"DOTA_Tooltip_Ability_item_aghsfort_sniper_headshot_proc_chance_Description"	"<h1>Yaygın Scepter Parçası</h1>Headshot'ın etkinleşme şansı %value% artırıldı."
"[english]DOTA_Tooltip_Ability_item_aghsfort_sniper_headshot_proc_chance_Description"	"<h1>Common Scepter Fragment</h1>Increases Headshot Proc Chance by %value%."
"DOTA_Tooltip_Ability_item_aghsfort_sniper_take_aim_flat_bonus_attack_range"	"Take Aim: Fazladan Saldırı Menzili"
"[english]DOTA_Tooltip_Ability_item_aghsfort_sniper_take_aim_flat_bonus_attack_range"	"Take Aim: Bonus Attack Range"
"DOTA_Tooltip_Ability_item_aghsfort_sniper_take_aim_flat_bonus_attack_range_Description"	"<h1>Yaygın Scepter Parçası</h1>Take Aim'in menzilini %value% artırır."
"[english]DOTA_Tooltip_Ability_item_aghsfort_sniper_take_aim_flat_bonus_attack_range_Description"	"<h1>Common Scepter Fragment</h1>Increases Take Aim Bonus Range by %value%."
"DOTA_Tooltip_Ability_item_aghsfort_sniper_assassinate_flat_damage"	"Assassinate: Hasar"
"[english]DOTA_Tooltip_Ability_item_aghsfort_sniper_assassinate_flat_damage"	"Assassinate: Damage"
"DOTA_Tooltip_Ability_item_aghsfort_sniper_assassinate_flat_damage_Description"	"<h1>Yaygın Scepter Parçası</h1>Assassinate'in hasarını %value% artırır."
"[english]DOTA_Tooltip_Ability_item_aghsfort_sniper_assassinate_flat_damage_Description"	"<h1>Common Scepter Fragment</h1>Increases Assassinate Damage by %value%."
"DOTA_Tooltip_Ability_item_aghsfort_sniper_assassinate_percent_cast_point"	"Assassinate: Nişan Süresi"
"[english]DOTA_Tooltip_Ability_item_aghsfort_sniper_assassinate_percent_cast_point"	"Assassinate: Aim Duration"
"DOTA_Tooltip_Ability_item_aghsfort_sniper_assassinate_percent_cast_point_Description"	"<h1>Yaygın Scepter Parçası</h1>Assassinate'in hedefleme süresini %%value% azaltır."
"[english]DOTA_Tooltip_Ability_item_aghsfort_sniper_assassinate_percent_cast_point_Description"	"<h1>Common Scepter Fragment</h1>Decreases Assassinate Aim Duration by %value%%."
"DOTA_Tooltip_Ability_item_aghsfort_templar_assassin_refraction_instances"	"Refraction: Örnek"
"[english]DOTA_Tooltip_Ability_item_aghsfort_templar_assassin_refraction_instances"	"Refraction: Instances"
"DOTA_Tooltip_Ability_item_aghsfort_templar_assassin_refraction_instances_Description"	"<h1>Yaygın Scepter Parçası</h1>Refraction'ın örneklerini %value% artırır."
"[english]DOTA_Tooltip_Ability_item_aghsfort_templar_assassin_refraction_instances_Description"	"<h1>Common Scepter Fragment</h1>Increases Refraction Instances by %value%."
"DOTA_Tooltip_Ability_item_aghsfort_templar_assassin_refraction_bonus_damage"	"Refraction: Fazladan Hasar"
"[english]DOTA_Tooltip_Ability_item_aghsfort_templar_assassin_refraction_bonus_damage"	"Refraction: Bonus Damage"
"DOTA_Tooltip_Ability_item_aghsfort_templar_assassin_refraction_bonus_damage_Description"	"<h1>Yaygın Scepter Parçası</h1>Refraction'ın fazladan hasarını %value% artırır."
"[english]DOTA_Tooltip_Ability_item_aghsfort_templar_assassin_refraction_bonus_damage_Description"	"<h1>Common Scepter Fragment</h1>Increases Refraction Bonus Damage by %value%."
"DOTA_Tooltip_Ability_item_aghsfort_templar_assassin_meld_bonus_damage"	"Meld: Fazladan Hasar"
"[english]DOTA_Tooltip_Ability_item_aghsfort_templar_assassin_meld_bonus_damage"	"Meld: Bonus Damage"
"DOTA_Tooltip_Ability_item_aghsfort_templar_assassin_meld_bonus_damage_Description"	"<h1>Yaygın Scepter Parçası</h1>Meld'in fazladan hasarını %value% artırır."
"[english]DOTA_Tooltip_Ability_item_aghsfort_templar_assassin_meld_bonus_damage_Description"	"<h1>Common Scepter Fragment</h1>Increases Meld Bonus Damage by %value%."
"DOTA_Tooltip_Ability_item_aghsfort_templar_assassin_meld_bonus_armor"	"Meld: Zırh Azaltma"
"[english]DOTA_Tooltip_Ability_item_aghsfort_templar_assassin_meld_bonus_armor"	"Meld: Armor Reduction"
"DOTA_Tooltip_Ability_item_aghsfort_templar_assassin_meld_bonus_armor_Description"	"<h1>Yaygın Scepter Parçası</h1>Meld'in zırh azaltmasını %value% artırır."
"[english]DOTA_Tooltip_Ability_item_aghsfort_templar_assassin_meld_bonus_armor_Description"	"<h1>Common Scepter Fragment</h1>Increases Meld Armor Reduction by %value%."
"DOTA_Tooltip_Ability_item_aghsfort_templar_assassin_psi_blades_bonus_attack_range"	"Psi Blades: Fazladan Saldırı Menzili"
"[english]DOTA_Tooltip_Ability_item_aghsfort_templar_assassin_psi_blades_bonus_attack_range"	"Psi Blades: Bonus Attack Range"
"DOTA_Tooltip_Ability_item_aghsfort_templar_assassin_psi_blades_bonus_attack_range_Description"	"<h1>Yaygın Scepter Parçası</h1>Psi Blades'in fazladan saldırı menzilini %value% artırır."
"[english]DOTA_Tooltip_Ability_item_aghsfort_templar_assassin_psi_blades_bonus_attack_range_Description"	"<h1>Common Scepter Fragment</h1>Increases Psi Blades Bonus Attack Range by %value%."
"DOTA_Tooltip_Ability_item_aghsfort_templar_assassin_psionic_trap_max_traps"	"Psionic Trap: Maks. Tuzak"
"[english]DOTA_Tooltip_Ability_item_aghsfort_templar_assassin_psionic_trap_max_traps"	"Psionic Trap: Max Traps"
"DOTA_Tooltip_Ability_item_aghsfort_templar_assassin_psionic_trap_max_traps_Description"	"<h1>Yaygın Scepter Parçası</h1>Psionic Trap'in maksimum tuzak sayısını %value% artırır."
"[english]DOTA_Tooltip_Ability_item_aghsfort_templar_assassin_psionic_trap_max_traps_Description"	"<h1>Common Scepter Fragment</h1>Increases Psionic Trap Max Traps by %value%."
"DOTA_Tooltip_Ability_item_aghsfort_templar_assassin_psionic_trap_trap_damage"	"Psionic Trap: Tuzak Hasarı"
"[english]DOTA_Tooltip_Ability_item_aghsfort_templar_assassin_psionic_trap_trap_damage"	"Psionic Trap: Trap Damage"
"DOTA_Tooltip_Ability_item_aghsfort_templar_assassin_psionic_trap_trap_damage_Description"	"<h1>Yaygın Scepter Parçası</h1>Psionic Trap'in tuzak hasarını %value% artırır."
"[english]DOTA_Tooltip_Ability_item_aghsfort_templar_assassin_psionic_trap_trap_damage_Description"	"<h1>Common Scepter Fragment</h1>Increases Psionic Trap Trap Damage by %value%."
"DOTA_Tooltip_Ability_item_aghsfort_tusk_ice_shards_flat_damage"	"Ice Shards: Hasar"
"[english]DOTA_Tooltip_Ability_item_aghsfort_tusk_ice_shards_flat_damage"	"Ice Shards: Damage"
"DOTA_Tooltip_Ability_item_aghsfort_tusk_ice_shards_flat_damage_Description"	"<h1>Yaygın Scepter Parçası</h1>Ice Shards'ın hasarını %value% artırır."
"[english]DOTA_Tooltip_Ability_item_aghsfort_tusk_ice_shards_flat_damage_Description"	"<h1>Common Scepter Fragment</h1>Increases Ice Shards Damage by %value%."
"DOTA_Tooltip_Ability_item_aghsfort_tusk_ice_shards_flat_shard_duration"	"Ice Shards: Süre"
"[english]DOTA_Tooltip_Ability_item_aghsfort_tusk_ice_shards_flat_shard_duration"	"Ice Shards: Duration"
"DOTA_Tooltip_Ability_item_aghsfort_tusk_ice_shards_flat_shard_duration_Description"	"<h1>Yaygın Scepter Parçası</h1>Ice Shards'ın süresini %value% artırır."
"[english]DOTA_Tooltip_Ability_item_aghsfort_tusk_ice_shards_flat_shard_duration_Description"	"<h1>Common Scepter Fragment</h1>Increases Ice Shards Duration by %value%."
"DOTA_Tooltip_Ability_item_aghsfort_tusk_snowball_flat_snowball_damage"	"Snowball: Hasar"
"[english]DOTA_Tooltip_Ability_item_aghsfort_tusk_snowball_flat_snowball_damage"	"Snowball: Damage"
"DOTA_Tooltip_Ability_item_aghsfort_tusk_snowball_flat_snowball_damage_Description"	"<h1>Yaygın Scepter Parçası</h1>Snowball'un hasarını %value% artırır."
"[english]DOTA_Tooltip_Ability_item_aghsfort_tusk_snowball_flat_snowball_damage_Description"	"<h1>Common Scepter Fragment</h1>Increases Snowball Damage by %value%."
"DOTA_Tooltip_Ability_item_aghsfort_tusk_snowball_flat_stun_duration"	"Snowball: Süre"
"[english]DOTA_Tooltip_Ability_item_aghsfort_tusk_snowball_flat_stun_duration"	"Snowball: Duration"
"DOTA_Tooltip_Ability_item_aghsfort_tusk_snowball_flat_stun_duration_Description"	"<h1>Yaygın Scepter Parçası</h1>Snowball'un süresini %value% artırır."
"[english]DOTA_Tooltip_Ability_item_aghsfort_tusk_snowball_flat_stun_duration_Description"	"<h1>Common Scepter Fragment</h1>Increases Snowball Duration by %value%."
"DOTA_Tooltip_Ability_item_aghsfort_tusk_tag_team_flat_damage"	"Tag Team: Hasar"
"[english]DOTA_Tooltip_Ability_item_aghsfort_tusk_tag_team_flat_damage"	"Tag Team: Damage"
"DOTA_Tooltip_Ability_item_aghsfort_tusk_tag_team_flat_damage_Description"	"<h1>Yaygın Scepter Parçası</h1>Tag Team'in hasarını %value% artırır."
"[english]DOTA_Tooltip_Ability_item_aghsfort_tusk_tag_team_flat_damage_Description"	"<h1>Common Scepter Fragment</h1>Increases Tag Team Damage by %value%."
"DOTA_Tooltip_Ability_item_aghsfort_tusk_tag_team_pct_cooldown"	"Tag Team: Dolum Süresi"
"[english]DOTA_Tooltip_Ability_item_aghsfort_tusk_tag_team_pct_cooldown"	"Tag Team: Cooldown"
"DOTA_Tooltip_Ability_item_aghsfort_tusk_tag_team_pct_cooldown_Description"	"<h1>Yaygın Scepter Parçası</h1>Tag Team'in dolum süresini %%value% azaltır."
"[english]DOTA_Tooltip_Ability_item_aghsfort_tusk_tag_team_pct_cooldown_Description"	"<h1>Common Scepter Fragment</h1>Decreases Tag Team Cooldown by %value%%."
"DOTA_Tooltip_Ability_item_aghsfort_tusk_walrus_punch_pct_cooldown"	"Walrus Punch: Dolum Süresi"
"[english]DOTA_Tooltip_Ability_item_aghsfort_tusk_walrus_punch_pct_cooldown"	"Walrus Punch: Cooldown"
"DOTA_Tooltip_Ability_item_aghsfort_tusk_walrus_punch_pct_cooldown_Description"	"<h1>Yaygın Scepter Parçası</h1>Walrus Punch'ın dolum süresini %%value% azaltır."
"[english]DOTA_Tooltip_Ability_item_aghsfort_tusk_walrus_punch_pct_cooldown_Description"	"<h1>Common Scepter Fragment</h1>Decreases Walrus Punch Cooldown by %value%%."
"DOTA_Tooltip_Ability_item_aghsfort_tusk_walrus_punch_flat_crit_multiplier"	"Walrus Punch: Kritik Çarpanı"
"[english]DOTA_Tooltip_Ability_item_aghsfort_tusk_walrus_punch_flat_crit_multiplier"	"Walrus Punch: Crit Multiplier"
"DOTA_Tooltip_Ability_item_aghsfort_tusk_walrus_punch_flat_crit_multiplier_Description"	"<h1>Yaygın Scepter Parçası</h1>Walrus Punch'ın kritik çarpanını %value% artırır."
"[english]DOTA_Tooltip_Ability_item_aghsfort_tusk_walrus_punch_flat_crit_multiplier_Description"	"<h1>Common Scepter Fragment</h1>Increases Walrus Punch Crit Multiplier by %value%."
"DOTA_Tooltip_Ability_item_aghsfort_ursa_earthshock_flat_damage"	"Earthshock: Hasar"
"[english]DOTA_Tooltip_Ability_item_aghsfort_ursa_earthshock_flat_damage"	"Earthshock: Damage"
"DOTA_Tooltip_Ability_item_aghsfort_ursa_earthshock_flat_damage_Description"	"<h1>Yaygın Scepter Parçası</h1>Earthshock'ın hasarını %value% artırır."
"[english]DOTA_Tooltip_Ability_item_aghsfort_ursa_earthshock_flat_damage_Description"	"<h1>Common Scepter Fragment</h1>Increases Earthshock Damage by %value%."
"DOTA_Tooltip_Ability_item_aghsfort_ursa_earthshock_flat_radius"	"Earthshock: Yarıçap"
"[english]DOTA_Tooltip_Ability_item_aghsfort_ursa_earthshock_flat_radius"	"Earthshock: Radius"
"DOTA_Tooltip_Ability_item_aghsfort_ursa_earthshock_flat_radius_Description"	"<h1>Yaygın Scepter Parçası</h1>Earthshock'ın yarıçapını %value% artırır."
"[english]DOTA_Tooltip_Ability_item_aghsfort_ursa_earthshock_flat_radius_Description"	"<h1>Common Scepter Fragment</h1>Increases Earthshock Radius by %value%."
"DOTA_Tooltip_Ability_item_aghsfort_ursa_overpower_flat_max_attacks"	"Overpower: Maks. Saldırı"
"[english]DOTA_Tooltip_Ability_item_aghsfort_ursa_overpower_flat_max_attacks"	"Overpower: Max Attacks"
"DOTA_Tooltip_Ability_item_aghsfort_ursa_overpower_flat_max_attacks_Description"	"<h1>Yaygın Scepter Parçası</h1>Overpower'ın maksimum saldırı sayısını %value% artırır."
"[english]DOTA_Tooltip_Ability_item_aghsfort_ursa_overpower_flat_max_attacks_Description"	"<h1>Common Scepter Fragment</h1>Increases Overpower Max Attacks by %value%."
"DOTA_Tooltip_Ability_item_aghsfort_ursa_overpower_percent_cooldown"	"Overpower: Dolum Süresi"
"[english]DOTA_Tooltip_Ability_item_aghsfort_ursa_overpower_percent_cooldown"	"Overpower: Cooldown"
"DOTA_Tooltip_Ability_item_aghsfort_ursa_overpower_percent_cooldown_Description"	"<h1>Yaygın Scepter Parçası</h1>Overpower'ın dolum süresini %%value% azaltır."
"[english]DOTA_Tooltip_Ability_item_aghsfort_ursa_overpower_percent_cooldown_Description"	"<h1>Common Scepter Fragment</h1>Decreases Overpower Cooldown by %value%%."
"DOTA_Tooltip_Ability_item_aghsfort_ursa_fury_swipes_flat_damage_per_stack"	"Fury Swipes: İstif Başına Hasar"
"[english]DOTA_Tooltip_Ability_item_aghsfort_ursa_fury_swipes_flat_damage_per_stack"	"Fury Swipes: Damage Per Stack"
"DOTA_Tooltip_Ability_item_aghsfort_ursa_fury_swipes_flat_damage_per_stack_Description"	"<h1>Yaygın Scepter Parçası</h1>Fury Swipes'ın istif başına hasarını %value% artırır."
"[english]DOTA_Tooltip_Ability_item_aghsfort_ursa_fury_swipes_flat_damage_per_stack_Description"	"<h1>Common Scepter Fragment</h1>Increases Fury Swipe Damage Per Stack by %value%."
"DOTA_Tooltip_Ability_item_aghsfort_ursa_fury_swipes_flat_max_swipe_stack"	"Fury Swipes: Maks. İstif"
"[english]DOTA_Tooltip_Ability_item_aghsfort_ursa_fury_swipes_flat_max_swipe_stack"	"Fury Swipes: Max Stacks"
"DOTA_Tooltip_Ability_item_aghsfort_ursa_fury_swipes_flat_max_swipe_stack_Description"	"<h1>Yaygın Scepter Parçası</h1>Fury Swipes'ın maksimum istif sayısını %value% artırır."
"[english]DOTA_Tooltip_Ability_item_aghsfort_ursa_fury_swipes_flat_max_swipe_stack_Description"	"<h1>Common Scepter Fragment</h1>Increases Fury Swipe Max Stacks by %value%."
"DOTA_Tooltip_Ability_item_aghsfort_ursa_enrage_flat_duration"	"Enrage: Süre"
"[english]DOTA_Tooltip_Ability_item_aghsfort_ursa_enrage_flat_duration"	"Enrage: Duration"
"DOTA_Tooltip_Ability_item_aghsfort_ursa_enrage_flat_duration_Description"	"<h1>Yaygın Scepter Parçası</h1>Enrage'in süresini %value% artırır."
"[english]DOTA_Tooltip_Ability_item_aghsfort_ursa_enrage_flat_duration_Description"	"<h1>Common Scepter Fragment</h1>Increases Enrage Duration by %value%."
"DOTA_Tooltip_Ability_item_aghsfort_ursa_enrage_percent_cooldown"	"Enrage: Dolum Süresi"
"[english]DOTA_Tooltip_Ability_item_aghsfort_ursa_enrage_percent_cooldown"	"Enrage: Cooldown"
"DOTA_Tooltip_Ability_item_aghsfort_ursa_enrage_percent_cooldown_Description"	"<h1>Yaygın Scepter Parçası</h1>Enrage'in dolum süresini %%value% azaltır."
"[english]DOTA_Tooltip_Ability_item_aghsfort_ursa_enrage_percent_cooldown_Description"	"<h1>Common Scepter Fragment</h1>Decreases Enrage Cooldown by %value%%."
"npc_dota_announcer_aghanim"	"Aghanim"
"[english]npc_dota_announcer_aghanim"	"Aghanim"
}
}
