"lang"
{
"Language"	"bulgarian"
"Tokens"
{
"addon_game_name"	"Aghanim's Labyrinth"
"[english]addon_game_name"	"Aghanim's Labyrinth"
"DOTA_GameMode_15"	"Aghanim's Labyrinth"
"[english]DOTA_GameMode_15"	"Aghanim's Labyrinth"
"DOTA_GameMode_19"	"Aghanim's Labyrinth"
"[english]DOTA_GameMode_19"	"Aghanim's Labyrinth"
"dota_game_end_victory_title_radiant"	"Надхитрихте Aghanim's Labyrinth"
"[english]dota_game_end_victory_title_radiant"	"You have bested Aghanim's Labyrinth"
"dota_game_end_victory_title_dire"	"Aghanim's Labyrinth покори екипа Ви"
"[english]dota_game_end_victory_title_dire"	"Aghanim's Labyrinth claims your party"
"DOTA_HUD_Kills"	"УБИЙСТВА"
"[english]DOTA_HUD_Kills"	"KILLS"
"DOTA_HUD_Bags"	"ТОРБИ"
"[english]DOTA_HUD_Bags"	"BAGS"
"DOTA_HUD_Mute"	"ЗАГЛУШ."
"[english]DOTA_HUD_Mute"	"MUTE"
"DOTA_HUD_Yes"	"ДА"
"[english]DOTA_HUD_Yes"	"YES"
"DOTA_HUD_No"	"НЕ"
"[english]DOTA_HUD_No"	"NO"
"DOTA_HUD_Score"	"РЕЗУЛТАТ"
"[english]DOTA_HUD_Score"	"SCORE"
"DOTA_HUD_GoldBags"	"СЪБРАНИ ТОРБИ СЪС ЗЛАТО"
"[english]DOTA_HUD_GoldBags"	"GOLD BAGS COLLECTED"
"DOTA_HUD_GoldBagsMissed"	"ПРОПУСНАТИ ТОРБИ СЪС ЗЛАТО"
"[english]DOTA_HUD_GoldBagsMissed"	"GOLD BAGS MISSED"
"DOTA_HUD_Reward_Gold_desc"	"{d:quantity} злато"
"[english]DOTA_HUD_Reward_Gold_desc"	"{d:quantity} Gold"
"DOTA_HUD_Reward_Aura"	"Аура"
"[english]DOTA_HUD_Reward_Aura"	"Aura"
"DOTA_HUD_Game_Mode_Header"	"Добре дошли в Aghanim's Labyrinth!"
"[english]DOTA_HUD_Game_Mode_Header"	"Welcome To Aghanim's Labyrinth!"
"DOTA_HUD_TopBar_Difficulty"	"{s:difficulty_name}"
"[english]DOTA_HUD_TopBar_Difficulty"	"{s:difficulty_name}"
"DOTA_Tooltip_Ability_item_arcane_fragments"	"Тайнствени фрагменти"
"[english]DOTA_Tooltip_Ability_item_arcane_fragments"	"Arcane Fragments"
"DOTA_RewardTooltip_Gold"	"Злато"
"[english]DOTA_RewardTooltip_Gold"	"Gold"
"DOTA_RewardTooltip_XP"	"ОПИТ"
"[english]DOTA_RewardTooltip_XP"	"XP"
"DOTA_HUD_REWARD_TYPE_GOLD_Toast"	"{s:player_name} избра {d:int_value} <panel class='CombatEventGoldIcon'/>"
"[english]DOTA_HUD_REWARD_TYPE_GOLD_Toast"	"{s:player_name} chose {d:int_value} <panel class='CombatEventGoldIcon'/>"
"DOTA_HUD_REWARD_TYPE_ITEM_Toast"	"{s:player_name} избра {s:locstring_value}"
"[english]DOTA_HUD_REWARD_TYPE_ITEM_Toast"	"{s:player_name} chose {s:locstring_value}"
"DOTA_HUD_REWARD_TYPE_ABILITY_UPGRADE_Toast"	"{s:player_name} избра {s:locstring_value}"
"[english]DOTA_HUD_REWARD_TYPE_ABILITY_UPGRADE_Toast"	"{s:player_name} chose {s:locstring_value}"
"DOTA_HUD_REWARD_TYPE_EXTRA_LIVES_Toast"	"{s:player_name} избра {d:int_value}"
"[english]DOTA_HUD_REWARD_TYPE_EXTRA_LIVES_Toast"	"{s:player_name} chose {d:int_value}"
"DOTA_HUD_REWARD_TYPE_MINOR_ABILITY_UPGRADE_Toast"	"{s:player_name} избра %s1"
"[english]DOTA_HUD_REWARD_TYPE_MINOR_ABILITY_UPGRADE_Toast"	"{s:player_name} chose %s1"
"DOTA_HUD_REWARD_TYPE_MINOR_STATS_UPGRADE_Toast"	"{s:player_name} избра %s1"
"[english]DOTA_HUD_REWARD_TYPE_MINOR_STATS_UPGRADE_Toast"	"{s:player_name} chose %s1"
"DOTA_HUD_REWARD_TYPE_GOLD_Desc"	"Злато"
"[english]DOTA_HUD_REWARD_TYPE_GOLD_Desc"	"Gold"
"DOTA_Hud_Tooltip_Outpost_BossTitle"	"Бос"
"[english]DOTA_Hud_Tooltip_Outpost_BossTitle"	"Boss"
"DOTA_Hud_Tooltip_Outpost_BonusTitle"	"Бонус"
"[english]DOTA_Hud_Tooltip_Outpost_BonusTitle"	"Bonus"
"DOTA_Tooltip_ability_item_shadow_amulet_Description"	"<h1>Активно: Fade</h1> Предоставя невидимост на Вас или посочен съюзнически герой, стига целта да остане неподвижна.<br><br>Има %fade_time% секундно време за избледняване и незабавно прекратява невидимостта при движение. Обсег: %abilitycastrange%"
"[english]DOTA_Tooltip_ability_item_shadow_amulet_Description"	"<h1>Active: Fade</h1>Grants invisibility to you or a target allied hero as long as the target unit remains still.  <br><br>Has a %fade_time% second fade time, and breaks instantly upon moving. Range: %abilitycastrange%"
"DOTA_Tooltip_ability_item_vladmir_Description"	"<h1>Пасивно: Vladmir's Aura</h1> Дава <font color='#F40000'>%lifesteal_aura%%%</font> кражба на здраве, %damage_aura%%% бонус щети и %mana_regen_aura% регенерация на мана към съюзниците наблизо.<br><br>Радиус: %aura_radius%"
"[english]DOTA_Tooltip_ability_item_vladmir_Description"	"<h1>Passive: Vladmir's Aura</h1>Grants <font color='#F40000'>%lifesteal_aura%%%</font> lifesteal, %damage_aura%%% bonus damage, and %mana_regen_aura% mana regeneration to nearby allies. <br><br>Radius: %aura_radius%"
"DOTA_Tooltip_ability_item_satanic_Description"	"<h1>Активно: Unholy Rage</h1> Увеличава процента за кражба на здраве до <font color='#F40000'>%unholy_lifesteal_total_tooltip%%%</font> за %unholy_duration% секунди. \n<h1>Пасивно: Lifesteal</h1> Лекува атакуващия с <font color='#F40000'>%lifesteal_percent%%%</font> от нанесените щети."
"[english]DOTA_Tooltip_ability_item_satanic_Description"	"<h1>Active: Unholy Rage</h1>Increases Lifesteal percentage to <font color='#F40000'>%unholy_lifesteal_total_tooltip%%%</font> for %unholy_duration% seconds. \n<h1>Passive: Lifesteal</h1>Heals the attacker for <font color='#F40000'>%lifesteal_percent%%%</font> of attack damage dealt."
"DOTA_Tooltip_ability_creature_brewmaster_fire_permanent_immolation_Lore"	" "
"[english]DOTA_Tooltip_ability_creature_brewmaster_fire_permanent_immolation_Lore"	""
"DOTA_Tooltip_ability_creature_brewmaster_fire_permanent_immolation_damage"	"ЩЕТИ В СЕКУНДА:"
"[english]DOTA_Tooltip_ability_creature_brewmaster_fire_permanent_immolation_damage"	"DAMAGE PER SECOND:"
"DOTA_Tooltip_ability_item_purification_potion_heal"	"ЛЕЧЕНИЕ/ЩЕТИ:"
"[english]DOTA_Tooltip_ability_item_purification_potion_heal"	"HEAL/DAMAGE:"
"DOTA_Tooltip_ability_item_dragon_potion_bonus_attack_range"	"БОНУС ОБСЕГ НА АТАКА:"
"[english]DOTA_Tooltip_ability_item_dragon_potion_bonus_attack_range"	"BONUS ATTACK RANGE:"
"DOTA_Tooltip_Ability_item_torrent_effect_potion_Description"	"<h1>Употреба: <font color='#FBD600'> Предоставя перманентен ефект.</font></h1> Когато бъдете атакувани, разполагате с %proc_chance%%% шанс да призовете нарастващ порой, който запраща вражеските единици в небето след кратко отлагане. Онези от тях, попаднали в пороя, биват зашеметени, поемат щети и са забавени."
"[english]DOTA_Tooltip_Ability_item_torrent_effect_potion_Description"	"<h1>Use: <font color='#FBD600'>Grants permanent effect.</font></h1> When attacked, you have a %proc_chance%%% chance to summon a rising torrent that hurls enemy units into the sky after a short delay. Units caught in the torrent are stunned, damaged, and slowed."
"DOTA_Tooltip_ability_item_shadow_wave_effect_potion_Description"	"<h1>Употреба: <font color='#FBD600'>Предоставя перманентен ефект.</font></h1> Когато бъдете атакувани, разполагате с %proc_chance%%% шанс да изпратите могъща мълния, която образува волтови дъги между съюзниците, лекувайки ги, докато същевременно с това нанася щети на всякакви единици, стоящи наблизо. Вие винаги бивате лекувани от Shadow Wave."
"[english]DOTA_Tooltip_ability_item_shadow_wave_effect_potion_Description"	"<h1>Use: <font color='#FBD600'>Grants permanent effect.</font></h1> When attacked, you have a %proc_chance%%% chance to send out a bolt of power that arcs between allies, healing them while damaging any units standing nearby. You are always healed by Shadow Wave."
"DOTA_Tooltip_ability_item_shadow_wave_effect_potion_tooltip_max_targets_inc_dazzle"	"МАКС. ЦЕЛИ (ЛЕЧЕНИЕ):"
"[english]DOTA_Tooltip_ability_item_shadow_wave_effect_potion_tooltip_max_targets_inc_dazzle"	"MAX HEAL TARGETS:"
"DOTA_Tooltip_ability_item_shadow_wave_effect_potion_damage"	"ЛЕЧЕНИЕ/ЩЕТИ:"
"[english]DOTA_Tooltip_ability_item_shadow_wave_effect_potion_damage"	"HEAL/DAMAGE:"
"DOTA_Tooltip_ability_aghsfort_luna_eclipse_Description"	"Обсипва произволни врагове в близост с удари от текущото ниво Lucent Beam на Luna. Тези лъчи не зашеметяват своите цели и има максимален брой пъти, в които могат да ударят дадена мишена. Също така превръща деня в нощ за 10 секунди.\n\nПодобрява се чрез Aghanim's Scepter."
"[english]DOTA_Tooltip_ability_aghsfort_luna_eclipse_Description"	"Showers random nearby enemies with strikes from Luna's current level of Lucent Beam. These beams do not stun their targets, and there is a maximum number of times that a single target can be struck. Also turns day into night for 10 seconds.\n\nUpgradable by Aghanim's Scepter."
"DOTA_Tooltip_ability_aghsfort_luna_eclipse_cast_range_tooltip_scepter"	"ОБСЕГ НА ИЗПЪЛНЯВАНЕ (СКИПТЪР):"
"[english]DOTA_Tooltip_ability_aghsfort_luna_eclipse_cast_range_tooltip_scepter"	"SCEPTER CAST RANGE:"
"DOTA_Tooltip_ability_aghsfort_luna_eclipse_aghanim_description"	"Позволява на Luna да изпълни Eclipse над съюзническа единица или върху себе си и ефектите ще ги последват. Може да го изпълни и върху дадена площ.
Също така увеличава общия брой лъчи и времетраене. Премахва ограничението от лъчи за единица. Прави появата на лъчите два пъти по-бърза."
"[english]DOTA_Tooltip_ability_aghsfort_luna_eclipse_aghanim_description"	"Allows Luna to cast Eclipse on an allied unit or herself and have its effects follow them, or cast it on an area. Also increases total beams and duration, removes the limit on beams per unit, and makes the beams appear twice as fast."
"DOTA_Tooltip_ability_item_pelt_of_the_old_wolf_Description"	" "
"[english]DOTA_Tooltip_ability_item_pelt_of_the_old_wolf_Description"	""
"DOTA_Tooltip_ability_item_paw_of_lucius_bonus_attack_speed"	"БОНУС СКОРОСТ НА АТАКА:"
"[english]DOTA_Tooltip_ability_item_paw_of_lucius_bonus_attack_speed"	"BONUS ATTACK SPEED:"
"DOTA_Tooltip_ability_item_longclaws_amulet_Description"	" "
"[english]DOTA_Tooltip_ability_item_longclaws_amulet_Description"	""
"DOTA_Tooltip_ability_item_longclaws_amulet_spell_lifesteal_pct"	"%КРАЖБА НА ЗДРАВЕ ОТ ЗАКЛИНАНИЯ:"
"[english]DOTA_Tooltip_ability_item_longclaws_amulet_spell_lifesteal_pct"	"%SPELL LIFESTEAL:"
"DOTA_Tooltip_ability_item_bogduggs_baldric_Description"	" "
"[english]DOTA_Tooltip_ability_item_bogduggs_baldric_Description"	""
"DOTA_Tooltip_ability_item_sign_of_the_arachnid_bonus_move_speed_pct"	"%БОНУС СКОРОСТ НА ДВИЖЕНИЕ (АУРА):"
"[english]DOTA_Tooltip_ability_item_sign_of_the_arachnid_bonus_move_speed_pct"	"%AURA BONUS MOVE SPEED:"
"DOTA_Tooltip_ability_item_sign_of_the_arachnid_attack_speed"	"БОНУС СКОРОСТ НА АТАКА (АУРА):"
"[english]DOTA_Tooltip_ability_item_sign_of_the_arachnid_attack_speed"	"AURA BONUS ATTACK SPEED:"
"DOTA_Tooltip_ability_item_unhallowed_icon_lifesteal_pct"	"%СВЪРЗАНА КРАЖБА НА ЗДРАВЕ (АУРА):"
"[english]DOTA_Tooltip_ability_item_unhallowed_icon_lifesteal_pct"	"%AURA LINKED LIFESTEAL:"
"DOTA_Tooltip_ability_item_unhallowed_icon_hp_regen"	"РЕГЕН. НА ЗДРАВЕ (АУРА):"
"[english]DOTA_Tooltip_ability_item_unhallowed_icon_hp_regen"	"AURA HP REGEN:"
"DOTA_Tooltip_ability_item_preserved_skull_cooldown_reduction_pct"	"%НАМАЛЯВАНЕ НА ИЗЧАКВАНЕТО (АУРА):"
"[english]DOTA_Tooltip_ability_item_preserved_skull_cooldown_reduction_pct"	"%AURA COOLDOWN REDUCTION:"
"DOTA_Tooltip_ability_item_preserved_skull_aura_mana_regen"	"РЕГЕН. НА МАНА (АУРА):"
"[english]DOTA_Tooltip_ability_item_preserved_skull_aura_mana_regen"	"AURA MANA REGEN:"
"DOTA_Tooltip_ability_item_treads_of_ermacor_bonus_movement_speed"	"БОНУС СКОРОСТ НА ДВИЖЕНИЕ:"
"[english]DOTA_Tooltip_ability_item_treads_of_ermacor_bonus_movement_speed"	"BONUS MOVEMENT SPEED:"
"DOTA_Tooltip_ability_item_treads_of_ermacor_bonus_attack_speed"	"БОНУС СКОРОСТ НА АТАКА:"
"[english]DOTA_Tooltip_ability_item_treads_of_ermacor_bonus_attack_speed"	"BONUS ATTACK SPEED:"
"DOTA_Tooltip_ability_item_rhyziks_eye_Description"	" "
"[english]DOTA_Tooltip_ability_item_rhyziks_eye_Description"	""
"DOTA_Tooltip_ability_item_rhyziks_eye_damage_reduction"	"%НАМАЛЯВАНЕ НА ЩЕТИ (ВХОДЯЩИ):"
"[english]DOTA_Tooltip_ability_item_rhyziks_eye_damage_reduction"	"%INCOMING DAMAGE REDUCTION:"
"DOTA_Tooltip_ability_item_the_caustic_finale_Description"	"<h1>Пасивно: Caustic Finale</h1> Атаките намаляват процент от бронята на целта. Този ефект се натрупва до макс. %max_stack_count% пъти. Ако целта умре под влиянието му, тя експлодира и нанася щети в областта на ефекта.\n"
"[english]DOTA_Tooltip_ability_item_the_caustic_finale_Description"	"<h1>Passive: Caustic Finale</h1>Attacks reduce a percentage of the target's armor.  This effect stacks up to %max_stack_count% times.  If the target dies under this effect, it explodes, dealing damage in an area of effect.\n"
"DOTA_Tooltip_ability_item_the_caustic_finale_bonus_attack_speed"	"БОНУС СКОРОСТ НА АТАКА:"
"[english]DOTA_Tooltip_ability_item_the_caustic_finale_bonus_attack_speed"	"BONUS ATTACK SPEED:"
"DOTA_Tooltip_ability_item_ice_dragon_maw_bonus_attack_range"	"БОНУС ОБСЕГ НА АТАКА (САМО ДАЛЕКОБОЙНИ):"
"[english]DOTA_Tooltip_ability_item_ice_dragon_maw_bonus_attack_range"	"BONUS ATTACK RANGE(RANGED ONLY):"
"DOTA_Tooltip_ability_item_stonework_pendant_Description"	"<h1>Пасивно: Blood From a Stone</h1> Заклинанията вече изискват точки здраве, еквивалентни на %hp_cost_multiplier% пъти нужната им мана. Носителят придобива бонус здраве и регенерация за него, еквивалентно на наличната му мана и нейната реген.\n"
"[english]DOTA_Tooltip_ability_item_stonework_pendant_Description"	"<h1>Passive: Blood From a Stone</h1>Spells now cost hit points equal to %hp_cost_multiplier% times their mana cost, and the wearer gains bonus hit points and health regen equal to the size of their mana pool and mana regen.\n"
"DOTA_Tooltip_ability_item_gravel_foot_Description"	" "
"[english]DOTA_Tooltip_ability_item_gravel_foot_Description"	""
"DOTA_Tooltip_ability_item_gravel_foot_bonus_movement_speed"	"БОНУС СКОРОСТ НА ДВИЖЕНИЕ:"
"[english]DOTA_Tooltip_ability_item_gravel_foot_bonus_movement_speed"	"BONUS MOVEMENT SPEED:"
"DOTA_Tooltip_Ability_item_slippers_of_the_abyss_bonus_movement_speed"	"БОНУС СКОРОСТ НА ДВИЖЕНИЕ:"
"[english]DOTA_Tooltip_Ability_item_slippers_of_the_abyss_bonus_movement_speed"	"BONUS MOVEMENT SPEED:"
"DOTA_Tooltip_Ability_item_slippers_of_the_abyss_bonus_atk_speed"	"БОНУС СКОРОСТ НА АТАКА:"
"[english]DOTA_Tooltip_Ability_item_slippers_of_the_abyss_bonus_atk_speed"	"BONUS ATTACK SPEED:"
"DOTA_Tooltip_modifier_item_slippers_of_the_abyss_sprint_Description"	"Тази единица има значително увеличена скорост на движение."
"[english]DOTA_Tooltip_modifier_item_slippers_of_the_abyss_sprint_Description"	"This unit has greatly increased movement speed."
"DOTA_Tooltip_modifier_blessing_magic_damage_bonus_Description"	"Предоставяне на %dMODIFIER_PROPERTY_SPELL_AMPLIFY_PERCENTAGE%%% увеличаване на заклинанията."
"[english]DOTA_Tooltip_modifier_blessing_magic_damage_bonus_Description"	"Providing %dMODIFIER_PROPERTY_SPELL_AMPLIFY_PERCENTAGE%%% spell amplification."
"DOTA_Tooltip_Ability_item_aghsfort_disruptor_static_storm_flat_damage_max"	"Static Storm — макс. щети"
"[english]DOTA_Tooltip_Ability_item_aghsfort_disruptor_static_storm_flat_damage_max"	"Static Storm: Max Damage"
"DOTA_Tooltip_Ability_item_aghsfort_disruptor_static_storm_flat_damage_max_Description"	"<h1>Common Scepter Fragment</h1>Увеличава макс. щети на Static Storm с %value%."
"[english]DOTA_Tooltip_Ability_item_aghsfort_disruptor_static_storm_flat_damage_max_Description"	"<h1>Common Scepter Fragment</h1>Increases Static Storm Max Damage by %value%."
"DOTA_Tooltip_Ability_item_aghsfort_mars_arena_of_blood_spear_damage"	"Arena of Blood — щети от копие"
"[english]DOTA_Tooltip_Ability_item_aghsfort_mars_arena_of_blood_spear_damage"	"Arena of Blood: Spear Damage"
"DOTA_Tooltip_Ability_item_aghsfort_mars_arena_of_blood_spear_damage_Description"	"<h1>Common Scepter Fragment</h1>Увеличаване на щетите от копието на Arena of Blood с %value%."
"[english]DOTA_Tooltip_Ability_item_aghsfort_mars_arena_of_blood_spear_damage_Description"	"<h1>Common Scepter Fragment</h1>Increases Arena of Blood Spear Damage by %value%."
"DOTA_Tooltip_Ability_item_aghsfort_snapfire_mortimer_kisses_flat_burn_damage"	"Mortimer Kisses — щети от изгаряне"
"[english]DOTA_Tooltip_Ability_item_aghsfort_snapfire_mortimer_kisses_flat_burn_damage"	"Mortimer Kisses: Burn Damage"
"DOTA_Tooltip_Ability_item_aghsfort_snapfire_mortimer_kisses_flat_burn_damage_Description"	"<h1>Common Scepter Fragment</h1>Увеличава щетите от изгаряне на Mortimer Kisses с %value%."
"[english]DOTA_Tooltip_Ability_item_aghsfort_snapfire_mortimer_kisses_flat_burn_damage_Description"	"<h1>Common Scepter Fragment</h1>Increases Mortimer Kisses Burn Damage by %value%."
"DOTA_Tooltip_Ability_item_aghsfort_sniper_take_aim_flat_bonus_attack_range"	"Take Aim — бонус обсег на атака"
"[english]DOTA_Tooltip_Ability_item_aghsfort_sniper_take_aim_flat_bonus_attack_range"	"Take Aim: Bonus Attack Range"
"DOTA_Tooltip_Ability_item_aghsfort_templar_assassin_psi_blades_bonus_attack_range"	"Psi Blades — бонус обсег на атака"
"[english]DOTA_Tooltip_Ability_item_aghsfort_templar_assassin_psi_blades_bonus_attack_range"	"Psi Blades: Bonus Attack Range"
"DOTA_Tooltip_Ability_item_aghsfort_tusk_snowball_flat_snowball_damage_Description"	"<h1>Common Scepter Fragment</h1>Увеличава щетите на Snowball с %value%."
"[english]DOTA_Tooltip_Ability_item_aghsfort_tusk_snowball_flat_snowball_damage_Description"	"<h1>Common Scepter Fragment</h1>Increases Snowball Damage by %value%."
"DOTA_Tooltip_Ability_item_aghsfort_ursa_fury_swipes_flat_damage_per_stack"	"Fury Swipes — щети за натрупване"
"[english]DOTA_Tooltip_Ability_item_aghsfort_ursa_fury_swipes_flat_damage_per_stack"	"Fury Swipes: Damage Per Stack"
"DOTA_Tooltip_Ability_item_aghsfort_ursa_fury_swipes_flat_damage_per_stack_Description"	"<h1>Common Scepter Fragment</h1>Увеличава щетите за натрупване на Fury Swipes с %value%."
"[english]DOTA_Tooltip_Ability_item_aghsfort_ursa_fury_swipes_flat_damage_per_stack_Description"	"<h1>Common Scepter Fragment</h1>Increases Fury Swipe Damage Per Stack by %value%."
"DOTA_Tooltip_Ability_item_aghsfort_viper_nethertoxin_max_damage"	"Nethertoxin — макс. щети"
"[english]DOTA_Tooltip_Ability_item_aghsfort_viper_nethertoxin_max_damage"	"Nethertoxin: Max Damage"
"DOTA_Tooltip_Ability_item_aghsfort_viper_nethertoxin_max_damage_Description"	"<h1>Common Scepter Fragment</h1>Увеличава макс. щети на Nethertoxin с %value%."
"[english]DOTA_Tooltip_Ability_item_aghsfort_viper_nethertoxin_max_damage_Description"	"<h1>Common Scepter Fragment</h1>Increases Nethertoxin Max Damage by %value%."
"DOTA_Tooltip_Ability_item_aghsfort_winter_wyvern_arctic_burn_flat_damage_Description"	"<h1>Common Scepter Fragment</h1>Увеличава щетите на Arctic Burn с %value%."
"[english]DOTA_Tooltip_Ability_item_aghsfort_winter_wyvern_arctic_burn_flat_damage_Description"	"<h1>Common Scepter Fragment</h1>Increases Arctic Burn Damage by %value%."
}
}
