"lang"
{
"Language"	"polish"
"Tokens"
{
"game_mode_15"	"Mroźny Festiwal"
"[english]game_mode_15"	"The Frostivus Festival"
"addon_game_name"	"Mroźny Festiwal"
"[english]addon_game_name"	"The Frostivus Festival"
"DOTA_Tooltip_ability_item_bag_of_gold"	"Moneta"
"[english]DOTA_Tooltip_ability_item_bag_of_gold"	"Coin"
"DOTA_GameMode_15"	"Mroczny Księżyc"
"[english]DOTA_GameMode_15"	"Dark Moon"
"DOTA_GameMode_19"	"Mroczny Księżyc"
"[english]DOTA_GameMode_19"	"Dark Moon"
"DOTA_HUD_Round"	"RUNDA"
"[english]DOTA_HUD_Round"	"ROUND"
"DOTA_HUD_EnemiesRemaining"	"POZOSTAŁO WROGÓW:"
"[english]DOTA_HUD_EnemiesRemaining"	"ENEMIES REMAINING:"
"DOTA_HUD_NextRound"	"NASTĘPNA RUNDA:"
"[english]DOTA_HUD_NextRound"	"NEXT ROUND: "
"DOTA_HUD_RoundStart"	"START RUNDY!"
"[english]DOTA_HUD_RoundStart"	"ROUND START!"
"DOTA_HUD_Victory"	"ZWYCIĘSTWO!"
"[english]DOTA_HUD_Victory"	"VICTORY!"
"DOTA_HUD_Defeat"	"PORAŻKA!"
"[english]DOTA_HUD_Defeat"	"DEFEAT!"
"DOTA_HUD_Kills"	"ZABÓJSTWA"
"[english]DOTA_HUD_Kills"	"KILLS"
"DOTA_HUD_Deaths"	"ŚMIERCI"
"[english]DOTA_HUD_Deaths"	"DEATHS"
"DOTA_HUD_Saves"	"RATUNKI"
"[english]DOTA_HUD_Saves"	"REVIVES"
"DOTA_HUD_Bags"	"WORKI"
"[english]DOTA_HUD_Bags"	"BAGS"
"DOTA_HUD_PlayAgain"	"Jeszcze raz?"
"[english]DOTA_HUD_PlayAgain"	"Play Again?"
"DOTA_HUD_Yes"	"TAK"
"[english]DOTA_HUD_Yes"	"YES"
"DOTA_HUD_No"	"NIE"
"[english]DOTA_HUD_No"	"NO"
"DOTA_HUD_Score"	"WYNIK RUNDY"
"[english]DOTA_HUD_Score"	"ROUND SCORE"
"DOTA_HUD_TowersRemaining"	"POZOSTAŁE WIEŻE"
"[english]DOTA_HUD_TowersRemaining"	"TOWERS REMAINING"
"DOTA_HUD_GoldBags"	"ZDOBYTE WORKI ZŁOTA"
"[english]DOTA_HUD_GoldBags"	"GOLD BAGS COLLECTED"
"DOTA_HUD_GoldBagsMissed"	"UTRACONE WORKI ZŁOTA"
"[english]DOTA_HUD_GoldBagsMissed"	"GOLD BAGS MISSED"
"DOTA_HUD_TeamDeaths"	"ŚMIERCI DRUŻYNY"
"[english]DOTA_HUD_TeamDeaths"	"TEAM DEATHS"
"DOTA_HUD_DarkMoonPoints"	"PUNKTY"
"[english]DOTA_HUD_DarkMoonPoints"	"POINTS"
"DOTA_HUD_ThisRound"	"PUNKTY W TEJ RUNDZIE"
"[english]DOTA_HUD_ThisRound"	"POINTS THIS ROUND"
"DOTA_HUD_TotalPoints"	"SUMA PUNKTÓW W TYM MECZU"
"[english]DOTA_HUD_TotalPoints"	"TOTAL POINTS EARNED THIS MATCH"
"DOTA_HUD_RankThisRound"	"OCENA TEJ RUNDY"
"[english]DOTA_HUD_RankThisRound"	"RANK THIS ROUND"
"DOTA_HUD_RankInfoIcon"	"Ocena jest określana na podstawie pozostałych wież, zebranych i utraconych worków złota oraz łącznej liczby śmierci drużyny. Ocena nie ma wpływu na punkty."
"[english]DOTA_HUD_RankInfoIcon"	"Rank is determined based off performance on Towers Remaining, Gold Bags Collected, and Total Team Deaths.  Points earned are not affected by Rank."
"DOTA_HUD_Mute"	"WYCISZ"
"[english]DOTA_HUD_Mute"	"MUTE"
"taunt_game_creep"	"Creep"
"[english]taunt_game_creep"	"Creep"
"suicidal_pudge"	"Samobójczy Pudge"
"[english]suicidal_pudge"	"Suicidal Pudge"
"custom_necrophos"	"Necrolyte"
"[english]custom_necrophos"	"Necrolyte"
"bloodseeker_game_bloodseeker"	"Bloodseeker"
"[english]bloodseeker_game_bloodseeker"	"Bloodseeker"
"chain_frost_game_lich"	"Lich"
"[english]chain_frost_game_lich"	"Lich"
"chain_frost_game_penguin"	"Pingwin"
"[english]chain_frost_game_penguin"	"Penguin"
"mirana_game_bell"	"Dzwon"
"[english]mirana_game_bell"	"Bell"
"techies_game_remote_mine"	"Remote Mine"
"[english]techies_game_remote_mine"	"Remote Mine"
"zuus_race_land_mine"	"Land Mine"
"[english]zuus_race_land_mine"	"Land Mine"
"zuus_race_stasis_trap"	"Stasis Trap"
"[english]zuus_race_stasis_trap"	"Stasis Trap"
"monkey_king_real"	"Monkey King"
"[english]monkey_king_real"	"Monkey King"
"monkey_king_fake"	"Fałszywy Monkey King"
"[english]monkey_king_fake"	"Not Monkey King"
"vision_dummy"	"Vision Dummy"
"[english]vision_dummy"	"Vision Dummy"
"npc_dota_creature_ogre_tank"	"Ogrzy twardziel"
"[english]npc_dota_creature_ogre_tank"	"Ogre Tank"
"npc_dota_creature_ogre_tank_boss"	"Ogrzy twardziel - boss"
"[english]npc_dota_creature_ogre_tank_boss"	"Ogre Tank Boss"
"earth_spirit_soccer_ball"	"Piłka"
"[english]earth_spirit_soccer_ball"	"Soccer Ball"
"earth_spirit_soccer_goal"	"Bramka"
"[english]earth_spirit_soccer_goal"	"Soccer Goal"
"npc_dota_creature_ogre_seal"	"Foka ogrza"
"[english]npc_dota_creature_ogre_seal"	"Ogre Seal"
"npc_dummy_unit"	"Dummy Unit"
"[english]npc_dummy_unit"	"Dummy Unit"
"npc_dota_fire_trap_ward"	"Ognista pułapka"
"[english]npc_dota_fire_trap_ward"	"Fire Trap"
"custom_undying_tombstone"	"Tombstone"
"[english]custom_undying_tombstone"	"Tombstone"
"custom_creature_zombie"	"Zombie"
"[english]custom_creature_zombie"	"Zombie"
"propulsion_mine"	"Propulsion Mine"
"[english]propulsion_mine"	"Propulsion Mine"
"npc_dota_weather_dummy"	"Dota Weather Dummy"
"[english]npc_dota_weather_dummy"	"Dota Weather Dummy"
"npc_dota_campfire"	"Ognisko"
"[english]npc_dota_campfire"	"Campfire"
"custom_invoker"	"Invoker"
"[english]custom_invoker"	"Invoker"
"invoker_leader_forge_spirit"	"Forge Spirit"
"[english]invoker_leader_forge_spirit"	"Forge Spirit"
"DOTA_Tooltip_modifier_aoe_rupture_lua"	"Rupture"
"[english]DOTA_Tooltip_modifier_aoe_rupture_lua"	"Rupture"
"DOTA_Tooltip_modifier_aoe_rupture_lua_Description"	"Otrzymywanie obrażeń podczas ruchu."
"[english]DOTA_Tooltip_modifier_aoe_rupture_lua_Description"	"Taking damage on movement."
"DOTA_Tooltip_modifier_heartstopper_aura_visible"	"Heartstopper Aura"
"[english]DOTA_Tooltip_modifier_heartstopper_aura_visible"	"Heartstopper Aura"
"DOTA_Tooltip_modifier_heartstopper_aura_visible_Description"	"Otrzymywanie obrażeń okresowych."
"[english]DOTA_Tooltip_modifier_heartstopper_aura_visible_Description"	"Taking damage over time."
"DOTA_Tooltip_modifier_sun_strike_datadriven"	"Sun Strike Datadriven"
"[english]DOTA_Tooltip_modifier_sun_strike_datadriven"	"Sun Strike Datadriven"
"DOTA_Tooltip_modifier_sun_strike_datadriven_Description"	"
"
"[english]DOTA_Tooltip_modifier_sun_strike_datadriven_Description"	""
"DOTA_Tooltip_modifier_weather_snowstorm_cold"	"Znajdź ognisko, zanim zaczniesz zamarzać!"
"[english]DOTA_Tooltip_modifier_weather_snowstorm_cold"	"Find a Campfire before you start to freeze!"
"DOTA_Tooltip_modifier_weather_snowstorm_effect"	"Zamarzanie"
"[english]DOTA_Tooltip_modifier_weather_snowstorm_effect"	"Freezing"
"DOTA_Tooltip_modifier_weather_snowstorm_effect_Description"	"Otrzymywanie obrażeń okresowych od chłodu"
"[english]DOTA_Tooltip_modifier_weather_snowstorm_effect_Description"	"Taking periodic damage from the cold"
"DOTA_Tooltip_modifier_campfire_effect"	"Campfire"
"[english]DOTA_Tooltip_modifier_campfire_effect"	"Campfire"
"DOTA_Tooltip_modifier_campfire_effect_Description"	"Usuwa efekty spowodowane zimnem."
"[english]DOTA_Tooltip_modifier_campfire_effect_Description"	"Removes the effects of cold."
"DOTA_Tooltip_modifier_invoked_spell_to_cast"	"Czar do rzucenia"
"[english]DOTA_Tooltip_modifier_invoked_spell_to_cast"	"Spell To Cast"
"DOTA_Tooltip_modifier_invoked_spell_to_cast_Description"	"Wywołaj ten czar lub otrzymaj obrażenia."
"[english]DOTA_Tooltip_modifier_invoked_spell_to_cast_Description"	"Invoke this spell or take damage."
"DOTA_Tooltip_modifier_rupture_damage"	"Rupture"
"[english]DOTA_Tooltip_modifier_rupture_damage"	"Rupture"
"DOTA_Tooltip_modifier_berserkers_call_lua"	"Berserker's Call"
"[english]DOTA_Tooltip_modifier_berserkers_call_lua"	"Berserkers Call"
"DOTA_Tooltip_modifier_campfire"	"Campfire"
"[english]DOTA_Tooltip_modifier_campfire"	"Campfire"
"DOTA_Tooltip_modifier_provides_fow_position"	"Zapewnia pozycję w mgle wojny"
"[english]DOTA_Tooltip_modifier_provides_fow_position"	"Provides FOW Position"
"DOTA_Tooltip_modifier_chain_frost_lua"	"Chain Frost"
"[english]DOTA_Tooltip_modifier_chain_frost_lua"	"Chain Frost"
"DOTA_Tooltip_modifier_conjure_image_lua"	"Conjure Image"
"[english]DOTA_Tooltip_modifier_conjure_image_lua"	"Conjure Image"
"DOTA_Tooltip_modifier_illusion_out_of_world"	"Iluzja spoza świata"
"[english]DOTA_Tooltip_modifier_illusion_out_of_world"	"Illusion Out Of World"
"DOTA_Tooltip_modifier_shoot_arrow_lua"	"Arrow – ogłuszenie"
"[english]DOTA_Tooltip_modifier_shoot_arrow_lua"	"Arrow Stun"
"DOTA_Tooltip_modifier_teleport_channel_lua"	"Teleport"
"[english]DOTA_Tooltip_modifier_teleport_channel_lua"	"Teleport"
"DOTA_Tooltip_modifier_greater_bash_lua"	"Greater Bash"
"[english]DOTA_Tooltip_modifier_greater_bash_lua"	"Greater Bash"
"DOTA_Tooltip_modifier_heartstopper_aura_lua"	"Heartstopper Aura"
"[english]DOTA_Tooltip_modifier_heartstopper_aura_lua"	"Heartstopper Aura"
"DOTA_Tooltip_modifier_quas_lua"	"Quas"
"[english]DOTA_Tooltip_modifier_quas_lua"	"Quas"
"DOTA_Tooltip_modifier_wex_lua"	"Wex"
"[english]DOTA_Tooltip_modifier_wex_lua"	"Wex"
"DOTA_Tooltip_modifier_exort_lua"	"Exort"
"[english]DOTA_Tooltip_modifier_exort_lua"	"Exort"
"DOTA_Tooltip_modifier_leader_cold_snap_lua"	"Cold Snap"
"[english]DOTA_Tooltip_modifier_leader_cold_snap_lua"	"Cold Snap"
"DOTA_Tooltip_modifier_rabid_lua"	"Rabid"
"[english]DOTA_Tooltip_modifier_rabid_lua"	"Rabid"
"DOTA_Tooltip_modifier_arrow_lua"	"Arrow"
"[english]DOTA_Tooltip_modifier_arrow_lua"	"Arrow"
"DOTA_Tooltip_modifier_health_lua"	"Zdrowie"
"[english]DOTA_Tooltip_modifier_health_lua"	"Health"
"DOTA_Tooltip_modifier_hidden_lua"	"Ukryto"
"[english]DOTA_Tooltip_modifier_hidden_lua"	"Hidden"
"DOTA_Tooltip_modifier_invisible_lua"	"Niewidzialność"
"[english]DOTA_Tooltip_modifier_invisible_lua"	"Invisible"
"DOTA_Tooltip_modifier_mana_lua"	"Mana"
"[english]DOTA_Tooltip_modifier_mana_lua"	"Mana"
"DOTA_Tooltip_modifier_ogre_tank_melee_smash_thinker"	"Ogre Melee Smash Thinker"
"[english]DOTA_Tooltip_modifier_ogre_tank_melee_smash_thinker"	"Ogre Melee Smash Thinker"
"DOTA_Tooltip_modifier_ogreseal_flop"	"Ogreseal Flop"
"[english]DOTA_Tooltip_modifier_ogreseal_flop"	"Ogreseal Flop"
"DOTA_Tooltip_modifier_provide_vision_lua"	"Zapewnianie widoczności"
"[english]DOTA_Tooltip_modifier_provide_vision_lua"	"Provide Vision"
"DOTA_Tooltip_modifier_rooted_lua"	"Ukorzenieniono"
"[english]DOTA_Tooltip_modifier_rooted_lua"	"Rooted"
"DOTA_Tooltip_modifier_rot_lua"	"Rot"
"[english]DOTA_Tooltip_modifier_rot_lua"	"Rot"
"DOTA_Tooltip_modifier_stunned_lua"	"Ogłuszono"
"[english]DOTA_Tooltip_modifier_stunned_lua"	"Stunned"
"DOTA_Tooltip_modifier_vision_dummy"	"Dummy"
"[english]DOTA_Tooltip_modifier_vision_dummy"	"Dummy"
"DOTA_Tooltip_modifier_ogreseal_flying"	"Ogreseal Passive"
"[english]DOTA_Tooltip_modifier_ogreseal_flying"	"Ogreseal Passive"
"DOTA_Tooltip_modifier_propulsion_mine"	"Propulsion Mine"
"[english]DOTA_Tooltip_modifier_propulsion_mine"	"Propulsion Mine"
"DOTA_Tooltip_modifier_proximity_mine"	"Proximity Mine"
"[english]DOTA_Tooltip_modifier_proximity_mine"	"Proximity Mine"
"DOTA_Tooltip_modifier_refraction_lua"	"Refraction"
"[english]DOTA_Tooltip_modifier_refraction_lua"	"Refraction"
"DOTA_Tooltip_modifier_remote_mine"	"Remote Mine"
"[english]DOTA_Tooltip_modifier_remote_mine"	"Remote Mine"
"DOTA_Tooltip_modifier_shapeshift_bear"	"Shapeshift Bear"
"[english]DOTA_Tooltip_modifier_shapeshift_bear"	"Shapeshift Bear"
"DOTA_Tooltip_modifier_shapeshift_boar"	"Shapeshift Boar"
"[english]DOTA_Tooltip_modifier_shapeshift_boar"	"Shapeshift Boar"
"DOTA_Tooltip_modifier_shapeshift_hawk"	"Shapeshift Hawk"
"[english]DOTA_Tooltip_modifier_shapeshift_hawk"	"Shapeshift Hawk"
"DOTA_Tooltip_modifier_shapeshift"	"Shapeshift"
"[english]DOTA_Tooltip_modifier_shapeshift"	"Shapeshift"
"DOTA_Tooltip_modifier_shukuchi_lua"	"Shukuchi"
"[english]DOTA_Tooltip_modifier_shukuchi_lua"	"Shukuchi"
"DOTA_Tooltip_modifier_snowball"	"Snowball"
"[english]DOTA_Tooltip_modifier_snowball"	"Snowball"
"DOTA_Tooltip_modifier_stasis_trap"	"Stasis Trap"
"[english]DOTA_Tooltip_modifier_stasis_trap"	"Stasis Trap"
"DOTA_Tooltip_modifier_stasis_trap_stun"	"Ogłuszono"
"[english]DOTA_Tooltip_modifier_stasis_trap_stun"	"Stunned"
"DOTA_Tooltip_modifier_storegga_avalanche_thinker"	"Avalanche Thinker"
"[english]DOTA_Tooltip_modifier_storegga_avalanche_thinker"	"Avalanche Thinker"
"DOTA_Tooltip_modifier_spawn_zombies"	"Spawn Zombies"
"[english]DOTA_Tooltip_modifier_spawn_zombies"	"Spawn Zombies"
"DOTA_Tooltip_modifier_weather_dummy_passive"	"Dummy"
"[english]DOTA_Tooltip_modifier_weather_dummy_passive"	"Dummy"
"DOTA_Tooltip_modifier_weather_snowstorm"	"Snowstorm"
"[english]DOTA_Tooltip_modifier_weather_snowstorm"	"Snowstorm"
"DOTA_Tooltip_modifier_item_blink_lua"	"Blink"
"[english]DOTA_Tooltip_modifier_item_blink_lua"	"Blink"
"DOTA_Tooltip_modifier_rune_haste"	"Runa przyśpieszenia"
"[english]DOTA_Tooltip_modifier_rune_haste"	"Haste"
"DOTA_Tooltip_modifier_rune_haste_Description"	"
"
"[english]DOTA_Tooltip_modifier_rune_haste_Description"	""
"DOTA_Tooltip_modifier_rune_double_damage"	"Podwójne obrażenia"
"[english]DOTA_Tooltip_modifier_rune_double_damage"	"Double Damage"
"DOTA_Tooltip_modifier_rune_double_damage_Description"	"
"
"[english]DOTA_Tooltip_modifier_rune_double_damage_Description"	""
"DOTA_Tooltip_ability_ability_hide_healthbar"	"Ukryj pasek zdrowia"
"[english]DOTA_Tooltip_ability_ability_hide_healthbar"	"Hide Healthbar"
"DOTA_Tooltip_ability_ability_hide_healthbar_Description"	"
"
"[english]DOTA_Tooltip_ability_ability_hide_healthbar_Description"	""
"DOTA_Tooltip_ability_vision_dummy_ability"	"Vision Dummy Ability"
"[english]DOTA_Tooltip_ability_vision_dummy_ability"	"Vision Dummy Ability"
"DOTA_Tooltip_ability_vision_dummy_ability_Description"	"
"
"[english]DOTA_Tooltip_ability_vision_dummy_ability_Description"	""
"DOTA_Tooltip_ability_custom_berserkers_call"	"Berserker's Call"
"[english]DOTA_Tooltip_ability_custom_berserkers_call"	"Berserker's Call"
"DOTA_Tooltip_ability_custom_berserkers_call_Description"	"Axe drwi z najbliższych jednostek przeciwnika, zmuszając je do ataku, podczas gdy on otrzymuje premię do pancerza na czas trwania umiejętności."
"[english]DOTA_Tooltip_ability_custom_berserkers_call_Description"	"Axe taunts nearby enemy units, forcing them to attack him, while he gains bonus armor during the duration."
"DOTA_Tooltip_ability_custom_berserkers_call_radius"	"PROMIEŃ:"
"[english]DOTA_Tooltip_ability_custom_berserkers_call_radius"	"RADIUS:"
"DOTA_Tooltip_ability_custom_berserkers_call_bonus_armor"	"PREMIA DO PANCERZA:"
"[english]DOTA_Tooltip_ability_custom_berserkers_call_bonus_armor"	"BONUS ARMOR:"
"DOTA_Tooltip_ability_custom_berserkers_call_duration"	"CZAS TRWANIA:"
"[english]DOTA_Tooltip_ability_custom_berserkers_call_duration"	"DURATION:"
"DOTA_Tooltip_ability_custom_shadowraze1"	"Niestandardowe Shadowraze 1"
"[english]DOTA_Tooltip_ability_custom_shadowraze1"	"Custom Shadowraze1"
"DOTA_Tooltip_ability_custom_shadowraze1_Description"	"Shadow Fiend zrównuje z ziemią obszar tuż przed nim, zadając obrażenia jednostkom na terenie tego obszaru."
"[english]DOTA_Tooltip_ability_custom_shadowraze1_Description"	"Shadow Fiend razes the area in front of him, dealing damage to enemy units in an area."
"DOTA_Tooltip_ability_custom_shadowraze1_shadowraze_radius"	"PROMIEŃ SHADOWRAZE:"
"[english]DOTA_Tooltip_ability_custom_shadowraze1_shadowraze_radius"	"SHADOWRAZE RADIUS:"
"DOTA_Tooltip_ability_custom_shadowraze1_shadowraze_range"	"ZASIĘG SHADOWRAZE:"
"[english]DOTA_Tooltip_ability_custom_shadowraze1_shadowraze_range"	"SHADOWRAZE RANGE:"
"DOTA_Tooltip_ability_custom_shadowraze2"	"Niestandardowe Shadowraze 2"
"[english]DOTA_Tooltip_ability_custom_shadowraze2"	"Custom Shadowraze2"
"DOTA_Tooltip_ability_custom_shadowraze2_Description"	"Shadow Fiend zrównuje z ziemią obszar tuż przed nim, zadając obrażenia jednostkom na terenie tego obszaru."
"[english]DOTA_Tooltip_ability_custom_shadowraze2_Description"	"Shadow Fiend razes the area in front of him, dealing damage to enemy units in an area."
"DOTA_Tooltip_ability_custom_shadowraze2_shadowraze_radius"	"PROMIEŃ SHADOWRAZE:"
"[english]DOTA_Tooltip_ability_custom_shadowraze2_shadowraze_radius"	"SHADOWRAZE RADIUS:"
"DOTA_Tooltip_ability_custom_shadowraze2_shadowraze_range"	"ZASIĘG SHADOWRAZE:"
"[english]DOTA_Tooltip_ability_custom_shadowraze2_shadowraze_range"	"SHADOWRAZE RANGE:"
"DOTA_Tooltip_ability_custom_shadowraze3"	"Niestandardowe Shadowraze 3"
"[english]DOTA_Tooltip_ability_custom_shadowraze3"	"Custom Shadowraze3"
"DOTA_Tooltip_ability_custom_shadowraze3_Description"	"Shadow Fiend zrównuje z ziemią obszar tuż przed nim, zadając obrażenia jednostkom na terenie tego obszaru."
"[english]DOTA_Tooltip_ability_custom_shadowraze3_Description"	"Shadow Fiend razes the area in front of him, dealing damage to enemy units in an area."
"DOTA_Tooltip_ability_custom_shadowraze3_shadowraze_radius"	"PROMIEŃ SHADOWRAZE:"
"[english]DOTA_Tooltip_ability_custom_shadowraze3_shadowraze_radius"	"SHADOWRAZE RADIUS:"
"DOTA_Tooltip_ability_custom_shadowraze3_shadowraze_range"	"ZASIĘG SHADOWRAZE:"
"[english]DOTA_Tooltip_ability_custom_shadowraze3_shadowraze_range"	"SHADOWRAZE RANGE:"
"DOTA_Tooltip_ability_pudge_rot_lua"	"Rot"
"[english]DOTA_Tooltip_ability_pudge_rot_lua"	"Rot"
"DOTA_Tooltip_ability_pudge_rot_lua_Description"	"Toksyczna chmura, która zadaje znaczące obrażenia i spowalnia ruch – szkodliwa nie tylko dla wrogich jednostek, lecz także dla Pudge'a."
"[english]DOTA_Tooltip_ability_pudge_rot_lua_Description"	"A toxic cloud that deals intense damage and slows movement--harming not only enemy units but Pudge himself."
"DOTA_Tooltip_ability_pudge_rot_lua_rot_radius"	"PROMIEŃ:"
"[english]DOTA_Tooltip_ability_pudge_rot_lua_rot_radius"	"ROT RADIUS:"
"DOTA_Tooltip_ability_pudge_rot_lua_rot_tick"	"ODSTĘP MIĘDZY OBRAŻENIAMI:"
"[english]DOTA_Tooltip_ability_pudge_rot_lua_rot_tick"	"ROT TICK:"
"DOTA_Tooltip_ability_pudge_rot_lua_rot_slow"	"SPOWOLNIENIE:"
"[english]DOTA_Tooltip_ability_pudge_rot_lua_rot_slow"	"ROT SLOW:"
"DOTA_Tooltip_ability_pudge_rot_lua_rot_damage"	"OBRAŻENIA:"
"[english]DOTA_Tooltip_ability_pudge_rot_lua_rot_damage"	"ROT DAMAGE:"
"DOTA_Tooltip_ability_custom_frostbite"	"Frostbite"
"[english]DOTA_Tooltip_ability_custom_frostbite"	"Frostbite"
"DOTA_Tooltip_ability_custom_frostbite_Description"	"Zamyka wrogą jednostkę w lodowej powłoce, uniemożliwiając jej poruszanie się oraz atakowanie"
"[english]DOTA_Tooltip_ability_custom_frostbite_Description"	"Encases an enemy unit in ice, prohibiting movement and attack"
"DOTA_Tooltip_ability_custom_frostbite_duration"	"CZAS TRWANIA (BOHATER):"
"[english]DOTA_Tooltip_ability_custom_frostbite_duration"	"HERO DURATION:"
"DOTA_Tooltip_ability_custom_frostbite_creep_duration"	"CZAS TRWANIA (CREEP):"
"[english]DOTA_Tooltip_ability_custom_frostbite_creep_duration"	"CREEP DURATION:"
"DOTA_Tooltip_ability_custom_pudge_meat_hook"	"Meat Hook"
"[english]DOTA_Tooltip_ability_custom_pudge_meat_hook"	"Meat Hook"
"DOTA_Tooltip_ability_custom_pudge_meat_hook_Description"	"
"
"[english]DOTA_Tooltip_ability_custom_pudge_meat_hook_Description"	""
"DOTA_Tooltip_ability_custom_pudge_meat_hook_hook_distance"	"DYSTANS:"
"[english]DOTA_Tooltip_ability_custom_pudge_meat_hook_hook_distance"	"HOOK DISTANCE:"
"DOTA_Tooltip_ability_chain_frost_lua"	"Chain Frost"
"[english]DOTA_Tooltip_ability_chain_frost_lua"	"Chain Frost"
"DOTA_Tooltip_ability_chain_frost_lua_Description"	"
"
"[english]DOTA_Tooltip_ability_chain_frost_lua_Description"	""
"DOTA_Tooltip_ability_chain_frost_lua_slow_duration"	"CZAS TRWANIA SPOWOLNIENIA:"
"[english]DOTA_Tooltip_ability_chain_frost_lua_slow_duration"	"SLOW DURATION:"
"DOTA_Tooltip_ability_chain_frost_lua_slow_movement_speed"	"SPOWOLNIENIE RUCHU:"
"[english]DOTA_Tooltip_ability_chain_frost_lua_slow_movement_speed"	"SLOW MOVEMENT SPEED:"
"DOTA_Tooltip_ability_chain_frost_lua_jump_range"	"ZASIĘG PRZESKOKU:"
"[english]DOTA_Tooltip_ability_chain_frost_lua_jump_range"	"JUMP RANGE:"
"DOTA_Tooltip_ability_chain_frost_lua_projectile_speed"	"SZYBKOŚĆ POCISKU:"
"[english]DOTA_Tooltip_ability_chain_frost_lua_projectile_speed"	"PROJECTILE SPEED:"
"DOTA_Tooltip_ability_chain_frost_lua_damage"	"OBRAŻENIA:"
"[english]DOTA_Tooltip_ability_chain_frost_lua_damage"	"DAMAGE:"
"DOTA_Tooltip_ability_chain_frost_lua_jump_interval"	"CZAS MIĘDZY PRZESKOKAMI:"
"[english]DOTA_Tooltip_ability_chain_frost_lua_jump_interval"	"JUMP INTERVAL:"
"DOTA_Tooltip_ability_aoe_rupture_lua"	"Aoe Rupture"
"[english]DOTA_Tooltip_ability_aoe_rupture_lua"	"Aoe Rupture"
"DOTA_Tooltip_ability_aoe_rupture_lua_Description"	"Rzuca Rupture na wszystkich bohaterów w pobliżu"
"[english]DOTA_Tooltip_ability_aoe_rupture_lua_Description"	"Casts Rupture on all heroes in the vicinity"
"DOTA_Tooltip_ability_aoe_rupture_lua_movement_damage_pct"	"OBRAŻENIA OD RUCHU:"
"[english]DOTA_Tooltip_ability_aoe_rupture_lua_movement_damage_pct"	"MOVEMENT DAMAGE PCT:"
"DOTA_Tooltip_ability_aoe_rupture_lua_damage_cap_interval"	"ODSTĘP LIMITU OBRAŻEŃ:"
"[english]DOTA_Tooltip_ability_aoe_rupture_lua_damage_cap_interval"	"DAMAGE CAP INTERVAL:"
"DOTA_Tooltip_ability_ogreseal_flop"	"Ogreseal Flop"
"[english]DOTA_Tooltip_ability_ogreseal_flop"	"Ogreseal Flop"
"DOTA_Tooltip_ability_ogreseal_flop_Description"	"trach plask trach plask"
"[english]DOTA_Tooltip_ability_ogreseal_flop_Description"	"Flip Flop Flip Flop"
"DOTA_Tooltip_ability_ogreseal_flop_radius"	"PROMIEŃ:"
"[english]DOTA_Tooltip_ability_ogreseal_flop_radius"	"RADIUS:"
"DOTA_Tooltip_ability_ogreseal_flop_damage"	"OBRAŻENIA:"
"[english]DOTA_Tooltip_ability_ogreseal_flop_damage"	"DAMAGE:"
"DOTA_Tooltip_ability_ogreseal_flop_stun_duration"	"CZAS TRWANIA OGŁUSZENIA:"
"[english]DOTA_Tooltip_ability_ogreseal_flop_stun_duration"	"STUN DURATION:"
"DOTA_Tooltip_ability_shukuchi_lua"	"Shukuchi"
"[english]DOTA_Tooltip_ability_shukuchi_lua"	"Shukuchi"
"DOTA_Tooltip_ability_shukuchi_lua_Description"	"Weaver staje się niewidzialny, uzyskując zdolność do poruszania się z maksymalną szybkością."
"[english]DOTA_Tooltip_ability_shukuchi_lua_Description"	"Weaver shifts out of visibility, gaining the ability to move at maximum speed."
"DOTA_Tooltip_ability_shukuchi_lua_move_speed"	"SZYBKOŚĆ RUCHU:"
"[english]DOTA_Tooltip_ability_shukuchi_lua_move_speed"	"MOVE SPEED:"
"DOTA_Tooltip_ability_shukuchi_lua_duration"	"CZAS TRWANIA:"
"[english]DOTA_Tooltip_ability_shukuchi_lua_duration"	"DURATION:"
"DOTA_Tooltip_ability_mirana_arrow_lua"	"Mirana Arrow"
"[english]DOTA_Tooltip_ability_mirana_arrow_lua"	"Mirana Arrow"
"DOTA_Tooltip_ability_mirana_arrow_lua_Description"	"Wystrzeliwuje z zabójczą precyzją strzałę, która zada obrażenia i ogłuszy pierwszego napotkanego wroga. Umiejętność zostaje odnowiona po trafieniu celu."
"[english]DOTA_Tooltip_ability_mirana_arrow_lua_Description"	"Fires a long-range arrow with deadly precision, which stuns and damages the first enemy unit it strikes. Refreshes upon hitting the target."
"DOTA_Tooltip_ability_mirana_arrow_lua_stun_duration"	"CZAS TRWANIA OGŁUSZENIA:"
"[english]DOTA_Tooltip_ability_mirana_arrow_lua_stun_duration"	"STUN DURATION:"
"DOTA_Tooltip_ability_shapeshift_boar_lua"	"Shapeshift Boar"
"[english]DOTA_Tooltip_ability_shapeshift_boar_lua"	"Shapeshift Boar"
"DOTA_Tooltip_ability_shapeshift_boar_lua_Description"	"Przyjmij formę dzika, jednostki walczącej na dystans o przeciętnej wytrzymałości."
"[english]DOTA_Tooltip_ability_shapeshift_boar_lua_Description"	"Take the shape of a Boar, a ranged unit with medium bulk."
"DOTA_Tooltip_ability_shapeshift_boar_lua_transformation_time"	"CZAS TRANSFORMACJI:"
"[english]DOTA_Tooltip_ability_shapeshift_boar_lua_transformation_time"	"TRANSFORMATION TIME:"
"DOTA_Tooltip_ability_shapeshift_bear_lua"	"Shapeshift Bear"
"[english]DOTA_Tooltip_ability_shapeshift_bear_lua"	"Shapeshift Bear"
"DOTA_Tooltip_ability_shapeshift_bear_lua_Description"	"Przyjmij formę niedźwiedzia, jednostki walczącej wręcz o wysokiej wytrzymałości."
"[english]DOTA_Tooltip_ability_shapeshift_bear_lua_Description"	"Take the shape of a bear, a melee unit with high bulk."
"DOTA_Tooltip_ability_shapeshift_bear_lua_transformation_time"	"CZAS TRANSFORMACJI:"
"[english]DOTA_Tooltip_ability_shapeshift_bear_lua_transformation_time"	"TRANSFORMATION TIME:"
"DOTA_Tooltip_ability_shapeshift_hawk_lua"	"Shapeshift Hawk"
"[english]DOTA_Tooltip_ability_shapeshift_hawk_lua"	"Shapeshift Hawk"
"DOTA_Tooltip_ability_shapeshift_hawk_lua_Description"	"Przyjmij formę jastrzębia, jednostki o dużej mobilności bez możliwości atakowania."
"[english]DOTA_Tooltip_ability_shapeshift_hawk_lua_Description"	"Take the form of a hawk, a highly mobile unit with no attack."
"DOTA_Tooltip_ability_shapeshift_hawk_lua_transformation_time"	"CZAS TRANSFORMACJI:"
"[english]DOTA_Tooltip_ability_shapeshift_hawk_lua_transformation_time"	"TRANSFORMATION TIME:"
"DOTA_Tooltip_ability_lion_finger_lua"	"Finger"
"[english]DOTA_Tooltip_ability_lion_finger_lua"	"Finger"
"DOTA_Tooltip_ability_lion_finger_lua_Description"	"Określ w staromodny sposób, czy coś jest tak naprawdę przebranym Monkey Kingiem. Wysadzając to w powietrze."
"[english]DOTA_Tooltip_ability_lion_finger_lua_Description"	"Determine if something is a disguised Monkey King the hard way. By blowing it the heck up."
"DOTA_Tooltip_ability_earth_spirit_kick_lua"	"Kick"
"[english]DOTA_Tooltip_ability_earth_spirit_kick_lua"	"Kick"
"DOTA_Tooltip_ability_earth_spirit_kick_lua_Description"	"Kopnij piłkę. Piłka odbija się od ścian."
"[english]DOTA_Tooltip_ability_earth_spirit_kick_lua_Description"	"Kick the ball. The ball bounces off walls."
"DOTA_Tooltip_ability_earth_spirit_kick_lua_kick_force"	"SIŁA KOPNIĘCIA:"
"[english]DOTA_Tooltip_ability_earth_spirit_kick_lua_kick_force"	"KICK FORCE:"
"DOTA_Tooltip_ability_drow_shoot_arrow_lua"	"Fire Arrow"
"[english]DOTA_Tooltip_ability_drow_shoot_arrow_lua"	"Fire Arrow"
"DOTA_Tooltip_ability_drow_shoot_arrow_lua_Description"	"Wystrzel strzałę w kierunku ziemi, zadając obrażenia wrogom w pobliżu punktu lądowania."
"[english]DOTA_Tooltip_ability_drow_shoot_arrow_lua_Description"	"Shoot an arrow at the ground, damaging enemies at the point of impact."
"DOTA_Tooltip_ability_drow_shoot_arrow_lua_damage"	"OBRAŻENIA:"
"[english]DOTA_Tooltip_ability_drow_shoot_arrow_lua_damage"	"DAMAGE:"
"DOTA_Tooltip_ability_remote_mine_lua"	"Remote Mine"
"[english]DOTA_Tooltip_ability_remote_mine_lua"	"Remote Mine"
"DOTA_Tooltip_ability_remote_mine_lua_Description"	"Powoli traci zdrowie, a następnie eksploduje."
"[english]DOTA_Tooltip_ability_remote_mine_lua_Description"	"Slowly tick down health, and then explode."
"DOTA_Tooltip_ability_remote_mine_lua_damage"	"OBRAŻENIA:"
"[english]DOTA_Tooltip_ability_remote_mine_lua_damage"	"DAMAGE:"
"DOTA_Tooltip_ability_remote_mine_lua_damage_radius"	"PROMIEŃ OBRAŻEŃ:"
"[english]DOTA_Tooltip_ability_remote_mine_lua_damage_radius"	"DAMAGE RADIUS:"
"DOTA_Tooltip_ability_proximity_mine_lua"	"Proximity Mine"
"[english]DOTA_Tooltip_ability_proximity_mine_lua"	"Proximity Mine"
"DOTA_Tooltip_ability_proximity_mine_lua_Description"	"Eksploduje, gdy ktoś do niej podejdzie"
"[english]DOTA_Tooltip_ability_proximity_mine_lua_Description"	"Explode when someone comes near"
"DOTA_Tooltip_ability_proximity_mine_lua_damage"	"OBRAŻENIA:"
"[english]DOTA_Tooltip_ability_proximity_mine_lua_damage"	"DAMAGE:"
"DOTA_Tooltip_ability_proximity_mine_lua_activation_radius"	"PROMIEŃ AKTYWACJI:"
"[english]DOTA_Tooltip_ability_proximity_mine_lua_activation_radius"	"ACTIVATION RADIUS:"
"DOTA_Tooltip_ability_proximity_mine_lua_damage_radius"	"PROMIEŃ OBRAŻEŃ:"
"[english]DOTA_Tooltip_ability_proximity_mine_lua_damage_radius"	"DAMAGE RADIUS:"
"DOTA_Tooltip_ability_stasis_trap_lua"	"Stasis Trap"
"[english]DOTA_Tooltip_ability_stasis_trap_lua"	"Stasis Trap"
"DOTA_Tooltip_ability_stasis_trap_lua_Description"	"Przy aktywacji ogłusza pobliskie jednostki."
"[english]DOTA_Tooltip_ability_stasis_trap_lua_Description"	"Stuns nearby units when triggered."
"DOTA_Tooltip_ability_stasis_trap_lua_stun_duration"	"CZAS TRWANIA OGŁUSZENIA:"
"[english]DOTA_Tooltip_ability_stasis_trap_lua_stun_duration"	"STUN DURATION:"
"DOTA_Tooltip_ability_stasis_trap_lua_activation_radius"	"PROMIEŃ AKTYWACJI:"
"[english]DOTA_Tooltip_ability_stasis_trap_lua_activation_radius"	"ACTIVATION RADIUS:"
"DOTA_Tooltip_ability_stasis_trap_lua_stun_radius"	"PROMIEŃ OGŁUSZENIA:"
"[english]DOTA_Tooltip_ability_stasis_trap_lua_stun_radius"	"STUN RADIUS:"
"DOTA_Tooltip_ability_lightning_bolt_lua"	"Lightning Bolt"
"[english]DOTA_Tooltip_ability_lightning_bolt_lua"	"Lightning Bolt"
"DOTA_Tooltip_ability_lightning_bolt_lua_Description"	"Zapewnia na obszarze efekt True Sight na krótki czas."
"[english]DOTA_Tooltip_ability_lightning_bolt_lua_Description"	"Gain true sight in an area for a short period of tiem."
"DOTA_Tooltip_ability_lightning_bolt_lua_true_sight_radius"	"PROMIEŃ TRUE SIGHT:"
"[english]DOTA_Tooltip_ability_lightning_bolt_lua_true_sight_radius"	"TRUE SIGHT RADIUS:"
"DOTA_Tooltip_ability_lightning_bolt_lua_true_sight_duration"	"CZAS TRWANIA TRUE SIGHT:"
"[english]DOTA_Tooltip_ability_lightning_bolt_lua_true_sight_duration"	"TRUE SIGHT DURATION:"
"DOTA_Tooltip_ability_heartstopper_aura_lua"	"Heartstopper Aura"
"[english]DOTA_Tooltip_ability_heartstopper_aura_lua"	"Heartstopper Aura"
"DOTA_Tooltip_ability_heartstopper_aura_lua_Description"	"Necrophos wstrzymuje pracę serc swoich przeciwników, powodując, że pobliskie wrogie jednostki wraz z upływem otrzymują obrażenia."
"[english]DOTA_Tooltip_ability_heartstopper_aura_lua_Description"	"Necrophos stills the hearts of his opponents, causing nearby enemy units to take damage over time."
"DOTA_Tooltip_ability_heartstopper_aura_lua_damage_per_tick"	"OBRAŻENIA OKRESOWE:"
"[english]DOTA_Tooltip_ability_heartstopper_aura_lua_damage_per_tick"	"DAMAGE PER TICK:"
"DOTA_Tooltip_ability_heartstopper_aura_lua_tick_rate"	"CZĘSTOTLIWOŚĆ OBRAŻEŃ:"
"[english]DOTA_Tooltip_ability_heartstopper_aura_lua_tick_rate"	"TICK RATE:"
"DOTA_Tooltip_ability_custom_shredder_whirling_death"	"Shredder Whirling Death"
"[english]DOTA_Tooltip_ability_custom_shredder_whirling_death"	"Shredder Whirling Death"
"DOTA_Tooltip_ability_custom_shredder_whirling_death_Description"	"
"
"[english]DOTA_Tooltip_ability_custom_shredder_whirling_death_Description"	""
"DOTA_Tooltip_ability_custom_shredder_whirling_death_whirling_radius"	"PROMIEŃ:"
"[english]DOTA_Tooltip_ability_custom_shredder_whirling_death_whirling_radius"	"WHIRLING RADIUS:"
"DOTA_Tooltip_ability_custom_shredder_whirling_death_whirling_damage"	"OBRAŻENIA:"
"[english]DOTA_Tooltip_ability_custom_shredder_whirling_death_whirling_damage"	"WHIRLING DAMAGE:"
"DOTA_Tooltip_ability_custom_shredder_whirling_death_whirling_tick"	"ODSTĘP MIĘDZY OBRAŻENIAMI:"
"[english]DOTA_Tooltip_ability_custom_shredder_whirling_death_whirling_tick"	"WHIRLING TICK:"
"DOTA_Tooltip_ability_custom_shredder_whirling_death_stat_loss_pct"	"PROCENT UTRATY ATRYBUTU:"
"[english]DOTA_Tooltip_ability_custom_shredder_whirling_death_stat_loss_pct"	"STAT LOSS PCT:"
"DOTA_Tooltip_ability_custom_shredder_whirling_death_LinkedSpecialBonus"	"LINKEDSPECIALBONUS:"
"[english]DOTA_Tooltip_ability_custom_shredder_whirling_death_LinkedSpecialBonus"	"LINKEDSPECIALBONUS:"
"DOTA_Tooltip_ability_custom_shredder_whirling_death_duration"	"CZAS TRWANIA:"
"[english]DOTA_Tooltip_ability_custom_shredder_whirling_death_duration"	"DURATION:"
"DOTA_Tooltip_ability_custom_shredder_timber_chain"	"Shredder Timber Chain"
"[english]DOTA_Tooltip_ability_custom_shredder_timber_chain"	"Shredder Timber Chain"
"DOTA_Tooltip_ability_custom_shredder_timber_chain_Description"	"
"
"[english]DOTA_Tooltip_ability_custom_shredder_timber_chain_Description"	""
"DOTA_Tooltip_ability_custom_shredder_timber_chain_chain_radius"	"PROMIEŃ:"
"[english]DOTA_Tooltip_ability_custom_shredder_timber_chain_chain_radius"	"CHAIN RADIUS:"
"DOTA_Tooltip_ability_custom_shredder_timber_chain_range"	"ZASIĘG:"
"[english]DOTA_Tooltip_ability_custom_shredder_timber_chain_range"	"RANGE:"
"DOTA_Tooltip_ability_custom_shredder_timber_chain_radius"	"PROMIEŃ:"
"[english]DOTA_Tooltip_ability_custom_shredder_timber_chain_radius"	"RADIUS:"
"DOTA_Tooltip_ability_custom_shredder_timber_chain_speed"	"SZYBKOŚĆ:"
"[english]DOTA_Tooltip_ability_custom_shredder_timber_chain_speed"	"SPEED:"
"DOTA_Tooltip_ability_custom_shredder_timber_chain_damage"	"OBRAŻENIA:"
"[english]DOTA_Tooltip_ability_custom_shredder_timber_chain_damage"	"DAMAGE:"
"DOTA_Tooltip_ability_custom_shredder_chakram"	"Shredder Chakram"
"[english]DOTA_Tooltip_ability_custom_shredder_chakram"	"Shredder Chakram"
"DOTA_Tooltip_ability_custom_shredder_chakram_Description"	"
"
"[english]DOTA_Tooltip_ability_custom_shredder_chakram_Description"	""
"DOTA_Tooltip_ability_custom_shredder_chakram_speed"	"SZYBKOŚĆ:"
"[english]DOTA_Tooltip_ability_custom_shredder_chakram_speed"	"SPEED:"
"DOTA_Tooltip_ability_custom_shredder_chakram_radius"	"PROMIEŃ:"
"[english]DOTA_Tooltip_ability_custom_shredder_chakram_radius"	"RADIUS:"
"DOTA_Tooltip_ability_custom_shredder_chakram_pass_damage"	"OBRAŻENIA PODCZAS LOTU:"
"[english]DOTA_Tooltip_ability_custom_shredder_chakram_pass_damage"	"PASS DAMAGE:"
"DOTA_Tooltip_ability_custom_shredder_chakram_damage_per_second"	"OBRAŻENIA NA SEKUNDĘ:"
"[english]DOTA_Tooltip_ability_custom_shredder_chakram_damage_per_second"	"DAMAGE PER SECOND:"
"DOTA_Tooltip_ability_custom_shredder_chakram_slow"	"SPOWOLNIENIE:"
"[english]DOTA_Tooltip_ability_custom_shredder_chakram_slow"	"SLOW:"
"DOTA_Tooltip_ability_custom_shredder_chakram_damage_interval"	"ODSTĘP POMIĘDZY OBRAŻENIAMI:"
"[english]DOTA_Tooltip_ability_custom_shredder_chakram_damage_interval"	"DAMAGE INTERVAL:"
"DOTA_Tooltip_ability_custom_shredder_chakram_break_distance"	"DYSTANS DO PRZERWANIA:"
"[english]DOTA_Tooltip_ability_custom_shredder_chakram_break_distance"	"BREAK DISTANCE:"
"DOTA_Tooltip_ability_custom_shredder_chakram_mana_per_second"	"MANA NA SEKUNDĘ:"
"[english]DOTA_Tooltip_ability_custom_shredder_chakram_mana_per_second"	"MANA PER SECOND:"
"DOTA_Tooltip_ability_custom_shredder_chakram_pass_slow_duration"	"CZAS TRW. SPOW. PRZY PRZELOCIE:"
"[english]DOTA_Tooltip_ability_custom_shredder_chakram_pass_slow_duration"	"PASS SLOW DURATION:"
"DOTA_Tooltip_ability_custom_nether_swap"	"Nether Swap"
"[english]DOTA_Tooltip_ability_custom_nether_swap"	"Nether Swap"
"DOTA_Tooltip_ability_custom_nether_swap_Description"	"Zamień się miejscami z celem."
"[english]DOTA_Tooltip_ability_custom_nether_swap_Description"	"Swap places with the target."
"DOTA_Tooltip_ability_custom_nether_swap_tooltip_range"	"ZASIĘG:"
"[english]DOTA_Tooltip_ability_custom_nether_swap_tooltip_range"	"TOOLTIP RANGE:"
"DOTA_Tooltip_ability_custom_nether_swap_nether_swap_cooldown_scepter"	"CZAS OCZEKIWANIA (SCEPTER):"
"[english]DOTA_Tooltip_ability_custom_nether_swap_nether_swap_cooldown_scepter"	"NETHER SWAP COOLDOWN SCEPTER:"
"DOTA_Tooltip_ability_custom_nether_swap_illusion_damage_out_pct_scepter"	"OBRAŻENIA OD ILUZJI (SCEPTER):"
"[english]DOTA_Tooltip_ability_custom_nether_swap_illusion_damage_out_pct_scepter"	"ILLUSION DAMAGE OUT PCT SCEPTER:"
"DOTA_Tooltip_ability_custom_nether_swap_illusion_damage_in_pct_scepter"	"OBRAŻENIA ZADAWANE ILUZJI (SCEPTER):"
"[english]DOTA_Tooltip_ability_custom_nether_swap_illusion_damage_in_pct_scepter"	"ILLUSION DAMAGE IN PCT SCEPTER:"
"DOTA_Tooltip_ability_custom_puck_phase_shift"	"Niestandardowy Phase Shift"
"[english]DOTA_Tooltip_ability_custom_puck_phase_shift"	"Custom Puck Phase Shift"
"DOTA_Tooltip_ability_custom_puck_phase_shift_Description"	"Puck na krótką chwilę przeskakuje do innego wymiaru, gdzie nic nie może mu zagrozić."
"[english]DOTA_Tooltip_ability_custom_puck_phase_shift_Description"	"Puck briefly shifts into another dimension where it is immune from harm."
"DOTA_Tooltip_ability_custom_puck_phase_shift_duration"	"CZAS TRWANIA:"
"[english]DOTA_Tooltip_ability_custom_puck_phase_shift_duration"	"DURATION:"
"DOTA_Tooltip_ability_ogre_tank_melee_smash"	"Smash"
"[english]DOTA_Tooltip_ability_ogre_tank_melee_smash"	"Smash"
"DOTA_Tooltip_ability_ogre_tank_melee_smash_Description"	"ROZWAAALIĆ"
"[english]DOTA_Tooltip_ability_ogre_tank_melee_smash_Description"	"SMAAAAASH"
"DOTA_Tooltip_ability_ogre_tank_melee_smash_impact_radius"	"PROMIEŃ UDERZENIA:"
"[english]DOTA_Tooltip_ability_ogre_tank_melee_smash_impact_radius"	"IMPACT RADIUS:"
"DOTA_Tooltip_ability_ogre_tank_melee_smash_stun_duration"	"CZAS TRWANIA OGŁUSZENIA:"
"[english]DOTA_Tooltip_ability_ogre_tank_melee_smash_stun_duration"	"STUN DURATION:"
"DOTA_Tooltip_ability_ogre_tank_melee_smash_damage"	"OBRAŻENIA:"
"[english]DOTA_Tooltip_ability_ogre_tank_melee_smash_damage"	"DAMAGE:"
"DOTA_Tooltip_ability_ogre_tank_melee_smash_base_swing_speed"	"BAZOWA SZYBKOŚĆ ZAMACHNIĘCIA:"
"[english]DOTA_Tooltip_ability_ogre_tank_melee_smash_base_swing_speed"	"BASE SWING SPEED:"
"DOTA_Tooltip_ability_ogre_tank_jump_smash"	"Jump Smash"
"[english]DOTA_Tooltip_ability_ogre_tank_jump_smash"	"Jump Smash"
"DOTA_Tooltip_ability_ogre_tank_jump_smash_Description"	"SKOOOOOOOOK"
"[english]DOTA_Tooltip_ability_ogre_tank_jump_smash_Description"	"JUUUUUUUUMP"
"DOTA_Tooltip_ability_ogre_tank_jump_smash_impact_radius"	"PROMIEŃ UDERZENIA:"
"[english]DOTA_Tooltip_ability_ogre_tank_jump_smash_impact_radius"	"IMPACT RADIUS:"
"DOTA_Tooltip_ability_ogre_tank_jump_smash_stun_duration"	"CZAS TRWANIA OGŁUSZENIA:"
"[english]DOTA_Tooltip_ability_ogre_tank_jump_smash_stun_duration"	"STUN DURATION:"
"DOTA_Tooltip_ability_ogre_tank_jump_smash_damage"	"OBRAŻENIA:"
"[english]DOTA_Tooltip_ability_ogre_tank_jump_smash_damage"	"DAMAGE:"
"DOTA_Tooltip_ability_ogre_tank_jump_smash_jump_speed"	"SZYBKOŚĆ SKOKU:"
"[english]DOTA_Tooltip_ability_ogre_tank_jump_smash_jump_speed"	"JUMP SPEED:"
"DOTA_Tooltip_ability_ogre_tank_boss_melee_smash"	"Smash"
"[english]DOTA_Tooltip_ability_ogre_tank_boss_melee_smash"	"Smash"
"DOTA_Tooltip_ability_ogre_tank_boss_melee_smash_Description"	"ROZWALAAAAAAAAAAAAAAAAAAAĆ"
"[english]DOTA_Tooltip_ability_ogre_tank_boss_melee_smash_Description"	"SMAAAAAAAAAAAAAAAAAAAAASH"
"DOTA_Tooltip_ability_ogre_tank_boss_melee_smash_impact_radius"	"PROMIEŃ UDERZENIA:"
"[english]DOTA_Tooltip_ability_ogre_tank_boss_melee_smash_impact_radius"	"IMPACT RADIUS:"
"DOTA_Tooltip_ability_ogre_tank_boss_melee_smash_stun_duration"	"CZAS TRWANIA OGŁUSZENIA:"
"[english]DOTA_Tooltip_ability_ogre_tank_boss_melee_smash_stun_duration"	"STUN DURATION:"
"DOTA_Tooltip_ability_ogre_tank_boss_melee_smash_damage"	"OBRAŻENIA:"
"[english]DOTA_Tooltip_ability_ogre_tank_boss_melee_smash_damage"	"DAMAGE:"
"DOTA_Tooltip_ability_ogre_tank_boss_melee_smash_base_swing_speed"	"BAZOWA SZYBKOŚĆ ZAMACHNIĘCIA:"
"[english]DOTA_Tooltip_ability_ogre_tank_boss_melee_smash_base_swing_speed"	"BASE SWING SPEED:"
"DOTA_Tooltip_ability_ogre_tank_boss_jump_smash"	"Jump Smash"
"[english]DOTA_Tooltip_ability_ogre_tank_boss_jump_smash"	"Jump Smash"
"DOTA_Tooltip_ability_ogre_tank_boss_jump_smash_Description"	"SKAAAAAAAAAAAAAAAAAAAAAAAAAACZ"
"[english]DOTA_Tooltip_ability_ogre_tank_boss_jump_smash_Description"	"JUUUUUUUUUUUUUUUUUUUUUUUUUMP"
"DOTA_Tooltip_ability_ogre_tank_boss_jump_smash_impact_radius"	"PROMIEŃ UDERZENIA:"
"[english]DOTA_Tooltip_ability_ogre_tank_boss_jump_smash_impact_radius"	"IMPACT RADIUS:"
"DOTA_Tooltip_ability_ogre_tank_boss_jump_smash_stun_duration"	"CZAS TRWANIA OGŁUSZENIA:"
"[english]DOTA_Tooltip_ability_ogre_tank_boss_jump_smash_stun_duration"	"STUN DURATION:"
"DOTA_Tooltip_ability_ogre_tank_boss_jump_smash_damage"	"OBRAŻENIA:"
"[english]DOTA_Tooltip_ability_ogre_tank_boss_jump_smash_damage"	"DAMAGE:"
"DOTA_Tooltip_ability_ogre_tank_boss_jump_smash_jump_speed"	"SZYBKOŚĆ SKOKU:"
"[english]DOTA_Tooltip_ability_ogre_tank_boss_jump_smash_jump_speed"	"JUMP SPEED:"
"DOTA_Tooltip_ability_conjure_image_lua"	"Conjure Image"
"[english]DOTA_Tooltip_ability_conjure_image_lua"	"Conjure Image"
"DOTA_Tooltip_ability_conjure_image_lua_Description"	"
"
"[english]DOTA_Tooltip_ability_conjure_image_lua_Description"	""
"DOTA_Tooltip_ability_conjure_image_lua_illusion_duration"	"CZAS TRWANIA ILUZJI:"
"[english]DOTA_Tooltip_ability_conjure_image_lua_illusion_duration"	"ILLUSION DURATION:"
"DOTA_Tooltip_ability_conjure_image_lua_illusion_incoming_damage"	"OBRAŻENIA ZADAWANE ILUZJI:"
"[english]DOTA_Tooltip_ability_conjure_image_lua_illusion_incoming_damage"	"ILLUSION INCOMING DAMAGE:"
"DOTA_Tooltip_ability_race_charge_lua"	"Charge"
"[english]DOTA_Tooltip_ability_race_charge_lua"	"Charge"
"DOTA_Tooltip_ability_race_charge_lua_Description"	"
"
"[english]DOTA_Tooltip_ability_race_charge_lua_Description"	""
"DOTA_Tooltip_ability_race_charge_lua_distance"	"DYSTANS:"
"[english]DOTA_Tooltip_ability_race_charge_lua_distance"	"DISTANCE:"
"DOTA_Tooltip_ability_invoker_quas_lua"	"Quas"
"[english]DOTA_Tooltip_ability_invoker_quas_lua"	"Quas"
"DOTA_Tooltip_ability_invoker_quas_lua_Description"	"
"
"[english]DOTA_Tooltip_ability_invoker_quas_lua_Description"	""
"DOTA_Tooltip_ability_invoker_wex_lua"	"Wex"
"[english]DOTA_Tooltip_ability_invoker_wex_lua"	"Wex"
"DOTA_Tooltip_ability_invoker_wex_lua_Description"	"
"
"[english]DOTA_Tooltip_ability_invoker_wex_lua_Description"	""
"DOTA_Tooltip_ability_invoker_exort_lua"	"Exort"
"[english]DOTA_Tooltip_ability_invoker_exort_lua"	"Exort"
"DOTA_Tooltip_ability_invoker_exort_lua_Description"	"
"
"[english]DOTA_Tooltip_ability_invoker_exort_lua_Description"	""
"DOTA_Tooltip_ability_invoker_invoke_lua"	"Invoke"
"[english]DOTA_Tooltip_ability_invoker_invoke_lua"	"Invoke"
"DOTA_Tooltip_ability_invoker_invoke_lua_Description"	"
"
"[english]DOTA_Tooltip_ability_invoker_invoke_lua_Description"	""
"DOTA_Tooltip_ability_cold_snap_passive"	"Cold Snap"
"[english]DOTA_Tooltip_ability_cold_snap_passive"	"Cold Snap"
"DOTA_Tooltip_ability_cold_snap_passive_Description"	"
"
"[english]DOTA_Tooltip_ability_cold_snap_passive_Description"	""
"DOTA_Tooltip_ability_ghost_walk_passive"	"Ghost Walk"
"[english]DOTA_Tooltip_ability_ghost_walk_passive"	"Ghost Walk"
"DOTA_Tooltip_ability_ghost_walk_passive_Description"	"
"
"[english]DOTA_Tooltip_ability_ghost_walk_passive_Description"	""
"DOTA_Tooltip_ability_ice_wall_passive"	"Ice Wall"
"[english]DOTA_Tooltip_ability_ice_wall_passive"	"Ice Wall"
"DOTA_Tooltip_ability_ice_wall_passive_Description"	"
"
"[english]DOTA_Tooltip_ability_ice_wall_passive_Description"	""
"DOTA_Tooltip_ability_deafening_blast_passive"	"Deafening Blast"
"[english]DOTA_Tooltip_ability_deafening_blast_passive"	"Deafening Blast"
"DOTA_Tooltip_ability_deafening_blast_passive_Description"	"
"
"[english]DOTA_Tooltip_ability_deafening_blast_passive_Description"	""
"DOTA_Tooltip_ability_emp_passive"	"E.M.P."
"[english]DOTA_Tooltip_ability_emp_passive"	"Emp"
"DOTA_Tooltip_ability_emp_passive_Description"	"
"
"[english]DOTA_Tooltip_ability_emp_passive_Description"	""
"DOTA_Tooltip_ability_tornado_passive"	"Tornado"
"[english]DOTA_Tooltip_ability_tornado_passive"	"Tornado"
"DOTA_Tooltip_ability_tornado_passive_Description"	"
"
"[english]DOTA_Tooltip_ability_tornado_passive_Description"	""
"DOTA_Tooltip_ability_chaos_meteor_passive"	"Chaos Meteor"
"[english]DOTA_Tooltip_ability_chaos_meteor_passive"	"Chaos Meteor"
"DOTA_Tooltip_ability_chaos_meteor_passive_Description"	"
"
"[english]DOTA_Tooltip_ability_chaos_meteor_passive_Description"	""
"DOTA_Tooltip_ability_sunstrike_passive"	"Sunstrike"
"[english]DOTA_Tooltip_ability_sunstrike_passive"	"Sunstrike"
"DOTA_Tooltip_ability_sunstrike_passive_Description"	"
"
"[english]DOTA_Tooltip_ability_sunstrike_passive_Description"	""
"DOTA_Tooltip_ability_forge_spirit_passive"	"Forge Spirit"
"[english]DOTA_Tooltip_ability_forge_spirit_passive"	"Forge Spirit"
"DOTA_Tooltip_ability_forge_spirit_passive_Description"	"
"
"[english]DOTA_Tooltip_ability_forge_spirit_passive_Description"	""
"DOTA_Tooltip_ability_alacrity_passive"	"Alacrity"
"[english]DOTA_Tooltip_ability_alacrity_passive"	"Alacrity"
"DOTA_Tooltip_ability_alacrity_passive_Description"	"
"
"[english]DOTA_Tooltip_ability_alacrity_passive_Description"	""
"DOTA_Tooltip_ability_invoker_leader_tornado"	"Tornado"
"[english]DOTA_Tooltip_ability_invoker_leader_tornado"	"Tornado"
"DOTA_Tooltip_ability_invoker_leader_tornado_Description"	"
"
"[english]DOTA_Tooltip_ability_invoker_leader_tornado_Description"	""
"DOTA_Tooltip_ability_invoker_leader_deafening_blast"	"Deafening Blast"
"[english]DOTA_Tooltip_ability_invoker_leader_deafening_blast"	"Deafening Blast"
"DOTA_Tooltip_ability_invoker_leader_deafening_blast_Description"	"
"
"[english]DOTA_Tooltip_ability_invoker_leader_deafening_blast_Description"	""
"DOTA_Tooltip_ability_invoker_leader_sunstrike"	"Sunstrike"
"[english]DOTA_Tooltip_ability_invoker_leader_sunstrike"	"Sunstrike"
"DOTA_Tooltip_ability_invoker_leader_sunstrike_Description"	"
"
"[english]DOTA_Tooltip_ability_invoker_leader_sunstrike_Description"	""
"DOTA_Tooltip_ability_invoker_leader_sunstrike_delay"	"OPÓŹNIENIE:"
"[english]DOTA_Tooltip_ability_invoker_leader_sunstrike_delay"	"DELAY:"
"DOTA_Tooltip_ability_invoker_leader_sunstrike_area_of_effect"	"PROMIEŃ:"
"[english]DOTA_Tooltip_ability_invoker_leader_sunstrike_area_of_effect"	"AREA OF EFFECT:"
"DOTA_Tooltip_ability_invoker_leader_chaos_meteor"	"Invoker Leader Chaos Meteor"
"[english]DOTA_Tooltip_ability_invoker_leader_chaos_meteor"	"Invoker Leader Chaos Meteor"
"DOTA_Tooltip_ability_invoker_leader_chaos_meteor_Description"	"
"
"[english]DOTA_Tooltip_ability_invoker_leader_chaos_meteor_Description"	""
"DOTA_Tooltip_ability_invoker_leader_ice_wall"	"Ice Wall"
"[english]DOTA_Tooltip_ability_invoker_leader_ice_wall"	"Ice Wall"
"DOTA_Tooltip_ability_invoker_leader_ice_wall_Description"	"
"
"[english]DOTA_Tooltip_ability_invoker_leader_ice_wall_Description"	""
"DOTA_Tooltip_ability_invoker_leader_ice_wall_duration"	"CZAS TRWANIA:"
"[english]DOTA_Tooltip_ability_invoker_leader_ice_wall_duration"	"DURATION:"
"DOTA_Tooltip_ability_invoker_leader_emp"	"E.M.P."
"[english]DOTA_Tooltip_ability_invoker_leader_emp"	"Emp"
"DOTA_Tooltip_ability_invoker_leader_emp_Description"	"
"
"[english]DOTA_Tooltip_ability_invoker_leader_emp_Description"	""
"DOTA_Tooltip_ability_invoker_leader_emp_delay"	"OPÓŹNIENIE:"
"[english]DOTA_Tooltip_ability_invoker_leader_emp_delay"	"DELAY:"
"DOTA_Tooltip_ability_invoker_leader_emp_area_of_effect"	"PROMIEŃ:"
"[english]DOTA_Tooltip_ability_invoker_leader_emp_area_of_effect"	"AREA OF EFFECT:"
"DOTA_Tooltip_ability_invoker_leader_alacrity"	"Alacrity"
"[english]DOTA_Tooltip_ability_invoker_leader_alacrity"	"Alacrity"
"DOTA_Tooltip_ability_invoker_leader_alacrity_Description"	"
"
"[english]DOTA_Tooltip_ability_invoker_leader_alacrity_Description"	""
"DOTA_Tooltip_ability_invoker_leader_alacrity_bonus_attack_speed"	"PREMIA DO SZYBKOŚCI ATAKU:"
"[english]DOTA_Tooltip_ability_invoker_leader_alacrity_bonus_attack_speed"	"BONUS ATTACK SPEED:"
"DOTA_Tooltip_ability_invoker_leader_alacrity_bonus_damage"	"PREMIA DO OBRAŻEŃ:"
"[english]DOTA_Tooltip_ability_invoker_leader_alacrity_bonus_damage"	"BONUS DAMAGE:"
"DOTA_Tooltip_ability_invoker_leader_alacrity_duration"	"CZAS TRWANIA:"
"[english]DOTA_Tooltip_ability_invoker_leader_alacrity_duration"	"DURATION:"
"DOTA_Tooltip_ability_invoker_leader_forge_spirit"	"Forge Spirit"
"[english]DOTA_Tooltip_ability_invoker_leader_forge_spirit"	"Forge Spirit"
"DOTA_Tooltip_ability_invoker_leader_forge_spirit_Description"	"
"
"[english]DOTA_Tooltip_ability_invoker_leader_forge_spirit_Description"	""
"DOTA_Tooltip_ability_invoker_leader_forge_spirit_duration"	"CZAS TRWANIA:"
"[english]DOTA_Tooltip_ability_invoker_leader_forge_spirit_duration"	"DURATION:"
"DOTA_Tooltip_ability_invoker_leader_cold_snap"	"Cold Snap"
"[english]DOTA_Tooltip_ability_invoker_leader_cold_snap"	"Cold Snap"
"DOTA_Tooltip_ability_invoker_leader_cold_snap_Description"	"
"
"[english]DOTA_Tooltip_ability_invoker_leader_cold_snap_Description"	""
"DOTA_Tooltip_ability_invoker_leader_cold_snap_duration"	"CZAS TRWANIA:"
"[english]DOTA_Tooltip_ability_invoker_leader_cold_snap_duration"	"DURATION:"
"DOTA_Tooltip_ability_invoker_leader_invoke"	"Invoke"
"[english]DOTA_Tooltip_ability_invoker_leader_invoke"	"Invoke"
"DOTA_Tooltip_ability_invoker_leader_invoke_Description"	"
"
"[english]DOTA_Tooltip_ability_invoker_leader_invoke_Description"	""
"DOTA_Tooltip_ability_tombstone_spawn_zombies_lua"	"Spawn Zombies"
"[english]DOTA_Tooltip_ability_tombstone_spawn_zombies_lua"	"Spawn Zombies"
"DOTA_Tooltip_ability_tombstone_spawn_zombies_lua_Description"	"
"
"[english]DOTA_Tooltip_ability_tombstone_spawn_zombies_lua_Description"	""
"DOTA_Tooltip_ability_tombstone_spawn_zombies_lua_spawn_delay"	"OPÓŹNIENIE POJAWIANIA:"
"[english]DOTA_Tooltip_ability_tombstone_spawn_zombies_lua_spawn_delay"	"SPAWN DELAY:"
"DOTA_Tooltip_ability_tombstone_spawn_zombies_lua_num_to_spawn"	"LICZBA DO PRZYZWANIA:"
"[english]DOTA_Tooltip_ability_tombstone_spawn_zombies_lua_num_to_spawn"	"NUM TO SPAWN:"
"DOTA_Tooltip_ability_tombstone_spawn_zombies_lua_max_spawned"	"MAKS. LICZBA PRZYZWANYCH:"
"[english]DOTA_Tooltip_ability_tombstone_spawn_zombies_lua_max_spawned"	"MAX SPAWNED:"
"DOTA_Tooltip_ability_sniper_ground_shot_lua"	"Ground Shot"
"[english]DOTA_Tooltip_ability_sniper_ground_shot_lua"	"Ground Shot"
"DOTA_Tooltip_ability_sniper_ground_shot_lua_Description"	"Wystrzeliwuje kulę, która przebija się przez wrogów, zadając poważne obrażenia"
"[english]DOTA_Tooltip_ability_sniper_ground_shot_lua_Description"	"Fires a bullet that pierces through enemies, dealing high damage"
"DOTA_Tooltip_ability_sniper_ground_shot_lua_damage"	"OBRAŻENIA:"
"[english]DOTA_Tooltip_ability_sniper_ground_shot_lua_damage"	"DAMAGE:"
"DOTA_Tooltip_ability_furion_teleport_lua"	"Teleport"
"[english]DOTA_Tooltip_ability_furion_teleport_lua"	"Teleport"
"DOTA_Tooltip_ability_furion_teleport_lua_Description"	"Teleportuje do dowolnego punktu na arenie."
"[english]DOTA_Tooltip_ability_furion_teleport_lua_Description"	"Teleports to any point in the arena."
"DOTA_Tooltip_ability_greater_bash_lua"	"Greater Bash"
"[english]DOTA_Tooltip_ability_greater_bash_lua"	"Greater Bash"
"DOTA_Tooltip_ability_greater_bash_lua_Description"	"
"
"[english]DOTA_Tooltip_ability_greater_bash_lua_Description"	""
"DOTA_Tooltip_ability_greater_bash_lua_damage"	"OBRAŻENIA:"
"[english]DOTA_Tooltip_ability_greater_bash_lua_damage"	"DAMAGE:"
"DOTA_Tooltip_ability_greater_bash_lua_knockback_distance"	"DYSTANS ODRZUCENIA:"
"[english]DOTA_Tooltip_ability_greater_bash_lua_knockback_distance"	"KNOCKBACK DISTANCE:"
"DOTA_Tooltip_ability_arcane_bolt_lua"	"Arcane Bolt"
"[english]DOTA_Tooltip_ability_arcane_bolt_lua"	"Arcane Bolt"
"DOTA_Tooltip_ability_arcane_bolt_lua_Description"	"Wystrzeliwuje pocisk magicznych obrażeń, który podąża za swoim celem."
"[english]DOTA_Tooltip_ability_arcane_bolt_lua_Description"	"Fires a bolt of magical damage that follows its target."
"DOTA_Tooltip_ability_arcane_bolt_lua_damage"	"OBRAŻENIA:"
"[english]DOTA_Tooltip_ability_arcane_bolt_lua_damage"	"DAMAGE:"
"DOTA_Tooltip_ability_custom_boar_poison"	"Poison"
"[english]DOTA_Tooltip_ability_custom_boar_poison"	"Poison"
"DOTA_Tooltip_ability_custom_boar_poison_Description"	"
"
"[english]DOTA_Tooltip_ability_custom_boar_poison_Description"	""
"DOTA_Tooltip_ability_custom_boar_poison_attack_speed"	"SZYBKOŚĆ ATAKU:"
"[english]DOTA_Tooltip_ability_custom_boar_poison_attack_speed"	"ATTACK SPEED:"
"DOTA_Tooltip_ability_custom_boar_poison_movement_speed"	"SZYBKOŚĆ RUCHU:"
"[english]DOTA_Tooltip_ability_custom_boar_poison_movement_speed"	"MOVEMENT SPEED:"
"DOTA_Tooltip_ability_custom_boar_poison_duration"	"CZAS TRWANIA:"
"[english]DOTA_Tooltip_ability_custom_boar_poison_duration"	"DURATION:"
"DOTA_Tooltip_ability_lone_druid_rabid_lua"	"Rabid"
"[english]DOTA_Tooltip_ability_lone_druid_rabid_lua"	"Rabid"
"DOTA_Tooltip_ability_lone_druid_rabid_lua_Description"	"Dodaje obrażenia od ataku i pancerz, a także na krótki czas zapewnia odporność na magię."
"[english]DOTA_Tooltip_ability_lone_druid_rabid_lua_Description"	"Adds attack damage and armor, and also becomes magic immune for a short duration."
"DOTA_Tooltip_ability_lone_druid_rabid_lua_bonus_move_speed"	"PREMIA DO SZYBKOŚCI RUCHU:"
"[english]DOTA_Tooltip_ability_lone_druid_rabid_lua_bonus_move_speed"	"BONUS MOVE SPEED:"
"DOTA_Tooltip_ability_lone_druid_rabid_lua_bonus_attack_speed"	"PREMIA DO SZYBKOŚCI ATAKU:"
"[english]DOTA_Tooltip_ability_lone_druid_rabid_lua_bonus_attack_speed"	"BONUS ATTACK SPEED:"
"DOTA_Tooltip_ability_lone_druid_rabid_lua_duration"	"CZAS TRWANIA:"
"[english]DOTA_Tooltip_ability_lone_druid_rabid_lua_duration"	"DURATION:"
"DOTA_Tooltip_ability_custom_entangling_roots"	"Entangling Roots"
"[english]DOTA_Tooltip_ability_custom_entangling_roots"	"Entangling Roots"
"DOTA_Tooltip_ability_custom_entangling_roots_Description"	"Ataki mają szansę na spowodowanie rozrostu korzeni unieruchamiających atakowaną wrogą jednostkę i zadających obrażenia na sekundę."
"[english]DOTA_Tooltip_ability_custom_entangling_roots_Description"	"Attacks have a chance to cause roots to burst from the ground, immobilizing the attacked enemy unit, and dealing damage per second."
"DOTA_Tooltip_ability_custom_entangling_roots_entangle_chance"	"SZANSA NA ENTANGLE:"
"[english]DOTA_Tooltip_ability_custom_entangling_roots_entangle_chance"	"ENTANGLE CHANCE:"
"DOTA_Tooltip_ability_custom_entangling_roots_hero_duration"	"CZAS TRWANIA:"
"[english]DOTA_Tooltip_ability_custom_entangling_roots_hero_duration"	"DURATION:"
"DOTA_Tooltip_ability_place_land_mine_lua"	"Place Land Mine Lua"
"[english]DOTA_Tooltip_ability_place_land_mine_lua"	"Place Land Mine Lua"
"DOTA_Tooltip_ability_place_land_mine_lua_Description"	"Umieść minę lądową, która eksploduje przy kontakcie z wrogiem."
"[english]DOTA_Tooltip_ability_place_land_mine_lua_Description"	"Place a Land Mine that explodes upon contact with an enemy."
"DOTA_Tooltip_ability_place_land_mine_lua_damage"	"OBRAŻENIA:"
"[english]DOTA_Tooltip_ability_place_land_mine_lua_damage"	"DAMAGE:"
"DOTA_Tooltip_ability_place_land_mine_lua_activation_radius"	"PROMIEŃ AKTYWACJI:"
"[english]DOTA_Tooltip_ability_place_land_mine_lua_activation_radius"	"ACTIVATION RADIUS:"
"DOTA_Tooltip_ability_place_land_mine_lua_damage_radius"	"PROMIEŃ OBRAŻEŃ:"
"[english]DOTA_Tooltip_ability_place_land_mine_lua_damage_radius"	"DAMAGE RADIUS:"
"DOTA_Tooltip_ability_custom_overpower"	"Overpower"
"[english]DOTA_Tooltip_ability_custom_overpower"	"Overpower"
"DOTA_Tooltip_ability_custom_overpower_Description"	"Używając swych zdolności bitewnych, Ursa zyskuje zwiększoną szybkość ataku na pewną liczbę kolejnych ataków."
"[english]DOTA_Tooltip_ability_custom_overpower_Description"	"Using his skill in combat, Ursa gains increased attack speed for a number of subsequent attacks."
"DOTA_Tooltip_ability_custom_overpower_max_attacks"	"MAKS. ATAKÓW:"
"[english]DOTA_Tooltip_ability_custom_overpower_max_attacks"	"MAX ATTACKS:"
"DOTA_Tooltip_ability_custom_overpower_attack_speed_bonus_pct"	"PREMIA DO SZYBKOŚCI ATAKU:"
"[english]DOTA_Tooltip_ability_custom_overpower_attack_speed_bonus_pct"	"ATTACK SPEED BONUS PCT:"
"DOTA_Tooltip_ability_custom_overpower_duration_tooltip"	"CZAS TRWANIA:"
"[english]DOTA_Tooltip_ability_custom_overpower_duration_tooltip"	"DURATION:"
"DOTA_Tooltip_ability_custom_fury_swipes"	"Fury Swipes"
"[english]DOTA_Tooltip_ability_custom_fury_swipes"	"Fury Swipes"
"DOTA_Tooltip_ability_custom_fury_swipes_Description"	"Pazury Ursy pozostawiają po sobie głębokie rany w ciele wroga, powodując, że następne ataki skierowane w jego stronę zadadzą więcej obrażeń."
"[english]DOTA_Tooltip_ability_custom_fury_swipes_Description"	"Ursa's claws dig deeper wounds in the enemy, causing consecutive attacks to the same enemy to deal more damage."
"DOTA_Tooltip_ability_custom_fury_swipes_damage_per_stack"	"OBRAŻENIA NA KUMULACJĘ:"
"[english]DOTA_Tooltip_ability_custom_fury_swipes_damage_per_stack"	"DAMAGE PER STACK:"
"DOTA_Tooltip_ability_snowball_lua"	"Snowball Lua"
"[english]DOTA_Tooltip_ability_snowball_lua"	"Snowball Lua"
"DOTA_Tooltip_ability_snowball_lua_Description"	"
"
"[english]DOTA_Tooltip_ability_snowball_lua_Description"	""
"DOTA_Tooltip_ability_impetus_lua"	"Impetus Lua"
"[english]DOTA_Tooltip_ability_impetus_lua"	"Impetus Lua"
"DOTA_Tooltip_ability_impetus_lua_Description"	"
"
"[english]DOTA_Tooltip_ability_impetus_lua_Description"	""
"DOTA_Tooltip_ability_remote_mine_lua_damage_per_tick"	"OBRAŻENIA OKRESOWE:"
"[english]DOTA_Tooltip_ability_remote_mine_lua_damage_per_tick"	"DAMAGE PER TICK:"
"DOTA_Tooltip_ability_remote_mine_lua_tick_rate"	"CZĘSTOTLIWOŚĆ UTRATY ZDROWIA:"
"[english]DOTA_Tooltip_ability_remote_mine_lua_tick_rate"	"TICK RATE:"
"DOTA_Tooltip_ability_place_propulsion_mine_lua"	"Propulsion Mine"
"[english]DOTA_Tooltip_ability_place_propulsion_mine_lua"	"Propulsion Mine"
"DOTA_Tooltip_ability_place_propulsion_mine_lua_Description"	"Rozstaw minę napędową, która odrzuci pobliskie jednostki podczas detonacji."
"[english]DOTA_Tooltip_ability_place_propulsion_mine_lua_Description"	"Place a Propulsion Mine that knocks back nearby units when detonated."
"DOTA_Tooltip_ability_place_propulsion_mine_lua_tooltip_damage"	"OBRAŻENIA:"
"[english]DOTA_Tooltip_ability_place_propulsion_mine_lua_tooltip_damage"	"DAMAGE:"
"DOTA_Tooltip_ability_place_propulsion_mine_lua_tooltip_damage_radius"	"PROMIEŃ OBRAŻEŃ:"
"[english]DOTA_Tooltip_ability_place_propulsion_mine_lua_tooltip_damage_radius"	"DAMAGE RADIUS:"
"DOTA_Tooltip_ability_place_propulsion_mine_lua_tooltip_knockback_distance"	"DYSTANS ODRZUCENIA:"
"[english]DOTA_Tooltip_ability_place_propulsion_mine_lua_tooltip_knockback_distance"	"KNOCKBACK DISTANCE:"
"DOTA_Tooltip_ability_detonate_propulsion_mine_lua"	"Detonate"
"[english]DOTA_Tooltip_ability_detonate_propulsion_mine_lua"	"Detonate"
"DOTA_Tooltip_ability_detonate_propulsion_mine_lua_Description"	"Wysadza wszystkie rozstawione miny z Propulsion Mine."
"[english]DOTA_Tooltip_ability_detonate_propulsion_mine_lua_Description"	"Detonates all currently placed propulsion mines."
"DOTA_Tooltip_ability_propulsion_mine_lua"	"Propulsion Mine"
"[english]DOTA_Tooltip_ability_propulsion_mine_lua"	"Propulsion Mine"
"DOTA_Tooltip_ability_propulsion_mine_lua_Description"	"
"
"[english]DOTA_Tooltip_ability_propulsion_mine_lua_Description"	""
"DOTA_Tooltip_ability_propulsion_mine_lua_damage"	"OBRAŻENIA:"
"[english]DOTA_Tooltip_ability_propulsion_mine_lua_damage"	"DAMAGE:"
"DOTA_Tooltip_ability_propulsion_mine_lua_radius"	"PROMIEŃ:"
"[english]DOTA_Tooltip_ability_propulsion_mine_lua_radius"	"RADIUS:"
"DOTA_Tooltip_ability_propulsion_mine_lua_knockback_distance"	"DYSTANS ODRZUCENIA:"
"[english]DOTA_Tooltip_ability_propulsion_mine_lua_knockback_distance"	"KNOCKBACK DISTANCE:"
"DOTA_Tooltip_ability_breathe_fire"	"Breathe Fire"
"[english]DOTA_Tooltip_ability_breathe_fire"	"Breathe Fire"
"DOTA_Tooltip_ability_breathe_fire_Description"	"
"
"[english]DOTA_Tooltip_ability_breathe_fire_Description"	""
"DOTA_Tooltip_ability_breathe_fire_start_radius"	"PROMIEŃ POCZĄTKOWY:"
"[english]DOTA_Tooltip_ability_breathe_fire_start_radius"	"START RADIUS:"
"DOTA_Tooltip_ability_breathe_fire_end_radius"	"PROMIEŃ KOŃCOWY:"
"[english]DOTA_Tooltip_ability_breathe_fire_end_radius"	"END RADIUS:"
"DOTA_Tooltip_ability_breathe_fire_range"	"ZASIĘG:"
"[english]DOTA_Tooltip_ability_breathe_fire_range"	"RANGE:"
"DOTA_Tooltip_ability_breathe_fire_speed"	"SZYBKOŚĆ:"
"[english]DOTA_Tooltip_ability_breathe_fire_speed"	"SPEED:"
"DOTA_Tooltip_ability_breathe_fire_fire_damage"	"OBRAŻENIA OD OGNIA:"
"[english]DOTA_Tooltip_ability_breathe_fire_fire_damage"	"FIRE DAMAGE:"
"DOTA_Tooltip_ability_refraction_lua"	"Refraction"
"[english]DOTA_Tooltip_ability_refraction_lua"	"Refraction"
"DOTA_Tooltip_ability_refraction_lua_Description"	"Po aktywacji blokuje wszystkie obrażenia, ale wysysa twoją manę."
"[english]DOTA_Tooltip_ability_refraction_lua_Description"	"Blocks all damage while activated, but drains your mana."
"DOTA_Tooltip_ability_refraction_lua_mana_per_second"	"MANA NA SEKUNDĘ:"
"[english]DOTA_Tooltip_ability_refraction_lua_mana_per_second"	"MANA PER SECOND:"
"DOTA_Tooltip_ability_campfire"	"Campfire"
"[english]DOTA_Tooltip_ability_campfire"	"Campfire"
"DOTA_Tooltip_ability_campfire_Description"	"
"
"[english]DOTA_Tooltip_ability_campfire_Description"	""
"DOTA_Tooltip_ability_campfire_aura_radius"	"PROMIEŃ AURY:"
"[english]DOTA_Tooltip_ability_campfire_aura_radius"	"AURA RADIUS:"
"DOTA_Tooltip_ability_campfire_aura_mana_regen"	"REGEN. MANY (AURA):"
"[english]DOTA_Tooltip_ability_campfire_aura_mana_regen"	"AURA MANA REGEN:"
"DOTA_Tooltip_ability_campfire_aura_hp_regen"	"REGEN. ZDROWIA (AURA):"
"[english]DOTA_Tooltip_ability_campfire_aura_hp_regen"	"AURA HP REGEN:"
"DOTA_Tooltip_ability_campfire_campfire_duration"	"CZAS TRWANIA OGNISKA:"
"[english]DOTA_Tooltip_ability_campfire_campfire_duration"	"CAMPFIRE DURATION:"
"DOTA_Tooltip_ability_weather_dummy_passive"	"Weather Dummy Passive"
"[english]DOTA_Tooltip_ability_weather_dummy_passive"	"Weather Dummy Passive"
"DOTA_Tooltip_ability_weather_dummy_passive_Description"	"
"
"[english]DOTA_Tooltip_ability_weather_dummy_passive_Description"	""
"DOTA_Tooltip_ability_weather_snowstorm"	"Weather Snowstorm"
"[english]DOTA_Tooltip_ability_weather_snowstorm"	"Weather Snowstorm"
"DOTA_Tooltip_ability_weather_snowstorm_Description"	"
"
"[english]DOTA_Tooltip_ability_weather_snowstorm_Description"	""
"DOTA_Tooltip_ability_custom_cold_feet"	"Cold Feet"
"[english]DOTA_Tooltip_ability_custom_cold_feet"	"Cold Feet"
"DOTA_Tooltip_ability_custom_cold_feet_Description"	"Umieszcza na wrogu mrożącą klątwę, która z upływem czasu zadaje obrażenia, ale może zostać zdjęta przez oddalenie się z miejsca, gdzie w momencie rzucenia znajdował się jej cel. Jeśli wróg nie opuści danego obszaru, zostanie ogłuszony i zamrożony."
"[english]DOTA_Tooltip_ability_custom_cold_feet_Description"	"Places a frozen hex on an enemy unit that deals damage over time, but can be dispelled by moving away from the initial cast point. If the enemy unit doesn't move out of the given range, it will be stunned and frozen in place."
"DOTA_Tooltip_ability_custom_cold_feet_damage"	"OBRAŻENIA:"
"[english]DOTA_Tooltip_ability_custom_cold_feet_damage"	"DAMAGE:"
"DOTA_Tooltip_ability_custom_cold_feet_break_distance"	"DYSTANS DO PRZERWANIA:"
"[english]DOTA_Tooltip_ability_custom_cold_feet_break_distance"	"BREAK DISTANCE:"
"DOTA_Tooltip_ability_custom_cold_feet_stun_duration"	"CZAS TRWANIA OGŁUSZENIA:"
"[english]DOTA_Tooltip_ability_custom_cold_feet_stun_duration"	"STUN DURATION:"
"DOTA_Tooltip_ability_custom_cold_feet_cast_range_tooltip"	"ZASIĘG CZARU:"
"[english]DOTA_Tooltip_ability_custom_cold_feet_cast_range_tooltip"	"CAST RANGE:"
"DOTA_Tooltip_ability_custom_ice_vortex"	"Ice Vortex"
"[english]DOTA_Tooltip_ability_custom_ice_vortex"	"Ice Vortex"
"DOTA_Tooltip_ability_custom_ice_vortex_Description"	"Tworzy wir lodowej energii, który spowalnia i zwiększa obrażenia magiczne zadawane wrogom na jego obszarze."
"[english]DOTA_Tooltip_ability_custom_ice_vortex_Description"	"Creates a vortex of icy energy that slows movement speed and increases magic damage done in its range."
"DOTA_Tooltip_ability_custom_ice_vortex_radius"	"PROMIEŃ:"
"[english]DOTA_Tooltip_ability_custom_ice_vortex_radius"	"RADIUS:"
"DOTA_Tooltip_ability_custom_ice_vortex_movement_speed_pct"	"SZYBKOŚĆ RUCHU:"
"[english]DOTA_Tooltip_ability_custom_ice_vortex_movement_speed_pct"	"MOVEMENT SPEED:"
"DOTA_Tooltip_ability_whirling_death_lua"	"Whirling Death"
"[english]DOTA_Tooltip_ability_whirling_death_lua"	"Whirling Death"
"DOTA_Tooltip_ability_whirling_death_lua_Description"	"Timbersaw zaczyna wirować bardzo ostrymi piłami, zadając obrażenia wrogom i niszcząc drzewa dookoła siebie."
"[english]DOTA_Tooltip_ability_whirling_death_lua_Description"	"Timbersaw whirls extremely sharp edges, damaging enemies and destroying trees around him in an area."
"DOTA_Tooltip_ability_whirling_death_lua_whirling_radius"	"PROMIEŃ:"
"[english]DOTA_Tooltip_ability_whirling_death_lua_whirling_radius"	"RADIUS:"
"DOTA_Tooltip_ability_timber_chain_lua"	"Timber Chain"
"[english]DOTA_Tooltip_ability_timber_chain_lua"	"Timber Chain"
"DOTA_Tooltip_ability_timber_chain_lua_Description"	"Timbersaw wystrzeliwuje łańcuch, który przyczepia się do pierwszego trafionego drzewa, przyciągając się do niego."
"[english]DOTA_Tooltip_ability_timber_chain_lua_Description"	"Timbersaw fires a chain that embeds itself in the first tree it hits, pulling him towards it."
"DOTA_Tooltip_ability_timber_chain_lua_chain_radius"	"PROMIEŃ SZUKANIA DRZEWA:"
"[english]DOTA_Tooltip_ability_timber_chain_lua_chain_radius"	"TREE SEARCH RADIUS:"
"DOTA_Tooltip_ability_timber_chain_lua_range"	"ZASIĘG:"
"[english]DOTA_Tooltip_ability_timber_chain_lua_range"	"RANGE:"
"DOTA_Tooltip_ability_chakram_lua"	"Chakram"
"[english]DOTA_Tooltip_ability_chakram_lua"	"Chakram"
"DOTA_Tooltip_ability_chakram_lua_Description"	"Wystrzeliwuje twoją główną piłę tarczową w wybrane miejsce, gdzie zacznie się ona obracać w miejscu. Piła ścina drzewa lecąc do celu i wracając."
"[english]DOTA_Tooltip_ability_chakram_lua_Description"	"Fires your main saw blade at the target location where it will spin in place. The blade cuts down trees in its path when fired and retracted."
"DOTA_Tooltip_ability_chakram_lua_speed"	"SZYBKOŚĆ:"
"[english]DOTA_Tooltip_ability_chakram_lua_speed"	"SPEED:"
"DOTA_Tooltip_ability_chakram_lua_radius"	"PROMIEŃ:"
"[english]DOTA_Tooltip_ability_chakram_lua_radius"	"EFFECT RADIUS:"
"DOTA_Tooltip_ability_chakram_lua_break_distance"	"DYSTANS DO PRZERWANIA:"
"[english]DOTA_Tooltip_ability_chakram_lua_break_distance"	"BREAK DISTANCE:"
"DOTA_Tooltip_ability_chakram_return_lua"	"Powrót Chakramu"
"[english]DOTA_Tooltip_ability_chakram_return_lua"	"Chakram Return"
"DOTA_Tooltip_ability_chakram_return_lua_Description"	"Przywołuje Chakram z powrotem do bohatera."
"[english]DOTA_Tooltip_ability_chakram_return_lua_Description"	"Returns the Chakram to Timbersaw."
"DOTA_Tooltip_ability_containers_lua_targeting"	"Containers Targeting"
"[english]DOTA_Tooltip_ability_containers_lua_targeting"	"Containers Targeting"
"DOTA_Tooltip_ability_containers_lua_targeting_Description"	"
"
"[english]DOTA_Tooltip_ability_containers_lua_targeting_Description"	""
"DOTA_Tooltip_ability_containers_lua_targeting_tree"	"Containers Targeting Tree"
"[english]DOTA_Tooltip_ability_containers_lua_targeting_tree"	"Containers Targeting Tree"
"DOTA_Tooltip_ability_containers_lua_targeting_tree_Description"	"
"
"[english]DOTA_Tooltip_ability_containers_lua_targeting_tree_Description"	""
"DOTA_Tooltip_ability_dummy_unit"	"Dummy Unit"
"[english]DOTA_Tooltip_ability_dummy_unit"	"Dummy Unit"
"DOTA_Tooltip_ability_dummy_unit_Description"	"
"
"[english]DOTA_Tooltip_ability_dummy_unit_Description"	""
"DOTA_Tooltip_ability_barebones_empty1"	"Barebones Empty1"
"[english]DOTA_Tooltip_ability_barebones_empty1"	"Barebones Empty1"
"DOTA_Tooltip_ability_barebones_empty1_Description"	"
"
"[english]DOTA_Tooltip_ability_barebones_empty1_Description"	""
"DOTA_Tooltip_ability_barebones_empty2"	"Barebones Empty2"
"[english]DOTA_Tooltip_ability_barebones_empty2"	"Barebones Empty2"
"DOTA_Tooltip_ability_barebones_empty2_Description"	"
"
"[english]DOTA_Tooltip_ability_barebones_empty2_Description"	""
"DOTA_Tooltip_ability_barebones_empty3"	"Barebones Empty3"
"[english]DOTA_Tooltip_ability_barebones_empty3"	"Barebones Empty3"
"DOTA_Tooltip_ability_barebones_empty3_Description"	"
"
"[english]DOTA_Tooltip_ability_barebones_empty3_Description"	""
"DOTA_Tooltip_ability_barebones_empty4"	"Barebones Empty4"
"[english]DOTA_Tooltip_ability_barebones_empty4"	"Barebones Empty4"
"DOTA_Tooltip_ability_barebones_empty4_Description"	"
"
"[english]DOTA_Tooltip_ability_barebones_empty4_Description"	""
"DOTA_Tooltip_ability_barebones_empty5"	"Barebones Empty5"
"[english]DOTA_Tooltip_ability_barebones_empty5"	"Barebones Empty5"
"DOTA_Tooltip_ability_barebones_empty5_Description"	"
"
"[english]DOTA_Tooltip_ability_barebones_empty5_Description"	""
"DOTA_Tooltip_ability_barebones_empty6"	"Barebones Empty6"
"[english]DOTA_Tooltip_ability_barebones_empty6"	"Barebones Empty6"
"DOTA_Tooltip_ability_barebones_empty6_Description"	"
"
"[english]DOTA_Tooltip_ability_barebones_empty6_Description"	""
"DOTA_Tooltip_ability_item_rune_heal"	"Runa regeneracji"
"[english]DOTA_Tooltip_ability_item_rune_heal"	"Regeneration"
"DOTA_Tooltip_ability_item_rune_heal_Description"	"
"
"[english]DOTA_Tooltip_ability_item_rune_heal_Description"	""
"DOTA_Tooltip_ability_item_rune_heal_heal"	"LECZENIE:"
"[english]DOTA_Tooltip_ability_item_rune_heal_heal"	"HEAL:"
"DOTA_Tooltip_ability_item_rune_full_heal"	"Runa regeneracji"
"[english]DOTA_Tooltip_ability_item_rune_full_heal"	"Regeneration"
"DOTA_Tooltip_ability_item_rune_full_heal_Description"	"
"
"[english]DOTA_Tooltip_ability_item_rune_full_heal_Description"	""
"DOTA_Tooltip_ability_item_rune_full_heal_heal"	"LECZENIE:"
"[english]DOTA_Tooltip_ability_item_rune_full_heal_heal"	"HEAL:"
"DOTA_Tooltip_ability_item_rune_double_damage_duration"	"CZAS TRWANIA:"
"[english]DOTA_Tooltip_ability_item_rune_double_damage_duration"	"DURATION:"
"DOTA_Tooltip_ability_item_blink_lua"	"Blink Dagger"
"[english]DOTA_Tooltip_ability_item_blink_lua"	"Blink Dagger"
"DOTA_Tooltip_ability_item_blink_lua_Description"	"
"
"[english]DOTA_Tooltip_ability_item_blink_lua_Description"	""
"DOTA_Tooltip_ability_item_blink_lua_blink_range"	"ZASIĘG (BLINK):"
"[english]DOTA_Tooltip_ability_item_blink_lua_blink_range"	"BLINK RANGE:"
"DOTA_Tooltip_ability_item_rune_haste"	"Runa przyspieszenia"
"[english]DOTA_Tooltip_ability_item_rune_haste"	"Haste"
"DOTA_Tooltip_ability_item_rune_haste_Description"	"
"
"[english]DOTA_Tooltip_ability_item_rune_haste_Description"	""
"DOTA_Tooltip_ability_item_rune_haste_duration"	"CZAS TRWANIA:"
"[english]DOTA_Tooltip_ability_item_rune_haste_duration"	"DURATION:"
"DOTA_Tooltip_ability_item_rune_double_damage"	"Podwójne obrażenia"
"[english]DOTA_Tooltip_ability_item_rune_double_damage"	"Double Damage"
"DOTA_Tooltip_ability_item_rune_double_damage_Description"	"
"
"[english]DOTA_Tooltip_ability_item_rune_double_damage_Description"	""
"DOTA_Tooltip_ability_item_containers_lua_pack"	"Containers Pack"
"[english]DOTA_Tooltip_ability_item_containers_lua_pack"	"Containers Pack"
"DOTA_Tooltip_ability_item_containers_lua_pack_Description"	"
"
"[english]DOTA_Tooltip_ability_item_containers_lua_pack_Description"	""
"DOTA_Frostivus_2017_Suicidal_Axe_Name"	"Samobójczy Axe"
"[english]DOTA_Frostivus_2017_Suicidal_Axe_Name"	"Suicidal Axe"
"DOTA_Frostivus_2017_Suicidal_Pudge_Name"	"Samobójczy Pudge"
"[english]DOTA_Frostivus_2017_Suicidal_Pudge_Name"	"Suicidal Pudge"
"DOTA_Frostivus_2017_Chain_Frost_Tag_Name"	"Mroźny berek"
"[english]DOTA_Frostivus_2017_Chain_Frost_Tag_Name"	"Chain Frost Tag"
"DOTA_Frostivus_2017_Minefield_Survival_Name"	"Przetrwanie na polu minowym"
"[english]DOTA_Frostivus_2017_Minefield_Survival_Name"	"Minefield Survival"
"DOTA_Frostivus_2017_Minefield_Racing_Name"	"Wyścig przez pole minowe"
"[english]DOTA_Frostivus_2017_Minefield_Racing_Name"	"Minefield Racing"
"DOTA_Frostivus_2017_Arrow_Practice_Name"	"Lekcja łucznictwa"
"[english]DOTA_Frostivus_2017_Arrow_Practice_Name"	"Arrow Practice"
"DOTA_Frostivus_2017_Survive_the_Winter_Name"	"Przetrwaj zimę"
"[english]DOTA_Frostivus_2017_Survive_the_Winter_Name"	"Survive the Winter"
"DOTA_Frostivus_2017_Pudge_Wars_Name"	"Wojny Pudge'ów"
"[english]DOTA_Frostivus_2017_Pudge_Wars_Name"	"Pudge Wars"
"DOTA_Frostivus_2017_Shadowfiend_Wars_Name"	"Wojny Shadow Fiendów"
"[english]DOTA_Frostivus_2017_Shadowfiend_Wars_Name"	"Shadowfiend Wars"
"DOTA_Frostivus_2017_Monkey_Mischief_Name"	"Małpie psoty"
"[english]DOTA_Frostivus_2017_Monkey_Mischief_Name"	"Monkey Mischief"
"DOTA_Frostivus_2017_Kaolin_Soccer_Name"	"Kaolińska piłka nożna"
"[english]DOTA_Frostivus_2017_Kaolin_Soccer_Name"	"Kaolin Soccer"
"DOTA_Frostivus_2017_Boar_Bear_Hawk_Name"	"Dzik, niedźwiedź, jastrząb"
"[english]DOTA_Frostivus_2017_Boar_Bear_Hawk_Name"	"Boar, Bear, Hawk"
"DOTA_Frostivus_2017_Archer_Wars_Name"	"Wojny łuczników"
"[english]DOTA_Frostivus_2017_Archer_Wars_Name"	"Archer Wars"
"DOTA_Frostivus_2017_Ogre_Seal_Survival_Name"	"Przetrwanie fok ogrzych"
"[english]DOTA_Frostivus_2017_Ogre_Seal_Survival_Name"	"Ogre Seal Survival"
"DOTA_Frostivus_2017_Ogre_Survival_Name"	"Przetrwanie ogra"
"[english]DOTA_Frostivus_2017_Ogre_Survival_Name"	"Ogre Survival"
"DOTA_Frostivus_2017_Red_Light_Green_Light_Name"	"Czerwone światło, zielone światło"
"[english]DOTA_Frostivus_2017_Red_Light_Green_Light_Name"	"Red Light, Green Light"
"DOTA_Frostivus_2017_Spirit_Breaker_Race_Name"	"Wyścig Spirit Breakerów"
"[english]DOTA_Frostivus_2017_Spirit_Breaker_Race_Name"	"Spirit Breaker Race"
"DOTA_Frostivus_2017_Zombies_Zombies_Zombies_Name"	"Zombie zombie zombie"
"[english]DOTA_Frostivus_2017_Zombies_Zombies_Zombies_Name"	"Zombies Zombies Zombies"
"DOTA_Frostivus_2017_Poke_the_Ogre_Name"	"Szturchnij ogra"
"[english]DOTA_Frostivus_2017_Poke_the_Ogre_Name"	"Poke the Ogre"
"DOTA_Frostivus_2017_Follow_the_Leader_Name"	"Podążaj za przywódcą"
"[english]DOTA_Frostivus_2017_Follow_the_Leader_Name"	"Follow the Leader"
"DOTA_Frostivus_2017_Coin_Collection_Name"	"Zbieranie monet"
"[english]DOTA_Frostivus_2017_Coin_Collection_Name"	"Coin Collection"
"DOTA_Frostivus_2017_Spirit_Breaker_Sumo_Name"	"Sumo Spirit Breakerów"
"[english]DOTA_Frostivus_2017_Spirit_Breaker_Sumo_Name"	"Spirit Breaker Sumo"
"DOTA_Frostivus_2017_Refraction_Survival_Name"	"Przetrwanie Refraction"
"[english]DOTA_Frostivus_2017_Refraction_Survival_Name"	"Refraction Survival"
"DOTA_Frostivus_2017_Campfire_Survival_Name"	"Przetrwanie ognisk"
"[english]DOTA_Frostivus_2017_Campfire_Survival_Name"	"Campfire Survival"
"DOTA_Frostivus_2017_Impetus_Throwing_Contest_Name"	"Zawody w rzucaniu Impetusem"
"[english]DOTA_Frostivus_2017_Impetus_Throwing_Contest_Name"	"Impetus Throwing Contest"
"DOTA_Frostivus_2017_Techies_Knockout_Name"	"Wypychanie Techiesów"
"[english]DOTA_Frostivus_2017_Techies_Knockout_Name"	"Techies Knockout"
"DOTA_Frostivus_2017_Fire_Trap_Race_Name"	"Wyścig z ognistymi pułapkami"
"[english]DOTA_Frostivus_2017_Fire_Trap_Race_Name"	"Fire Trap Race"
"DOTA_Frostivus_2017_Avalanche_Survival_Name"	"Przetrwanie lawiny"
"[english]DOTA_Frostivus_2017_Avalanche_Survival_Name"	"Avalanche Survival"
"DOTA_Frostivus_2017_An_End_To_All_Magic_Name"	"Kres wszelkiej magii"
"[english]DOTA_Frostivus_2017_An_End_To_All_Magic_Name"	"An End To All Magic"
"DOTA_Frostivus_2017_Deforestation_Name"	"Wylesianie"
"[english]DOTA_Frostivus_2017_Deforestation_Name"	"Deforestation"
"DOTA_Frostivus2017_Suicidal_Axe_Desc"	"Bądź pierwszym graczem, który zginie"
"[english]DOTA_Frostivus2017_Suicidal_Axe_Desc"	"Be the first player to die"
"DOTA_Frostivus2017_Suicidal_Pudge_Desc"	"Trzymaj się z dala od samobójczego Pudge'a"
"[english]DOTA_Frostivus2017_Suicidal_Pudge_Desc"	"Stay away from the suicidal pudge"
"DOTA_Frostivus2017_Chain_Frost_Tag_Desc"	"Unikaj Chain Frosta Licha"
"[english]DOTA_Frostivus2017_Chain_Frost_Tag_Desc"	"Avoid the Lich's Chain Frosts"
"DOTA_Frostivus2017_Minefield_Survival_Desc"	"Unikaj eksplodujących bomb"
"[english]DOTA_Frostivus2017_Minefield_Survival_Desc"	"Avoid the exploding bombs"
"DOTA_Frostivus2017_Minefield_Racing_Desc"	"Przedostań się przez niebezpieczne pole minowe, wykorzystując pioruny za przewodników"
"[english]DOTA_Frostivus2017_Minefield_Racing_Desc"	"Navigate a dangerous minefield, using lightning to guide your way"
"DOTA_Frostivus2017_Arrow_Practice_Desc"	"Zestrzel jeden z dzwonków przy pomocy strzały"
"[english]DOTA_Frostivus2017_Arrow_Practice_Desc"	"Shoot one of the bells with an Arrow"
"DOTA_Frostivus2017_Survive_the_Winter_Desc"	"Zbieraj runy regeneracji, żeby przetrwać mroźną zimę"
"[english]DOTA_Frostivus2017_Survive_the_Winter_Desc"	"Pick up Regen Runes to survive the freezing winter"
"DOTA_Frostivus2017_Pudge_Wars_Desc"	"Zdobywaj punkty za zabijanie innych graczy"
"[english]DOTA_Frostivus2017_Pudge_Wars_Desc"	"Get points by killing other players"
"DOTA_Frostivus2017_Kaolin_Soccer_Desc"	"Trzymaj piłkę z dala od swojej bramki"
"[english]DOTA_Frostivus2017_Kaolin_Soccer_Desc"	"Keep the ball out of your goal"
"DOTA_Frostivus2017_Archer_Wars_Desc"	"Ostatni żywy strzelec wygrywa"
"[english]DOTA_Frostivus2017_Archer_Wars_Desc"	"Last Archer Standing"
"DOTA_Frostivus2017_Ogre_Seal_Survival_Desc"	"Uniknij zgniecenia przez fokę ogrzą"
"[english]DOTA_Frostivus2017_Ogre_Seal_Survival_Desc"	"Avoid getting crushed by the Ogre Seal"
"DOTA_Frostivus2017_Ogre_Survival_Desc"	"Uniknij zgniecenia przez ogra"
"[english]DOTA_Frostivus2017_Ogre_Survival_Desc"	"Avoid getting crushed by the Ogre"
"DOTA_Frostivus2017_Red_Light_Green_Light_Desc"	"Ukończ wyścig, nie umierając od Rupture"
"[english]DOTA_Frostivus2017_Red_Light_Green_Light_Desc"	"Make it to the end of the race without being killed by rupture"
"DOTA_Frostivus2017_Spirit_Breaker_Race_Desc"	"Spamuj Charge, aby poruszać się do przodu"
"[english]DOTA_Frostivus2017_Spirit_Breaker_Race_Desc"	"Spam Charge to move forwards"
"DOTA_Frostivus2017_Zombies_Zombies_Zombies_Desc"	"Przetrwaj apokalipsę zombie"
"[english]DOTA_Frostivus2017_Zombies_Zombies_Zombies_Desc"	"Survive the Zombie Apocalypse"
"DOTA_Frostivus2017_Poke_the_Ogre_Desc"	"Zadaj ogrowi jak najwięcej obrażeń, zanim skończy się czas. Ładunki Fury Swipes kumulują się z innymi graczami."
"[english]DOTA_Frostivus2017_Poke_the_Ogre_Desc"	"Do the most damage to the Ogre before time runs out. Fury Swipes stacks with other players."
"DOTA_Frostivus2017_Follow_the_Leader_Desc"	"Wywołaj to samo zaklęcie, co Invoker\n\nOtrzymasz obrażenia za wyczarowanie złego zaklęcia, lub gdy nie zrobisz tego na czas"
"[english]DOTA_Frostivus2017_Follow_the_Leader_Desc"	"Invoke the same spells as Invoker\n\nTake damage for invoking the wrong spell, or not invoking on time"
"DOTA_Frostivus2017_Coin_Collection_Desc"	"Zbierz jak najwięcej monet, zanim skończy się czas"
"[english]DOTA_Frostivus2017_Coin_Collection_Desc"	"Collect the most coins before time runs out"
"DOTA_Frostivus2017_Spirit_Breaker_Sumo_Desc"	"Spróbuj wypchnąć innych graczy poza granice areny"
"[english]DOTA_Frostivus2017_Spirit_Breaker_Sumo_Desc"	"Try to push other players out of bounds"
"DOTA_Frostivus2017_Refraction_Survival_Desc"	"Użyj Refraction, żeby przetrwać w ogniu. Utrzymywanie Refraction zużywa manę."
"[english]DOTA_Frostivus2017_Refraction_Survival_Desc"	"Use Refraction to survive the fire. Keeping Refraction on drains mana."
"DOTA_Frostivus2017_Impetus_Throwing_Contest_Desc"	"Rzuć najdłuższy Impetus. Odległość jest mierzona od miejsca, w którym się znajdujesz w momencie trafienia twojej lancy."
"[english]DOTA_Frostivus2017_Impetus_Throwing_Contest_Desc"	"Throw the longest Impetus. Distance is measured from where you are when your lance hits."
"DOTA_Frostivus2017_Techies_Knockout_Desc"	"Użyj swoich min, aby wypchnąć innych graczy poza granice areny"
"[english]DOTA_Frostivus2017_Techies_Knockout_Desc"	"Use your mines to push other players out of bounds"
"DOTA_Frostivus2017_Fire_Trap_Race_Desc"	"Dotrwaj do końca, nie umierając od ognia"
"[english]DOTA_Frostivus2017_Fire_Trap_Race_Desc"	"Make it to the end without being killed by the fire"
"DOTA_Frostivus2017_An_End_To_All_Magic_Desc"	"Nie daj się zepchnąć z platformy przez Deafening Blasty Invokera"
"[english]DOTA_Frostivus2017_An_End_To_All_Magic_Desc"	"Don't get pushed off the platform by Invoker's Deafening Blasts"
"DOTA_Frostivus2017_Deforestation_Desc"	"Zniszcz jak najwięcej drzew, zanim skończy się czas!"
"[english]DOTA_Frostivus2017_Deforestation_Desc"	"Destroy the most trees before time runs out!"
}
}
