"lang"
{
"Language"	"turkish"
"Tokens"
{
"addon_game_name"	"EKLENTİ ADINIZ"
"[english]addon_game_name"	"YOUR ADDON NAME"
"DotaNPX_Hint"	"İPUCU"
"[english]DotaNPX_Hint"	"HINT"
"DotaNPX_HintOk"	"Tamamdır!"
"[english]DotaNPX_HintOk"	"Ok, got it!"
"DOTANPX_Quit"	"ÇIKIŞ"
"[english]DOTANPX_Quit"	"EXIT"
"task_place_ward_at_location_fail"	"Göz, istenilen yerden çok uzağa dikildi."
"[english]task_place_ward_at_location_fail"	"Ward placed too far from required location."
"task_fail_player_hero_death_fail"	"Öldünüz."
"[english]task_fail_player_hero_death_fail"	"You died."
"task_fail_protect_units"	"Dostlarınızı koruyamadınız."
"[english]task_fail_protect_units"	"Failed to protect your allies."
"task_fail_pull_target"	"Tarafsız yaratık öldü."
"[english]task_fail_pull_target"	"Neutral creep died."
"task_fail_stack_target_out_of_time"	"Yaratıklar zamanında istiflenemedi."
"[english]task_fail_stack_target_out_of_time"	"Failed to stack creeps in time."
"task_fail_stack_target_unit_died"	"Tarafsız yaratık öldü."
"[english]task_fail_stack_target_unit_died"	"Neutral creep died."
"scenario_farming_main_objective"	"Kasmanın temellerini öğrenin."
"[english]scenario_farming_main_objective"	"Learn the basics of farming"
"scenario_farming_task_learn_shrapnel"	"Shrapnel yeteneğinin seviyesini yükseltin."
"[english]scenario_farming_task_learn_shrapnel"	"Level up the ability Shrapnel"
"scenario_farming_task_buy_boots"	"Dükkândan Boots of Speed'i satın alın."
"[english]scenario_farming_task_buy_boots"	"Buy the item Boots of Speed from the shop"
"scenario_farming_task_move_to_location_1"	"Gösterilen noktaya ilerleyin ve yaratık bulun."
"[english]scenario_farming_task_move_to_location_1"	"Move to the waypoint and find some creeps"
"scenario_farming_task_kill_creeps"	"5 yaratık öldürün."
"[english]scenario_farming_task_kill_creeps"	"Kill 5 creeps"
"scenario_support_survival_main_objective"	"Destek olarak hayatta kalmayı öğrenin."
"[english]scenario_support_survival_main_objective"	"Learn to live as a support."
"scenario_support_survival_task_learn_frostbite"	"Frostbite yeteneğinin seviyesini yükseltin."
"[english]scenario_support_survival_task_learn_frostbite"	"Level up the ability Frostbite."
"scenario_support_survival_task_move_to_location_1"	"Gösterilen yere ilerleyin ve kendinizi savunmaya hazır olun!"
"[english]scenario_support_survival_task_move_to_location_1"	"Move to the waypoint and prepare to defend yourself!"
"scenario_support_survival_task_survive_for_time_1"	"Zaman dolana kadar hayatta kalın!"
"[english]scenario_support_survival_task_survive_for_time_1"	"Survive until time runs out!"
"scenario_support_survival_task_buy_glimmer_cape"	"Glimmer Cape satın alın."
"[english]scenario_support_survival_task_buy_glimmer_cape"	"Purchase a Glimmer Cape."
"scenario_support_survival_task_move_to_location_2"	"Gösterilen yere ilerleyin ve kendinizi savunmaya hazır olun!"
"[english]scenario_support_survival_task_move_to_location_2"	"Move to the waypoint and prepare to defend yourself!"
"scenario_support_survival_task_survive_for_time_2"	"Zaman dolana kadar hayatta kalın!"
"[english]scenario_support_survival_task_survive_for_time_2"	"Survive until time runs out!"
"scenario_support_survival_task_buy_force_staff"	"Force Staff satın alın."
"[english]scenario_support_survival_task_buy_force_staff"	"Purchase a Force Staff."
"scenario_support_survival_task_move_to_location_3"	"Gösterilen yere ilerleyin ve kendinizi savunmaya hazır olun!"
"[english]scenario_support_survival_task_move_to_location_3"	"Move to the waypoint and prepare to defend yourself!"
"scenario_support_survival_task_survive_for_time_3"	"Zaman dolana kadar hayatta kalın!"
"[english]scenario_support_survival_task_survive_for_time_3"	"Survive until time runs out!"
"scenario_support_survival_task_kill_sven_1"	"Sven'i yenin."
"[english]scenario_support_survival_task_kill_sven_1"	"Defeat Sven."
"scenario_support_survival_task_kill_sven_2"	"Sven'i yenin."
"[english]scenario_support_survival_task_kill_sven_2"	"Defeat Sven."
"scenario_support_survival_task_kill_sven_3"	"Sven'i yenin."
"[english]scenario_support_survival_task_kill_sven_3"	"Defeat Sven."
"scenario_support_survival_task_do_not_die"	"Ölmeyin!"
"[english]scenario_support_survival_task_do_not_die"	"Don't die!"
"scenario_support_survival_time_remaining"	"Kalan Süre:"
"[english]scenario_support_survival_time_remaining"	"Time Remaining:"
"scenario_glimmer_cape_task_move_to_location_1"	"Gösterilen yere ilerleyin."
"[english]scenario_glimmer_cape_task_move_to_location_1"	"Move to the waypoint."
"scenario_glimmer_cape_task_do_not_die"	"Ölmeyin!"
"[english]scenario_glimmer_cape_task_do_not_die"	"Don't die!"
"scenario_glimmer_cape_task_move_to_escape"	"Chaos Knight'tan kurtulun ve gösterilen yere ilerleyin."
"[english]scenario_glimmer_cape_task_move_to_escape"	"Evade Chaos Knight and get to the waypoint."
"scenario_glimmer_cape_task_move_to_escape_Description"	"Chaos Knight yaklaştığında önce Glimmer Cape'inize ardından kahramanınıza tıklayın."
"[english]scenario_glimmer_cape_task_move_to_escape_Description"	"Click your Glimmer Cape and click your hero as Chaos Knight approaches."
"scenario_glimmer_cape_task_move_to_location_2"	"Gösterilen yere ilerleyin."
"[english]scenario_glimmer_cape_task_move_to_location_2"	"Move to the waypoint."
"scenario_glimmer_cape_task_move_to_location_2_Description"	"Kahramanınızı ilerletmek için gösterilen yerin yakınına sağ tıklayın."
"[english]scenario_glimmer_cape_task_move_to_location_2_Description"	"Right click near the waypoint to move your hero."
"scenario_glimmer_cape_task_protect_ogre"	"Ogre Magi'a nehre kadar eşlik edin."
"[english]scenario_glimmer_cape_task_protect_ogre"	"Escort Ogre Magi down the river."
"scenario_glimmer_cape_task_protect_ogre_Description"	"Chaos Knight yaklaştığında önce Glimmer Cape'inize ardından Ogre Magi'a tıklayın."
"[english]scenario_glimmer_cape_task_protect_ogre_Description"	"Click your Glimmer Cape and click Ogre Magi as Chaos Knight approaches."
"scenario_glimmer_cape_task_kill_necrophos"	"Sniper'ın hayatta kalmasına ve Necrophos'u yenmesine yardım edin."
"[english]scenario_glimmer_cape_task_kill_necrophos"	"Help Sniper survive and defeat Necrophos."
"scenario_glimmer_cape_task_kill_necrophos_Description"	"Sniper üzerinde Scythe kullanıldığında önce Glimmer Cape'inize ardından Sniper'a tıklayın."
"[english]scenario_glimmer_cape_task_kill_necrophos_Description"	"Click your Glimmer Cape and click Sniper as he gets Scythed."
"scenario_glimmer_cape_wizard_tip_intro_Text"	"Glimmer Cape sizi kısa süreliğine görünmez yaparak kaçmanıza fırsat tanır."
"[english]scenario_glimmer_cape_wizard_tip_intro_Text"	"The Glimmer Cape can turn you invisible for a short time, allowing you to escape."
"scenario_glimmer_cape_wizard_tip_ally_Text"	"Glimmer Cape'i ayrıca dostlarınızı görünmez yapmak için de kullanabilirsiniz. Tıpkı bu Ogre Magi gibi!"
"[english]scenario_glimmer_cape_wizard_tip_ally_Text"	"You can also use the Glimmer Cape on your allies to make them invisible. Like this Ogre Magi!"
"scenario_glimmer_cape_wizard_tip_magic_resist_Text"	"Glimmer Cape'in etkin yeteneği oldukça yüksek büyü direnci sağlar. Güçlü büyülere karşı kullanmak için birebirdir."
"[english]scenario_glimmer_cape_wizard_tip_magic_resist_Text"	"Glimmer Cape's active ability provides a lot of magic resistance. It's great against powerful spells."
"scenario_glimmer_cape_failure_ogre_died"	"Ogre Magi öldü."
"[english]scenario_glimmer_cape_failure_ogre_died"	"Ogre Magi died."
"scenario_glimmer_cape_failure_sniper_died"	"Sniper öldü."
"[english]scenario_glimmer_cape_failure_sniper_died"	"Sniper died."
"scenario_roshan_task_move_to_location_1"	"Takım arkadaşlarınızın yanına gidin."
"[english]scenario_roshan_task_move_to_location_1"	"Meet up with your teammates"
"scenario_roshan_task_move_to_location_1_Description"	"Kahramanınızı ilerletmek için gösterilen yerin yakınına sağ tıklayın."
"[english]scenario_roshan_task_move_to_location_1_Description"	"Right-click near the waypoint to move your hero."
"scenario_roshan_task_kill_roshan"	"Roshan'ı kendi çukurunda alt edin."
"[english]scenario_roshan_task_kill_roshan"	"Defeat Roshan in his pit"
"scenario_roshan_task_kill_roshan_Description"	"Roshan'a karşı saldırılarınızı ve yeteneklerinizi kullanın."
"[english]scenario_roshan_task_kill_roshan_Description"	"Use your attacks and abilities against Roshan."
"scenario_roshan_task_pick_up_aegis"	"Aegis of the Immortal'ı alın."
"[english]scenario_roshan_task_pick_up_aegis"	"Pick up the Aegis of the Immortal"
"scenario_roshan_task_pick_up_aegis_Description"	"Aegis'i almak için üzerine sağ tıklayın."
"[english]scenario_roshan_task_pick_up_aegis_Description"	"Right-click on the Aegis to pick it up."
"scenario_roshan_task_exit_pit"	"Roshan'ın çukurundan çıkın."
"[english]scenario_roshan_task_exit_pit"	"Exit Roshan's pit"
"scenario_roshan_task_exit_pit_Description"	"Kahramanınızı ilerletmek için gösterilen yerin yakınına sağ tıklayın."
"[english]scenario_roshan_task_exit_pit_Description"	"Right-click near the waypoint to move your hero."
"scenario_roshan_task_kill_juggernaut"	"Aegis'in gücüyle Juggernaut'u yenin."
"[english]scenario_roshan_task_kill_juggernaut"	"Defeat Juggernaut with the power of the Aegis"
"scenario_roshan_task_kill_juggernaut_Description"	"Juggernaut'a karşı saldırılarınızı ve yeteneklerinizi kullanın."
"[english]scenario_roshan_task_kill_juggernaut_Description"	"Use your attacks and abilities against Juggernaut."
"scenario_roshan_wizard_tip_intro_Text"	"Roshan güçlü ve ölümsüz bir yaratıktır. Onu öldürdüğünüzde Aegis of the Immortal da dahil olmak üzere birçok harika ödül çıkar! Haydi gidip Roshan'ı öldürelim."
"[english]scenario_roshan_wizard_tip_intro_Text"	"Roshan is a powerful immortal beast that carries great rewards, including the Aegis of the Immortal! Let's go kill him."
"scenario_roshan_wizard_tip_fight_Text"	"Roshan oyunun başında çukurunda çıkar fakat onu öldürebilmek için seviye atlamalı, güçlü eşyalara sahip olmalı ve takım hâlinde saldırmalısınız."
"[english]scenario_roshan_wizard_tip_fight_Text"	"Roshan spawns in his pit at the start of the game, but you'll want to level up, get some items, and bring your teammates to defeat him."
"scenario_roshan_wizard_tip_rosh_killed_Text"	"Roshan'ı öldürdüğünüzde takımınızdaki herkes altın ve TP kazanır. Roshan belirli bir süre sonra tekrar aynı yerde çıkar ve tekrar öldürüldüğünde daha fazla ödül bahşeder."
"[english]scenario_roshan_wizard_tip_rosh_killed_Text"	"Killing Roshan grants your entire team Gold and XP. He will respawn after a period of time, and he'll have more rewards upon his return."
"scenario_roshan_wizard_tip_aegis_pickup_Text"	"Ölürseniz, Aegis sizi öldüğünüz yerde kısa bir süre içinde tekrar hayata döndürür."
"[english]scenario_roshan_wizard_tip_aegis_pickup_Text"	"If you die the Aegis will resurrect you right where you died after a short delay."
"scenario_roshan_failure_aegis_denied"	"Aegis yok edildi!"
"[english]scenario_roshan_failure_aegis_denied"	"The Aegis was destroyed!"
"scenario_invisibility_task_buy_sentry"	"Bir nöbetçi göz alın."
"[english]scenario_invisibility_task_buy_sentry"	"Purchase a Sentry Ward."
"scenario_invisibility_task_buy_sentry_Description"	"Dükkân butonuna tıklayın. Nöbetçi göze sağ tıklayın."
"[english]scenario_invisibility_task_buy_sentry_Description"	"Click on the Shop Button. Right-Click on the Sentry Ward."
"scenario_invisibility_task_place_sentry"	"Bir bölgede gerçek görüş kazanmak için bir nöbetçi göz dikin."
"[english]scenario_invisibility_task_place_sentry"	"Place a Sentry Ward to gain True Sight in an area."
"scenario_invisibility_task_place_sentry_Description"	"Nöbetçi göze tıklayın veya kısayol tuşuna basın, ardından yakınınızda bir yere tıklayın."
"[english]scenario_invisibility_task_place_sentry_Description"	"Click the Sentry Ward or use its hotkey and then Click near the location."
"scenario_invisibility_task_destroy_enemy_ward"	"Gerçek görüşünüzle ortaya çıkan izleyici gözü yok edin."
"[english]scenario_invisibility_task_destroy_enemy_ward"	"Destroy the enemy Observer Ward revealed by your True Sight."
"scenario_invisibility_task_destroy_enemy_ward_Description"	"Saldırmak için sağ tıklayın."
"[english]scenario_invisibility_task_destroy_enemy_ward_Description"	"Right click to attack it."
"scenario_invisibility_task_kill_riki"	"Görünmezliğine rağmen Riki'yi yenin."
"[english]scenario_invisibility_task_kill_riki"	"Defeat Riki despite his invisibility."
"scenario_invisibility_task_kill_riki_Description"	"Nöbetçi gözünüzün yakınında durun, saldırılarınızı ve yeteneklerinizi kullanın."
"[english]scenario_invisibility_task_kill_riki_Description"	"Stand near your Sentry Ward and use your attacks and abilities."
"scenario_invisibility_task_move_to_shop"	"Bir sonraki dükkâna ilerleyin."
"[english]scenario_invisibility_task_move_to_shop"	"Move to the next shop."
"scenario_invisibility_task_move_to_shop_Description"	"Kahramanınızı gösterilen yerin yakınına ilerletmek için sağ tıklayın."
"[english]scenario_invisibility_task_move_to_shop_Description"	"Right click to move your hero near the waypoint."
"scenario_invisibility_task_buy_dust"	"Dust of Appearence satın alın."
"[english]scenario_invisibility_task_buy_dust"	"Purchase Dust of Appearance."
"scenario_invisibility_task_buy_dust_Description"	"Dükkân butonuna tıklayın. Dust of Appearence'a sağ tıklayın."
"[english]scenario_invisibility_task_buy_dust_Description"	"Click on the Shop Button. Right-Click on the Dust of Appearance."
"scenario_invisibility_task_dust_bounty_hunter"	"Dust of Appearance aracılığıyla Bounty Hunter'ı açığa çıkartın."
"[english]scenario_invisibility_task_dust_bounty_hunter"	"Reveal Bounty Hunter with Dust of Appearance."
"scenario_invisibility_task_dust_bounty_hunter_Description"	"Bounty Hunter'ın yakınındayken envanterinizde bulunan Dust of Appearance'a tıklayın."
"[english]scenario_invisibility_task_dust_bounty_hunter_Description"	"Click on the Dust of Appearance in your inventory when near him."
"scenario_invisibility_task_kill_bounty_hunter"	"Nehre doğru kaçamadan Bounty Hunter'ı yenin."
"[english]scenario_invisibility_task_kill_bounty_hunter"	"Defeat Bounty Hunter before he escapes to the river."
"scenario_invisibility_task_kill_bounty_hunter_Description"	"Dust'ın etkisi altındayken ona karşı saldırılarınızı ve yeteneklerinizi kullanın."
"[english]scenario_invisibility_task_kill_bounty_hunter_Description"	"Use your attacks and abilities while he is dusted."
"scenario_invisibility_task_pick_up_gem"	"Gem of True Sight'ı alın."
"[english]scenario_invisibility_task_pick_up_gem"	"Pick up the Gem of True Sight."
"scenario_invisibility_task_pick_up_gem_Description"	"Gem'in üzerine sağ tıklayın."
"[english]scenario_invisibility_task_pick_up_gem_Description"	"Right-click on the Gem."
"scenario_invisibility_task_destroy_enemy_gem_wards"	"Gem'i kullanarak 3 düşman gözünü bulun ve yok edin."
"[english]scenario_invisibility_task_destroy_enemy_gem_wards"	"Find and destroy 3 enemy wards using the Gem."
"scenario_invisibility_task_destroy_enemy_gem_wards_Description"	"Bölgeyi aramak için kahramanınızı ilerletin ve önünüze çıkan gözlere sağ tıklayarak saldırın."
"[english]scenario_invisibility_task_destroy_enemy_gem_wards_Description"	"Move your hero to search the area and right-click the wards to destroy them."
"scenario_invisibility_wizard_tip_intro_Text"	"Görünmezlik, Dota 2'de büyük bir yer tutar.\nHer an etrafınızda birileri olabilir!"
"[english]scenario_invisibility_wizard_tip_intro_Text"	"Invisibility is an impactful aspect of Dota 2.\nAnything could be lurking out there!"
"scenario_invisibility_wizard_tip_sentry_wards_Text"	"Görünmez nesneleri açığa çıkarmak bu nöbetçi gözü kullanabilirsin."
"[english]scenario_invisibility_wizard_tip_sentry_wards_Text"	"You can use that Sentry Ward to detect invisible objects."
"scenario_invisibility_wizard_tip_observer_wards_Text"	"Bu bir düşman izleyici gözü!\nGözler görünmezdir ve ancak gerçek görüşle görülebilirler."
"[english]scenario_invisibility_wizard_tip_observer_wards_Text"	"It's an enemy Observer Ward!\nWards are invisible and you need True Sight to see them."
"scenario_invisibility_wizard_tip_dust_intro_Text"	"Görünmez kahramanları tespit etmenin farklı yolları mevcut.\nDükkândan Dust alın."
"[english]scenario_invisibility_wizard_tip_dust_intro_Text"	"There are other ways to detect invisible heroes.\nGrab some of that Dust from the shop."
"scenario_invisibility_wizard_tip_dust_Text"	"Dust of Appearance'la etraftaki düşman kahramanlar kısa süreliğine açığa çıkartılabilir.\nDust aynı zamanda bu kahramanları yavaşlatır."
"[english]scenario_invisibility_wizard_tip_dust_Text"	"Dust of Appearance can reveal invisible enemy heroes around you for a limited amount of time.\n It also slows them down."
"scenario_invisibility_wizard_tip_kill_riki_Text"	"Riki görünmez olabilen sinsi bir kahramandır. Nöbetçi göz tarafından açığa çıkan Riki'yi yenin."
"[english]scenario_invisibility_wizard_tip_kill_riki_Text"	"Riki is a sneaky hero that can turn invisible. Defeat him under the gaze of the Sentry Ward."
"scenario_invisibility_wizard_tip_pick_up_gem_Text"	"Bounty Hunter bir Gem düşürdü! Gem of True Sight'la hem görünmez birimleri hem de gözleri görebilirsiniz."
"[english]scenario_invisibility_wizard_tip_pick_up_gem_Text"	"Bounty Hunter dropped a Gem! The Gem of True Sight can detect both invisible units and wards."
"scenario_invisibility_wizard_tip_gem_care_Text"	"Gem'e dikkat edin! Pahalıdır ve öldüğünüzde düşebilen nadir eşyalardan biridir."
"[english]scenario_invisibility_wizard_tip_gem_care_Text"	"Careful with the Gem! It's expensive and it's one of the few items that will drop if you die."
"scenario_invisibility_failure_bounty_escaped"	"Bounty Hunter kaçtı."
"[english]scenario_invisibility_failure_bounty_escaped"	"Bounty Hunter Escaped."
"scenario_invisibility_failure_missed_dust"	"Dust of Appearance, Bounty Hunter'a isabet etmedi."
"[english]scenario_invisibility_failure_missed_dust"	"Failed to hit Bounty Hunter with Dust of Appearance."
"scenario_invisibility_items"	"Görünmezlik Algılayıcıları"
"[english]scenario_invisibility_items"	"Invisibility Detectors"
"DOTA_NPEDesc_scenario_invisibility_items"	"Gizli düşmanları ve gözleri bulmak için bu eşyaları kullanın."
"[english]DOTA_NPEDesc_scenario_invisibility_items"	"Use these items to find hidden enemies and wards."
"scenario_sven_task_root"	"Senaryonun sonundaki kötü bölüm sonu canavarını öldür!"
"[english]scenario_sven_task_root"	"Kill the evil boss at the end of the scenario!"
"scenario_sven_task_kill_creeps_first"	"Gnoll'ları öldür ama tamamını öldürme ki birkaç tanesini sorguya çekebilin!"
"[english]scenario_sven_task_kill_creeps_first"	"Kill those gnolls but leave some alive to interrogate them!"
"scenario_sven_task_chase_creeps"	"Ya da hepsini öldür gitsin! Yoksa alarmı çalabilirler! Kimseyi sağ bırakma!"
"[english]scenario_sven_task_chase_creeps"	"Actually, kill them all! Or they'll sound the alarm! Leave no survivors!"
"scenario_sven_task_cross_the_road"	"Cesur Centaur kendisini cesurca feda ederken kulenin yanından geç!"
"[english]scenario_sven_task_cross_the_road"	"Go past the tower while bald centaur bravely sacrifices himself!"
"scenario_sven_task_kill_more_creeps"	"Olamaz, daha fazla koruma geldi! Bunlar daha güçlü görünüyor! Dikkatli ol!"
"[english]scenario_sven_task_kill_more_creeps"	"Oh no, more guards! These look stronger! Dispose of them carefully!"
"scenario_sven_task_kill_a_lot_of_creeps"	"Gnoll'lar sayıca fazla. Onlarla savaşmadan önce iyileşmek iyi bir fikir olabilir."
"[english]scenario_sven_task_kill_a_lot_of_creeps"	"That's a lot of gnolls. Maybe you'll want to heal before going to fight them!"
"scenario_sven_task_pickup_rune"	"Sağlığını ve mananı yenilemek için bir yol bul!"
"[english]scenario_sven_task_pickup_rune"	"Find a way to restore your health and mana!"
"scenario_sven_task_buy_item"	"Tüccar'ı bul ve ondan bilgi edin."
"[english]scenario_sven_task_buy_item"	"Find the shopkeeper and get some information from him."
"scenario_sven_hint_narration_sven1_1"	"SVEN: Zindana sızıp Shadow Fiend'i öldürmenin bir yolunu bulmalıyım fakat gözcü kulesi geçit vermiyor. Birkaç tane Gnoll öldürürsem, belki geri kalan Gnoll'lar nasıl geçebileceğimi söyler."
"[english]scenario_sven_hint_narration_sven1_1"	"SVEN: I need to infiltrate the dungeon and kill Shadow Fiend, but there's no way I'll get past the watchtower. Maybe if I kill some gnolls, the other ones will tell me how to do it..."
"scenario_sven_hint_narration_sven1_2"	"Gnoll: Aaaah!"
"[english]scenario_sven_hint_narration_sven1_2"	"Gnoll: Agghhh"
"scenario_sven_hint_narration_sven1_3"	"Gnoll: Sana hiçbir şey söylemeyeceğiz! Kuleye doğru kaçın!"
"[english]scenario_sven_hint_narration_sven1_3"	"Gnoll: We'll never tell you anything! Run away to the tower!!"
"scenario_sven_hint_narration_sven1_4"	"Gnoll: YOLOOOOO!<br>Sven: Hay böyle işe... Hepsini öldürme vakti!"
"[english]scenario_sven_hint_narration_sven1_4"	"Gnoll: YOLOOOOO!!<br>Sven: Screw this, gotta kill them all!"
"scenario_sven_hint_narration_sven1_fail"	"Sven: Hepsini öldürdüm ama bu sefer de nasıl devam edeceğimi bilmiyorum :(  (Tekrar denemek için senaryoyu yeniden başlatın)"
"[english]scenario_sven_hint_narration_sven1_fail"	"Sven: I killed them all and now I don't know how to proceed :(   (Restart Scenario to try again)"
"scenario_sven_hint_narration_sven2_1"	"Centaur: Beni kurtardığın için teşekkürler! Kuleyi geçmenin yolu yok ama sen yanından geçene kadar kuleyi meşgul edebilirim."
"[english]scenario_sven_hint_narration_sven2_1"	"Centaur: Thank you for setting me free! There's no other way past the tower, but I can distract it while you pass."
"scenario_sven_hint_narration_sven2_2"	"Centaur: Acele et! Sonsuza kadar dayanamam."
"[english]scenario_sven_hint_narration_sven2_2"	"Centaur: Hurry!! I can only tank it for so long"
"scenario_sven_hint_narration_sven2_3"	"Centaur: Acele et! Sonsuza kadar dayanamam."
"[english]scenario_sven_hint_narration_sven2_3"	"Centaur: Hurry!! I can only tank it for so long"
"scenario_sven_hint_narration_sven2_4"	"Centaur: Öff, kuleler fena hasar veriyor, mecbur kalmadıkça yakınlarına girme!"
"[english]scenario_sven_hint_narration_sven2_4"	"Centaur: Man, towers really hurt, avoid them like the plague!"
"scenario_sven_hint_narration_sven2_5"	"Centaur: Öff, kuleler fena hasar veriyor, mecbur kalmadıkça yakınlarına girme!"
"[english]scenario_sven_hint_narration_sven2_5"	"Centaur: Man, towers really hurt, avoid them like the plague!"
"scenario_sven_hint_narration_sven2_6"	"Centaur: Ah, benden bu kadar, umarım hedefine ulaşırsın!"
"[english]scenario_sven_hint_narration_sven2_6"	"Centaur: Ugh, this is as far as I can go, hope you made it to the other side!"
"scenario_sven_hint_narration_sven2_7"	"Centaur: Ah, benden bu kadar, umarım hedefine ulaşırsın!"
"[english]scenario_sven_hint_narration_sven2_7"	"Centaur: Ugh, this is as far as I can go, hope you made it to the other side!"
"scenario_sven_hint_narration_sven2_centaur_dead"	"Centaur: Şanımı anlatan... Şarkılar söyle..."
"[english]scenario_sven_hint_narration_sven2_centaur_dead"	"Centaur: Sing songs... of my valor...."
"scenario_sven_hint_narration_sven3_gnolls_1"	"Gnoll: Amanın! Bir istilacı! Umarım bize normal bir şekilde saldırır ve başka numaralara başvurmaz!"
"[english]scenario_sven_hint_narration_sven3_gnolls_1"	"Gnoll: Look! An invader!! Hopefully he is just attacking us and has no tricks under his sleeve!"
"scenario_sven_hint_narration_sven3_gnolls_2"	"Gnoll: Uf! Bizi sersemletse falan hiç hoş olmazdı!"
"[english]scenario_sven_hint_narration_sven3_gnolls_2"	"Gnoll: Phew! Would've been really bad for us if he had a stun or something!"
"scenario_sven_hint_narration_sven3_gnolls_stun"	"Gnoll: Of! Sersemledim!"
"[english]scenario_sven_hint_narration_sven3_gnolls_stun"	"Gnoll: Ughh! Stunnedd!!"
"scenario_sven_hint_narration_sven4"	"Sven: Bayağı dayak yedim ama şunlardan biri iyileştirme iksiri düşürmüştü sanki... Devam etmeden önce içsem iyi olabilir..."
"[english]scenario_sven_hint_narration_sven4"	"Sven: I'm pretty banged up, but I think one of these guys dropped a healing potion... Maybe I can drink it before moving on..."
"scenario_sven_hint_narration_sven_death_tower"	"KULE: HAHAHAHA! APTAL İNSAN, BİR KULEYE ÖYLECE YAKLAŞABİLECEĞİNİ Mİ SANDIN? (Tekrar denemek için senaryoyu yeniden başlatın)"
"[english]scenario_sven_hint_narration_sven_death_tower"	"TOWER: MWAHAHAHA! SILLY HUMAN, THINKS HE CAN RUN INTO A TOWER LIKE THAT. (Restart the scenario to try again)"
"scenario_sven_hint_narration_sven_death_gnoll"	"Gnoll: Hiyak hiyak hiyak! (Tekrar denemek için senaryoyu yeniden başlatın)"
"[english]scenario_sven_hint_narration_sven_death_gnoll"	"Gnoll: Hyuck Hyuck Hyuck! (Restart the scenario to try again)"
"scenario_sven_hint_killed_them_all"	"Sven: Hmm, hepsini öldürürsem kulenin yanından geçmenin yolunu hayatta bulamam! (Tekrar denemek için senaryoyu yeniden başlatın)"
"[english]scenario_sven_hint_killed_them_all"	"Sven: Welp, if I kill them all at once, I'll never find out how to get past the tower! (Restart the scenario to try again)"
"scenario1_task_root"	"Kötü bölüm sonu canavarı Shadow Fiend'i öldürün ve barış getirin."
"[english]scenario1_task_root"	"Kill The Evil Boss Shadow Fiend and restore peace."
"scenario1_task_see_the_boss"	"Bölüm sonu canavarının yerini bulun."
"[english]scenario1_task_see_the_boss"	"Scout the boss's location."
"scenario1_task_kill_gnolls"	"Bölüm sonu canavarına kadar önünüze çıkan düşmanları öldürün."
"[english]scenario1_task_kill_gnolls"	"Kill the enemies in the way to the boss."
"scenario1_task_kill_centaur"	"Bölüm sonu canavarına giderken Centaur'u öldürün."
"[english]scenario1_task_kill_centaur"	"Kill the centaur in the way to the boss."
"scenario1_task_level_up"	"İlk yeteneğiniz Shrapnel'in seviyesini yükseltin."
"[english]scenario1_task_level_up"	"Level up your first skill, shrapnel."
"scenario1_task_kill_wolves"	"Yüksek bir yere çıkın ve oradaki düşmanları öldürün."
"[english]scenario1_task_kill_wolves"	"Scout the high ground and kill any enemies there."
"scenario1_task_see_the_tower"	"Düşman kulesini bulun."
"[english]scenario1_task_see_the_tower"	"Scout the enemy tower."
"scenario1_task_see_the_new_path"	"Kuleye giden yeni bir yol bulun."
"[english]scenario1_task_see_the_new_path"	"Find a new path to the tower."
"scenario1_task_kill_tower"	"Düşman kulesini yok edin."
"[english]scenario1_task_kill_tower"	"Kill the enemy tower."
"scenario1_task_see_the_boss_up_close"	"Bölüm sonu canavarıyla yüzleşin."
"[english]scenario1_task_see_the_boss_up_close"	"Go face the boss."
"scenario1_task_mini_bosses"	"Üç kötü komutanı yenin!"
"[english]scenario1_task_mini_bosses"	"Defeat the three evil commanders!"
"scenario1_task_kill_mirana"	"Mirana'yı öldürün."
"[english]scenario1_task_kill_mirana"	"Kill Mirana."
"scenario1_task_kill_underlord"	"Underlord'u öldürün."
"[english]scenario1_task_kill_underlord"	"Kill Underlord."
"scenario1_task_kill_broodmother"	"Broodmother'ı öldürün."
"[english]scenario1_task_kill_broodmother"	"Kill Broodmother."
"scenario1_task_learn_assassinate"	"Assassinate'i öğrenin."
"[english]scenario1_task_learn_assassinate"	"Learn Assassinate."
"scenario1_task_kill_the_boss"	"Shadow Fiend'i öldürün!"
"[english]scenario1_task_kill_the_boss"	"Kill Shadow Fiend!"
"npc_dota_badguys_tower1_bot_weak"	"Kule"
"[english]npc_dota_badguys_tower1_bot_weak"	"Tower"
"npc_dota_creature_scenario1_gnoll"	"Küçük Gnoll"
"[english]npc_dota_creature_scenario1_gnoll"	"Little Gnoll"
"scenario_economy_main_objective"	"Oyun Ortası İlerlemesi"
"[english]scenario_economy_main_objective"	"Mid-game Progression"
"scenario_economy_task_buy_echo_sabre"	"Şunu tamamlayın: {s:ItemName}"
"[english]scenario_economy_task_buy_echo_sabre"	"Complete an {s:ItemName}"
"scenario_economy_task_add_echo_sabre_to_quick_buy"	"\"Hızlı Al\"a {s:ItemName} ekleyin."
"[english]scenario_economy_task_add_echo_sabre_to_quick_buy"	"Add {s:ItemName} to Quick Buy"
"scenario_economy_task_add_echo_sabre_to_quick_buy_Description"	"Hızlı ala eklemek için önce eşyayı dükkânda bulun ardından Shift+Tık yapın ya da sürükleyin."
"[english]scenario_economy_task_add_echo_sabre_to_quick_buy_Description"	"Find it in the shop, then shift-click or drag to add it to Quick Buy."
"scenario_economy_task_buy_quarter_staff"	"{s:ItemName} alın."
"[english]scenario_economy_task_buy_quarter_staff"	"Buy a {s:ItemName}"
"scenario_economy_task_buy_quarter_staff_Description"	"Hızlı aldaki simgeye sağ tıklayın."
"[english]scenario_economy_task_buy_quarter_staff_Description"	"Right-click on the icon in the Quick Buy."
"scenario_economy_task_buy_sobi_mask"	"{s:ItemName} alın."
"[english]scenario_economy_task_buy_sobi_mask"	"Buy a {s:ItemName}"
"scenario_economy_task_buy_sobi_mask_Description"	"Hızlı aldaki simgeye sağ tıklayın."
"[english]scenario_economy_task_buy_sobi_mask_Description"	"Right-click on the icon in the Quick Buy."
"scenario_economy_task_teleport_to_bot_t1"	"Kuleye ışınlanın."
"[english]scenario_economy_task_teleport_to_bot_t1"	"Teleport to The Tower"
"scenario_economy_task_teleport_to_bot_t1_Description"	"Town Portall Scroll'a tıklayın ya da kısayol tuşuna basın, ardından kulenin yanına tıklayın."
"[english]scenario_economy_task_teleport_to_bot_t1_Description"	"Click or use the TP scroll hotkey, then click next to the tower."
"scenario_economy_task_earn_gold_for_robe"	"{s:Gold} altın kazanın."
"[english]scenario_economy_task_earn_gold_for_robe"	"Earn {s:Gold} Gold"
"scenario_economy_task_earn_gold_for_robe_Description"	"Altın ödülü kazanmak için bir düşmanı öldüren son vuruşu siz yapın."
"[english]scenario_economy_task_earn_gold_for_robe_Description"	"Get the last hit on an enemy unit to receive a gold bounty."
"scenario_economy_task_buy_robe"	"{s:ItemName} alın."
"[english]scenario_economy_task_buy_robe"	"Buy a {s:ItemName}"
"scenario_economy_task_buy_robe_Description"	"Hızlı aldaki simgeye sağ tıklayın."
"[english]scenario_economy_task_buy_robe_Description"	"Right-click on the icon in the Quick Buy."
"scenario_economy_task_buy_tp_scroll"	"{s:ItemAmount} adet {s:ItemName} alın."
"[english]scenario_economy_task_buy_tp_scroll"	"Buy {s:ItemAmount} {s:ItemName}s"
"scenario_economy_task_buy_tp_scroll_Description"	"Hızlı aldaki simgeye sağ tıklayın."
"[english]scenario_economy_task_buy_tp_scroll_Description"	"Right-click on the icon in the Quick Buy."
"scenario_economy_task_retrieve_robe_with_courier"	"Kuryeyi kullanın."
"[english]scenario_economy_task_retrieve_robe_with_courier"	"Use the Courier"
"scenario_economy_task_retrieve_robe_with_courier_Description"	"\"Eşyaları Kuryeyle Teslim Et\" butonunu kullanarak üssünüzdeki eşyalarınızı alın."
"[english]scenario_economy_task_retrieve_robe_with_courier_Description"	"Retrieve items from the base with your courier by using the Deliver Items button."
"scenario_economy_task_deliver_robe_with_courier"	"Kuryenizle güvenli bir yerde buluşun."
"[english]scenario_economy_task_deliver_robe_with_courier"	"Meet Your Courier In A Safe Place"
"scenario_economy_task_deliver_robe_with_courier_Description"	"Düşmanlardan uzaklaşın ve kendi kulenizin arkasına geçin."
"[english]scenario_economy_task_deliver_robe_with_courier_Description"	"Move away from the enemies behind your Tower."
"scenario_economy_task_gain_level_9"	"{s:Level}. seviyeye ulaşın."
"[english]scenario_economy_task_gain_level_9"	"Reach Level {s:Level}"
"scenario_economy_task_gain_level_9_Description"	"Ölmek üzere olan birimlerin yakınında olarak tecrübe puanı kazanın."
"[english]scenario_economy_task_gain_level_9_Description"	"Earn experience by being near dying enemy units."
"scenario_economy_task_learn_great_cleave"	"{s:AbilityName} yeteneğini öğrenin."
"[english]scenario_economy_task_learn_great_cleave"	"Learn {s:AbilityName}"
"scenario_economy_task_learn_great_cleave_Description"	"Üstünde yer alan butona tıklayarak {s:AbilityName} yeteneğinin seviyesini yükseltin."
"[english]scenario_economy_task_learn_great_cleave_Description"	"Level up the {s:AbilityName} ability by clicking on the upgrade button above it."
"scenario_economy_task_gain_level_10"	"{s:Level}. seviyeye ulaşın."
"[english]scenario_economy_task_gain_level_10"	"Reach Level {s:Level}"
"scenario_economy_task_gain_level_10_Description"	"Ölmek üzere olan birimlerin yakınında olarak tecrübe puanı kazanın."
"[english]scenario_economy_task_gain_level_10_Description"	"Earn experience by being near dying enemy units."
"scenario_economy_task_learn_a_talent"	"{s:AbilityName} hünerini öğrenin."
"[english]scenario_economy_task_learn_a_talent"	"Learn {s:AbilityName}"
"scenario_economy_task_learn_a_talent_Description"	"Hüner ağacına tıklayın ve {s:AbilityName} hünerini seçin."
"[english]scenario_economy_task_learn_a_talent_Description"	"Click on the talent tree to pick the talent {s:AbilityName}."
"scenario_economy_task_clear_the_jungle"	"Tarafsız yaratık kamplarını temizleyin."
"[english]scenario_economy_task_clear_the_jungle"	"Clear Neutral Creep Camps"
"scenario_economy_task_clear_the_jungle_Description"	"Her kamptaki yaratıkları yenin."
"[english]scenario_economy_task_clear_the_jungle_Description"	"Defeat all of the creeps at each camp."
"scenario_economy_task_send_grove_bow_to_stash"	"Takımın Tarafsız Zula'sına {s:ItemName} gönderin."
"[english]scenario_economy_task_send_grove_bow_to_stash"	"Send the {s:ItemName} to the team Neutral Stash"
"scenario_economy_task_send_grove_bow_to_stash_Description"	"Sırt çantanızdaki Grove Bow'a sağ tıklayın ve \"Tarafsız Zula'ya Işınla\" seçeneğini seçin."
"[english]scenario_economy_task_send_grove_bow_to_stash_Description"	"Right-click on the Grove Bow in your backpack, and select 'Teleport to Neutral Stash'"
"scenario_economy_task_defend_tower_and_kill_sf"	"Kulenizi savunun ve Shadow Fiend'i yenin."
"[english]scenario_economy_task_defend_tower_and_kill_sf"	"Defend your tower and defeat Shadow Fiend"
"scenario_economy_task_protect_tower"	"Kuleyi koruyun."
"[english]scenario_economy_task_protect_tower"	"Protect the Tower"
"scenario_economy_task_protect_tower_Description"	"Kulenize saldıran düşmanlara saldırın."
"[english]scenario_economy_task_protect_tower_Description"	"Attack enemies that are attacking your tower."
"scenario_economy_task_kill_sf"	"Shadow Fiend'i yenin."
"[english]scenario_economy_task_kill_sf"	"Defeat Shadow Fiend"
"scenario_economy_task_kill_sf_Description"	"Shadow Fiend'i yenmek için temel saldırılarınızı ve yeteneklerinizi kullanın."
"[english]scenario_economy_task_kill_sf_Description"	"Use your basic attack and abilities to defeat Shadow Fiend."
"scenario_economy_task_teleport_to_bot_t1_again"	"Kuleye ışınlanın."
"[english]scenario_economy_task_teleport_to_bot_t1_again"	"Teleport to The Tower"
"scenario_economy_task_teleport_to_bot_t1_again_Description"	"Town Portall Scroll'a tıklayın ya da kısayol tuşuna basın, ardından kulenin yanına tıklayın."
"[english]scenario_economy_task_teleport_to_bot_t1_again_Description"	"Click or use the TP scroll hotkey, then click next to the tower."
"scenario_economy_task_neutral_creeps_and_items"	"Tarafsız yaratıklarla güçlenin."
"[english]scenario_economy_task_neutral_creeps_and_items"	"Get stronger from Neutral Creeps"
"scenario_economy_task_pick_up_imp_claw"	"{s:ItemName} eşyasını alın."
"[english]scenario_economy_task_pick_up_imp_claw"	"Pick up the {s:ItemName}"
"scenario_economy_task_pick_up_imp_claw_Description"	"Eşyayı almak için üzerine sağ tıklayın."
"[english]scenario_economy_task_pick_up_imp_claw_Description"	"Right-click on the item to pick it up."
"scenario_economy_task_pick_up_grove_bow"	"{s:ItemName} eşyasını alın."
"[english]scenario_economy_task_pick_up_grove_bow"	"Pick up the {s:ItemName}"
"scenario_economy_task_pick_up_grove_bow_Description"	"Eşyayı almak için üzerine sağ tıklayın."
"[english]scenario_economy_task_pick_up_grove_bow_Description"	"Right-click on the item to pick it up."
"scenario_economy_wizard_tip_echo_sabre_Text"	"Shadow Fiend'i alt etmek için güçlenmelisiniz. Önce bir Echo Sabre tamamlayalım ve seviye atlayalım."
"[english]scenario_economy_wizard_tip_echo_sabre_Text"	"You'll need to become more powerful to take down that Shadow Fiend.  Let's complete an Echo Sabre and level up."
"scenario_economy_wizard_tip_last_hit_enemy_creeps_Text"	"Eşyamızı tamamlayacak yeterince altınımız yok, o hâlde ilave altın ve tecrübe kazanmak için bir kulvara gidelim."
"[english]scenario_economy_wizard_tip_last_hit_enemy_creeps_Text"	"We don't have enough gold to finish our item, so it's time to head out into the lane to get some additional gold and experience."
"scenario_economy_wizard_tip_use_the_courier_Text"	"Her oyuncunun üsten eşyaları getirtebileceği bir kuryesi vardır!"
"[english]scenario_economy_wizard_tip_use_the_courier_Text"	"Each player has a courier that can retrieve items from the base for you!"
"scenario_economy_wizard_tip_safe_courier_usage_Text"	"Kuryeniz düşmanlar tarafından öldürülebilir olduğundan, onunla güvenli bir yerde buluşun."
"[english]scenario_economy_wizard_tip_safe_courier_usage_Text"	"Your courier can be killed by enemies, so try to meet it in a safe place."
"scenario_economy_wizard_tip_double_tap_to_center_Text"	"Kamerayı tekrar kendi kahramanınızın üzerine getirmek için \"Kahramanı Seç\" kısayol tuşuna hızlıca iki defa basabilirsiniz."
"[english]scenario_economy_wizard_tip_double_tap_to_center_Text"	"You can press your 'Select Hero' hotkey twice quickly to recenter the camera on your Hero."
"scenario_economy_wizard_tip_farm_the_jungle_Text"	"Kulvarların dışında tarafsız yaratıklar vardır. Bunları yenerek daha fazla altın ve tecrübe kazanabilirsiniz."
"[english]scenario_economy_wizard_tip_farm_the_jungle_Text"	"Outside of the lanes, you can find Neutral Creeps, which can also be defeated to earn more gold and experience."
"scenario_economy_wizard_tip_imp_claw_Text"	"Tarafsız yaratıklar ayrıca tarafsız eşyalar düşürme şansına sahiptir. Bu eşyalardan aynı anda bir tane kuşanabilirsiniz fakat isterseniz bu eşyaları takım arkadaşlarınızla da paylaşabilirsiniz."
"[english]scenario_economy_wizard_tip_imp_claw_Text"	"Neutral creeps can also drop a special type of item called a Neutral Item.  You can only equip one of these at once, but they can be shared with teammates."
"scenario_economy_wizard_tip_grove_bow_Text"	"Her oyunda çeşitli birçok tarafsız eşya bulabilirsiniz. İstemediğiniz tarafsız eşyaları üssünüze geri gönderebilirsiniz."
"[english]scenario_economy_wizard_tip_grove_bow_Text"	"You can find a variety of Neutral Items in each game.  Neutral Items you don't want can be sent back to the base at any time."
"scenario_economy_wizard_tip_talents_Text"	"Kahramanınız 10. seviyeye ulaştığında hünerleri öğrenmeye başlarsınız. Şu seviyelerde birer hüner seçebilirsiniz: 10, 15 ve 20. Son seviye olan 30. seviyedeyse bütün hünerler açılır."
"[english]scenario_economy_wizard_tip_talents_Text"	"Once your hero reaches level 10, you unlock the ability to learn special Talents.  You can only choose one at levels 10, 15, 20, and 25.  At level 30, all talents are unlocked."
"scenario_economy_wizard_tip_fight_near_tower_Text"	"Kulenizi savunun! Kule, düşmanlara saldırır ve yakındaki birimlere ilave zırh ve yenilenme sağlayan bir aura verir."
"[english]scenario_economy_wizard_tip_fight_near_tower_Text"	"Defend your tower!  The tower attacks your enemies, and provides nearby units with an aura for additional armor and regen."
"scenario_economy_wizard_tip_neutral_creep_camps_Text"	"Küçük, orta, büyük ve Kadim tarafsız yaratık kampları vardır. Sırasıyla her biri bir öncekinden daha tehlikelidir ama tehlike seviyesi arttıkça gelen tecrübe ve altın da artar."
"[english]scenario_economy_wizard_tip_neutral_creep_camps_Text"	"There are small, medium, large, and Ancient neutral creep camps, each being progressively more dangerous while also giving more experience and gold."
"scenario_economy_wizard_tip_backpack_Text"	"Grove Bow sırt çantanıza geldi. Normal envanterinize sığmayan eşyalar sırt çantanızda saklanabilir fakat bu eşyaları ana envanterinize koyana kadar kullanamazsınız."
"[english]scenario_economy_wizard_tip_backpack_Text"	"The Grove Bow went into your backpack.  Extra items that don't fit in your normal inventory can be held there, but not used until you put them in your main inventory."
"scenario_economy_ui_tip_click_to_open_shop"	"Dükkânı açmak için buraya tıklayın!"
"[english]scenario_economy_ui_tip_click_to_open_shop"	"Click here to open the shop!"
"scenario_economy_ui_tip_item_guide"	"Eşyayı hızlı ala eklemek için Shift + Sol Tık yapın."
"[english]scenario_economy_ui_tip_item_guide"	"Shift + Left-click to add the item to quick-buy."
"scenario_economy_ui_tip_right_click_neutral_item"	"Bir eşyanın seçeneklerini görmek için üzerine sağ tıklayın."
"[english]scenario_economy_ui_tip_right_click_neutral_item"	"Right-click an item to see its options."
"wizard_tip_failed_tp_wrong_location_Text"	"Tüh! Görünüşe göre yanlış yere ışınladınız. Town Portal Scroll'unuzu tazeledim, tekrar deneyelim!"
"[english]wizard_tip_failed_tp_wrong_location_Text"	"Oops!  Looks like you teleported to the wrong place.  I've refreshed your Town Portal Scroll; let's try again!"
"wizard_tip_failed_tp_interrupted_Text"	"Tüh! Town Portal Scroll yönlendirilen bir yetenektir ve kullanırken başka bir şey yapmaya çalıştığınız anda iptal olur! Town Portal Scroll'unuzu tazeledim, tekrar deneyelim!"
"[english]wizard_tip_failed_tp_interrupted_Text"	"Oops!  The Town Portal Scroll is a channelled ability; you can't do anything else while it's being used or it will be cancelled! I've refreshed your Town Portal Scroll; let's try again!"
"scenario_economy_dialog_complete_echo_sabre"	"Shadow Fiend'i yenmek için bazı eşyalara ihtiyacım var. Daha fazla hasar verebilmek için bir Echo Sabre tamamlamalıyım."
"[english]scenario_economy_dialog_complete_echo_sabre"	"I'll need some items to take down that Shadow Fiend.  I should complete an Echo Sabre, so I can deal more damage."
"scenario_economy_dialog_last_hit_enemy_creep"	"Düşman yaratıklara son vuruş yaparak altın kazanabilirim."
"[english]scenario_economy_dialog_last_hit_enemy_creep"	"I can earn gold by last hitting enemy creeps."
"scenario_economy_dialog_use_the_courier"	"Eşyalarımı almak için üsse gitmeme gerek yok. Kuryem eşyalarımı bana getirebilir!"
"[english]scenario_economy_dialog_use_the_courier"	"I don't have to be in base to get my items; my trusty Courier can do it for me!"
"scenario_economy_dialog_farm_jungle"	"Artık Great Cleave'im olduğuna göre tarafsız yaratık kamplarını hızlıca temizleyebilir ve daha fazla altın ve tecrübe kazanabilirim."
"[english]scenario_economy_dialog_farm_jungle"	"Now that I have Great Cleave, I can clear Neutral Creep Camps faster, for more gold and experience!"
"scenario_economy_dialog_found_imp_claw"	"Imp Claw! Aynı anda sadece bir tane tarafsız eşya kullanabilirim; Imp Claw hasarımı yükselteceği için tam benlik!"
"[english]scenario_economy_dialog_found_imp_claw"	"Ah, an Imp Claw!  I can use only one Neutral Item at a time; Imp Claw boosts my damage even more so it will be perfect!"
"scenario_economy_hint_how_to_tp"	"TP'yi kullanmak için önce {s:keybind}, sonra {s:secondary_keybind} tuşuna basın."
"[english]scenario_economy_hint_how_to_tp"	"{s:keybind} then {s:secondary_keybind} to use TP Scroll"
"scenario_economy_hint_how_to_pickup_item"	"Eşyaları almak için {s:alternate_keybind} tuşuna basın."
"[english]scenario_economy_hint_how_to_pickup_item"	"{s:alternate_keybind} to pickup item"
"scenario_mid_1v1_task_get_last_hits"	"Düşman yaratıklara son vuruşu yapın."
"[english]scenario_mid_1v1_task_get_last_hits"	"Last hit enemy creeps"
"scenario_mid_1v1_task_get_denies"	"Dost yaratıkları reddedin."
"[english]scenario_mid_1v1_task_get_denies"	"Deny friendly creeps"
"scenario_mid_1v1_task_do_not_die"	"Hayatta kalmalısınız."
"[english]scenario_mid_1v1_task_do_not_die"	"You must survive"
"scenario_mid_1v1_hint_enemy_hero_damage"	"Düşman kulvarındaki kahramandan çok fazla saldırı hasarı almamaya bakın! Son vuruşları ve reddetmeleri yapacak kadar açılın fakat düşman kahramanın saldırılarının menziline girmeyin."
"[english]scenario_mid_1v1_hint_enemy_hero_damage"	"Avoid taking too much attack damage from the enemy laner!  Try to stay out of range of its attacks while being in range to get last hits and denies."
"scenario_earthshaker_intro_hint_how_to_move"	"Hareket etmek için {s:keybind} tuşuna basın."
"[english]scenario_earthshaker_intro_hint_how_to_move"	"{s:keybind} to move"
"scenario_intro_task_move_to_location_1"	"Kahramanınızı hedefe doğru ilerletin."
"[english]scenario_intro_task_move_to_location_1"	"Move your hero to the target."
"scenario_intro_task_move_to_location_2"	"Kahramanınızı hedefe doğru ilerletin."
"[english]scenario_intro_task_move_to_location_2"	"Move your hero to the target."
"scenario_intro_task_move_to_location_3"	"Kahramanınızı hedefe doğru ilerletin."
"[english]scenario_intro_task_move_to_location_3"	"Move your hero to the target."
"scenario_intro_hint_how_to_move"	"Buraya ilerlemek için sağ tıklayın."
"[english]scenario_intro_hint_how_to_move"	"Right-click to move here."
"scenario_intro_hint_narration_move"	"Kahramanınızı işarete doğru ilerletin."
"[english]scenario_intro_hint_narration_move"	"Move your hero to the marker."
"scenario_intro_hint_narration_fow"	"Haritanın karanlık kısmına \"Savaş Sisi\" denir ve kahramanınızın göremediği bölgeleri temsil eder."
"[english]scenario_intro_hint_narration_fow"	"The dark area of the map is called Fog of War and shows the area your hero does not have vision to."
"scenario_objectives_main_objective"	"Roshan'ı yenin ve Aegis of the Immortal'ı alın."
"[english]scenario_objectives_main_objective"	"Defeat Roshan and Claim the Aegis of the Immortal"
"scenario_navigation_main_objective"	"Tüm kontrol noktalarını geçerek dünyayı dolaşın."
"[english]scenario_navigation_main_objective"	"Navigate through the world passing all the checkpoints"
"scenario_navigation_task_move_to_location_1"	"Kahramanınızı ilk işaretli alana götürün."
"[english]scenario_navigation_task_move_to_location_1"	"Move your hero to the first marker"
"scenario_navigation_task_move_to_location_1_Description"	"Hareket etmek için zemine sağ tıklayın."
"[english]scenario_navigation_task_move_to_location_1_Description"	"Right-Click on the ground to move."
"scenario_navigation_task_move_to_location_2"	"Kahramanınızı sonraki işaretli alana götürün."
"[english]scenario_navigation_task_move_to_location_2"	"Move your hero to the next marker"
"scenario_navigation_task_move_to_location_2_Description"	"Farenizi ekranın kenarlarına doğru hareket ettirerek kamerayı oynatın."
"[english]scenario_navigation_task_move_to_location_2_Description"	"Pan the camera by moving your cursor to the edges of the screen."
"scenario_navigation_task_move_to_location_3"	"Kahramanınızı sonraki işaretli alana götürün."
"[english]scenario_navigation_task_move_to_location_3"	"Move your hero to the next marker"
"scenario_navigation_task_move_to_location_3_Description"	"Kısa süreliğine hareket hızı artışı için \"Phase Boots\"unuzu kullanın. Simgesine veya tuşuna basarak etkinleştirin."
"[english]scenario_navigation_task_move_to_location_3_Description"	"For a temporary speed increase use your ‘Phase Boots’.  Activate them by clicking their icon or pressing their hotkey."
"scenario_navigation_task_move_to_location_4"	"Engelden ışınlanarak geçin ve sonraki işaretli alana gidin."
"[english]scenario_navigation_task_move_to_location_4"	"Blink past the obstacle then travel to the next marker"
"scenario_navigation_task_move_to_location_4_Description"	"\"Blink Dagger\" sizi kısa mesafede ışınlar. Simgesine veya tuşuna basarak Blink Dagger'ı etkinleştirin ve ardından ışınlanmak için dünyada bir yere tıklayın."
"[english]scenario_navigation_task_move_to_location_4_Description"	"‘Blink Dagger’ teleports you short distances.  Activate the blink dagger by clicking its icon or pressing its hotkey then blink by clicking a location in the world."
"scenario_navigation_task_move_to_location_5"	"Birimlerin içinden geçerek sonraki işaretli alana gidin."
"[english]scenario_navigation_task_move_to_location_5"	"Phase through the units and get to the next marker"
"scenario_navigation_task_move_to_location_5_Description"	"Birimlerin içinden geçmek için \"Phase Boots\"u kullanın. Öncelikle ilgili tuşa basarak eşyayı etkinleştirin, ardından yolunuzu engelleyen birimlerin içinden koşun."
"[english]scenario_navigation_task_move_to_location_5_Description"	"To travel through units use ‘Phase Boots’.  Activate them with the hotkey and run through the units blocking your path."
"scenario_navigation_task_move_to_location_6"	"Kahramanınızı sonraki işaretli alana götürün."
"[english]scenario_navigation_task_move_to_location_6"	"Move your hero to the next marker"
"scenario_navigation_task_move_to_location_6_Description"	"Rünler geçici güçlendirmelerdir. \"Sürat Rünü\"ne sağ tıklayarak alın ve sonraki işaretli alana koşun. Rünler alındığında otomatik olarak etkinleşir."
"[english]scenario_navigation_task_move_to_location_6_Description"	"Runes are temporary power-ups.  Right-Click on the ‘Haste Rune’ to pick it up and then run to the next marker.  Runes are automatically activated upon pick-up."
"scenario_navigation_task_learn_mirana_leap"	"Leap yeteneğinin seviyesini yükseltin."
"[english]scenario_navigation_task_learn_mirana_leap"	"Level up the ability Leap"
"scenario_navigation_task_learn_mirana_leap_Description"	"Yetenekler bölümünden Leap yeteneğinin üzerindeki + sembolüne tıklayın."
"[english]scenario_navigation_task_learn_mirana_leap_Description"	"Click on the + symbol above Leap in your abilities."
"scenario_navigation_task_move_to_location_7"	"Leap ile sonraki işaretli alana gidin."
"[english]scenario_navigation_task_move_to_location_7"	"Use Leap to get to the next marker"
"scenario_navigation_task_move_to_location_7_Description"	"İleri doğru zıplamak için \"Leap\" tuşuna basın."
"[english]scenario_navigation_task_move_to_location_7_Description"	"Press your 'Leap' hotkey to jump forward."
"scenario_navigation_task_move_to_location_end"	"Kahramanınızı son işaretli alana götürün."
"[english]scenario_navigation_task_move_to_location_end"	"Move your hero to the final marker"
"scenario_navigation_task_move_to_location_end_Description"	"\"Force Staff\" birimleri ve kahramanları kısa bir mesafe iter. İlerlemenizi engelleyen birimi kenara ittirmek için eşyanın üzerine tıklayın veya kısayol tuşunu kullanın."
"[english]scenario_navigation_task_move_to_location_end_Description"	"‘Force Staff’ pushes units and heroes a short distance.  Cast it on a unit blocking you to move them aside by clicking its icon or pressing its hotkey and then clicking the unit."
"scenario_navigation_time_spent"	"Geçen Süre:"
"[english]scenario_navigation_time_spent"	"Time Spent:"
"scenario_navigation_wizard_tip_center_camera_Text"	"Kahramanınızın portresine tıklayarak kamerayı kahramanın üzerine getirin."
"[english]scenario_navigation_wizard_tip_center_camera_Text"	"Center on your hero by clicking on their portrait."
"scenario_navigation_wizard_tip_leap_Text"	"Leap, bariyerlerin üzerinden veya farklı yükseklikler arasında hareket edebilmenizi sağlar. Leap'i kullanmak şarj sayısını azaltacaktır."
"[english]scenario_navigation_wizard_tip_leap_Text"	"Leap allows you to traverse over barriers or between different elevations.  Casting Leap will reduce its number of charges."
"scenario_navigation_wizard_tip_phase_Text"	"Phase Boots etkinleştirildiğinde dolum süresine girer. Belirli durumlarda daha kullanışlı olsa da etkinleştirilebilir olduğu her an Phase Boots'u kullanabilirsiniz. Botların tek bir eşya olarak sayıldığını aklınızda bulundurun."
"[english]scenario_navigation_wizard_tip_phase_Text"	"Phase Boots have a cooldown after activating them.  You can use Phase Boots whenever active although they may be more useful in other situations.  Note that boots count as a single item."
"scenario_navigation_wizard_tip_blink_Text"	"Blink Dagger, normalde aşılamaz engelleri geçmenize izin verir."
"[english]scenario_navigation_wizard_tip_blink_Text"	"Blink Dagger allows you to traverse normally impassable barriers."
"scenario_navigation_wizard_tip_block_Text"	"Birimler diğer birimleri engeller. Phase Boots'u kullanmak geçici olarak birimlerin içinden geçmenizi sağlar."
"[english]scenario_navigation_wizard_tip_block_Text"	"Units block other units.  Using Phase Boots temporarily allows you to pass through units."
"scenario_navigation_wizard_tip_force_Text"	"Force Staff, engellerden geçmenizi sağlar. Force Staff'a iki kez tıklamak otomatik olarak kahramanınızı ileri doğru iter."
"[english]scenario_navigation_wizard_tip_force_Text"	"Force Staff allows you to traverse through barriers.  Double-click Force Staff to automatically push your hero forward."
"scenario_navigation_ui_tip_use_boots"	"Phase Boots'u etkinleştirmek için buraya tıklayın."
"[english]scenario_navigation_ui_tip_use_boots"	"Click here to Activate Phase Boots"
"scenario_navigation_ui_tip_use_blink"	"Blink Dagger'ı kullanmak için buraya tıklayın."
"[english]scenario_navigation_ui_tip_use_blink"	"Click here to Queue Blink Dagger"
"scenario_navigation_ui_tip_use_leap"	"İleri doğru sıçramak için buraya tıklayın."
"[english]scenario_navigation_ui_tip_use_leap"	"Click here to Leap Forward"
"scenario_navigation_ui_tip_use_force"	"Force Staff'ı kullanmak için buraya tıklayın."
"[english]scenario_navigation_ui_tip_use_force"	"Click here to Queue Force Staff"
"initiation_teamfight_main_objective"	"Takım savaşlarını nasıl başlatacağınızı öğrenin."
"[english]initiation_teamfight_main_objective"	"Learn how to initiate team fights."
"initiation_teamfight_task_root"	"[Ana görev]"
"[english]initiation_teamfight_task_root"	"[Root task]"
"initiation_teamfight_tip_ravage_primer_Text"	"Ravage, geniş bir alandaki düşmanları sersemletir."
"[english]initiation_teamfight_tip_ravage_primer_Text"	"Ravage stuns enemies in a large area."
"initiation_teamfight_task_go_into_trees"	"Düşmanlar yaklaşırken ağaçların arasında saklanın."
"[english]initiation_teamfight_task_go_into_trees"	"Hide in the trees as enemies approach."
"initiation_teamfight_task_go_into_trees_Description"	"Bir sonraki işaretli yere ilerleyin."
"[english]initiation_teamfight_task_go_into_trees_Description"	"Move to the next waypoint."
"initiation_teamfight_tip_queenofpain_combo_Text"	"Siz Ravage kullandıktan sonra dostunuz da son yeteneğini kullanacak."
"[english]initiation_teamfight_tip_queenofpain_combo_Text"	"Your ally will use her ultimate after you cast Ravage."
"initiation_teamfight_task_win_teamfight"	"2v2 savaşı kazanın."
"[english]initiation_teamfight_task_win_teamfight"	"Win the 2v2 fight"
"initiation_teamfight_task_win_teamfight_Description"	"Her iki düşmanı da öldürün. Queen of Pain'in ölmesine ve kulenizin yok olmasına izin vermeyin."
"[english]initiation_teamfight_task_win_teamfight_Description"	"Kill both enemies. Keep Queen of Pain and your tower alive."
"initiation_teamfight_task_ravage_and_kill_enemies"	"Bütün düşmanlarınız üzerinde Ravage kullanın."
"[english]initiation_teamfight_task_ravage_and_kill_enemies"	"Ravage all enemies"
"initiation_teamfight_task_protect_allies"	"Queen of Pain'in ölmesine ve kulenizin yok olmasına izin vermeyin."
"[english]initiation_teamfight_task_protect_allies"	"Keep Queen of Pain and the tower alive"
"initiation_teamfight_task_move_to_p2_loc"	"Devam"
"[english]initiation_teamfight_task_move_to_p2_loc"	"Proceed"
"initiation_teamfight_task_move_to_p2_loc_Description"	"Bir sonraki işaretli yere ilerleyin."
"[english]initiation_teamfight_task_move_to_p2_loc_Description"	"Move to the next waypoint."
"initiation_teamfight_tip_blink_gained_Text"	"Kısa mesafede anında ışınlanmanıza olanak tanıyan Blink Dagger'ı elde ettiniz."
"[english]initiation_teamfight_tip_blink_gained_Text"	"You've gained Blink Dagger, an item that lets you instantly teleport a short distance."
"initiation_teamfight_tip_move_with_team_Text"	"Takımınızla ilerleyin."
"[english]initiation_teamfight_tip_move_with_team_Text"	"Move forward with your team"
"initiation_teamfight_task_win_second_teamfight"	"3v3 takım savaşını kazanın."
"[english]initiation_teamfight_task_win_second_teamfight"	"Win the 3v3 teamfight"
"initiation_teamfight_task_win_second_teamfight_Description"	"Takımınız için avantajlı savaş şartları oluşturmak adına Blink Dagger ve Ravage kullanın."
"[english]initiation_teamfight_task_win_second_teamfight_Description"	"Use Blink Dagger and Ravage to set up the fight for your team."
"initiation_teamfight_tip_enigma_bkb_Text"	"Enigma, Black Kink Bar'ı kullanarak büyüye karşı bağışıklık kazanmadan önce Ravage'ınızı kullanın."
"[english]initiation_teamfight_tip_enigma_bkb_Text"	"Land your Ravage before Enigma uses Black King Bar and becomes magic immune."
"initiation_teamfight_task_blink_ravage_enemies"	"Düşmanların tepki göstermesine fırsat vermemek için Blink Dagger'la aralarına ışınlanın, ardından Ravage kullanın."
"[english]initiation_teamfight_task_blink_ravage_enemies"	"Blink in and Ravage before enemies can react."
"initiation_teamfight_task_protect_allies_p2"	"Dostlarınızı hayatta tutun, düşmanların hepsini öldürün."
"[english]initiation_teamfight_task_protect_allies_p2"	"Keep allies alive and kill all the enemies."
"initiation_teamfight_failure_protect_units"	"Bir dost öldü."
"[english]initiation_teamfight_failure_protect_units"	"An ally died."
"lockdown_single_target"	"Tek Hedefi Devre Dışı Bırakma"
"[english]lockdown_single_target"	"Single Target Lockdown"
"lockdown_single_target_main_objective"	"Düşmanları uzun süreliğine ekarte etmek için kontrol büyülerini kullanın."
"[english]lockdown_single_target_main_objective"	"Use control spells to disable enemies for long periods of time."
"lockdown_single_target_task_root"	"[Ana görev]"
"[english]lockdown_single_target_task_root"	"[Root task]"
"lockdown_single_target_task_move_to_lina"	"Lina'ya gidin."
"[english]lockdown_single_target_task_move_to_lina"	"Go to Lina."
"lockdown_single_target_task_move_to_lina_Description"	"Bir sonraki işaretli yere ilerleyin."
"[english]lockdown_single_target_task_move_to_lina_Description"	"Move to the next waypoint."
"lockdown_single_target_tip_channeled_spells_Text"	"Shackles süreli bir büyüdür yani hareket ederseniz, düşman tarafından sersemletilir ya da susturulursanız büyü yarıda kesilir."
"[english]lockdown_single_target_tip_channeled_spells_Text"	"Shackles is a channeled spell, meaning it's interrupted when you move and when enemies stun or silence you."
"lockdown_single_target_task_protect_lina"	"Lina'yı koruyun."
"[english]lockdown_single_target_task_protect_lina"	"Protect Lina."
"lockdown_single_target_task_protect_lina_Description"	"Lina'yla ilerleyin ve Lina ışınlanmaya başladığında Bane'i devre dışı bırakın."
"[english]lockdown_single_target_task_protect_lina_Description"	"Move forward with Lina and disable Bane while she teleports out."
"lockdown_single_target_task_move_to_drow_ranger"	"Drow Ranger'a gidin."
"[english]lockdown_single_target_task_move_to_drow_ranger"	"Go to Drow Ranger."
"lockdown_single_target_task_move_to_drow_ranger_Description"	"Bir sonraki işaretli yere ilerleyin."
"[english]lockdown_single_target_task_move_to_drow_ranger_Description"	"Move to the next waypoint."
"lockdown_single_target_tip_hex_gained_Text"	"Artık Hex yeteneğiniz var. Bu yetenek sayesinde düşmanları artık daha fazla devre dışı bırakabileceksiniz."
"[english]lockdown_single_target_tip_hex_gained_Text"	"You've gained Hex. With this ability you can disable enemies even longer."
"lockdown_single_target_task_kill_queenofpain"	"Drow Ranger'ın yardımıyla Quen of Pain'i öldürün."
"[english]lockdown_single_target_task_kill_queenofpain"	"Kill Queen of Pain with Drow's help."
"lockdown_single_target_task_kill_queenofpain_Description"	"Drow Ranger, Queen of Paine'e saldırırken Queen of Pain üzerinde Shackles ve Hex yeteneklerinizi kullanın."
"[english]lockdown_single_target_task_kill_queenofpain_Description"	"Use Shackles and Hex on Queen of Pain while Drow Ranger attacks her."
"lockdown_single_target_tip_queenofpain_blink_Text"	"Queen of Pain'i ölene kadar sersemlemiş bir vaziyette tutmazsanız, Blink kullanarak kaçar."
"[english]lockdown_single_target_tip_queenofpain_blink_Text"	"Queen of Pain will use her Blink ability to escape if you don't keep her stunned until she dies."
"lockdown_single_target_failure_queenofpain_escaped"	"Queen of Pain kaçtı."
"[english]lockdown_single_target_failure_queenofpain_escaped"	"Queen of Pain escaped."
"lockdown_single_target_failure_protect_units"	"Bir dost öldü."
"[english]lockdown_single_target_failure_protect_units"	"An ally died."
"scenario_tp_scroll_main_objective"	"Town Portal Scroll"
"[english]scenario_tp_scroll_main_objective"	"Town Portal Scrolls"
"scenario_tp_scroll_items"	"Town Portal Scroll"
"[english]scenario_tp_scroll_items"	"Town Portal Scroll"
"DOTA_NPEDesc_scenario_tp_scroll_items"	"Her oyuncu bir Dota maçına bunlardan üç taneyle başlar."
"[english]DOTA_NPEDesc_scenario_tp_scroll_items"	"Every player gets three of these at the start of a Dota match."
"scenario_tp_scroll_task_buy_two_tp"	"İki tane Town Portal Scroll satın alın."
"[english]scenario_tp_scroll_task_buy_two_tp"	"Buy two Town Portal Scrolls"
"scenario_tp_scroll_task_buy_two_tp_Description"	"Aşağıdaki hızlı satın alma menüsünden satın almak için Town Portal Scroll'a sağ tıklayın."
"[english]scenario_tp_scroll_task_buy_two_tp_Description"	"Right-click on Town Portal Scroll to buy it from the Quick Buy Menu below."
"scenario_tp_scroll_wizard_tip_intro_Text"	"En az bir veya iki Town Portal Scroll taşımadan savaşa gitmeyin."
"[english]scenario_tp_scroll_wizard_tip_intro_Text"	"Never run off to battle without a Town Portal Scroll or two."
"scenario_regen_ui_tip_quick_buy_slot"	"Town Portal Scroll almak için buraya sağ tıklayın."
"[english]scenario_regen_ui_tip_quick_buy_slot"	"Right-Click here to buy Town Portal Scroll"
"scenario_tp_scroll_task_teleport_to_tower"	"Town Portal Scroll'u kullanarak kuleye ışınlanın."
"[english]scenario_tp_scroll_task_teleport_to_tower"	"Teleport to the tower using your Town Portal Scroll"
"scenario_tp_scroll_task_teleport_to_tower_Description"	"Önce Town Portal Scroll'a, ardından kulenin yakınına tıklayın."
"[english]scenario_tp_scroll_task_teleport_to_tower_Description"	"Click the Town Portal Scroll and then click near the tower."
"scenario_tp_scroll_wizard_tip_teleport_Text"	"Town Portal Scroll'lar haritadaki fırsatlara hızlı bir şekilde yanıt vermenizi sağlar."
"[english]scenario_tp_scroll_wizard_tip_teleport_Text"	"Town Portal Scrolls let you respond quickly to opportunities across the map."
"scenario_tp_scroll_task_stun_tp"	"Dragon Knight'ı ışınlanırken sersemletin."
"[english]scenario_tp_scroll_task_stun_tp"	"Stun Dragon Knight when he tries to teleport away"
"scenario_tp_scroll_task_stun_tp_Description"	"Dragon Knight'a saldırın. Işınlanmaya başladığında ışınlanmasını iptal etmek ve sersemletmek için hemen Wraithfire Blast yeteneğinizi kullanın."
"[english]scenario_tp_scroll_task_stun_tp_Description"	"Attack Dragon Knight. Cast your Wraithfire Blast quickly after he starts teleporting to stun him and cancel his teleport."
"scenario_tp_scroll_task_stun_tp_Failure"	"Dragon Knight kaçtı. Dragon Knight ışınlanmaya başladıktan hemen sonra Wraithfire Blast yeteneğinizi kullanın."
"[english]scenario_tp_scroll_task_stun_tp_Failure"	"Dragon Knight got away. Cast your Wraithfire Blast quickly after Dragon Knight starts teleporting."
"scenario_tp_scroll_wizard_tip_stun_Text"	"Town Portal Scroll art arda kullanılamaz. Düşmanınızın olduğu yerde bir süre daha kalmasını sağlamak için ışınlanmasını iptal edin."
"[english]scenario_tp_scroll_wizard_tip_stun_Text"	"Town Portal Scroll cannot be cast often. Cancel your enemy's cast and they'll be stuck for a while."
"scenario_tp_scroll_task_kill_enemy"	"Dragon Knight'ı öldürün."
"[english]scenario_tp_scroll_task_kill_enemy"	"Kill the Dragon Knight"
"scenario_tp_scroll_task_kill_enemy_Description"	"Ölene kadar Dragon Knight'a saldırın."
"[english]scenario_tp_scroll_task_kill_enemy_Description"	"Attack Dragon Knight until he's dead."
"scenario_regen_main_objective"	"Yenilenme"
"[english]scenario_regen_main_objective"	"Regen"
"scenario_regen_start"	"Yenilenme Eşyaları"
"[english]scenario_regen_start"	"Regen Items"
"DOTA_NPEDesc_scenario_regen_start"	"Sağlığınızı ve mananızı dolduracak tüketilebilir standart eşyalar."
"[english]DOTA_NPEDesc_scenario_regen_start"	"Basic consumables for restoring health and mana"
"scenario_regen_more"	"Daha Fazla Yenilenme Eşyası"
"[english]scenario_regen_more"	"More Regen Items"
"DOTA_NPEDesc_scenario_regen_more"	"Sağlığınızı ve mananızı dolduracak tüketilebilir standart eşyalar."
"[english]DOTA_NPEDesc_scenario_regen_more"	"Basic consumables for restoring health and mana"
"scenario_regen_even_more"	"Daha da Fazla Yenilenme Eşyası"
"[english]scenario_regen_even_more"	"Even More Regen Items"
"DOTA_NPEDesc_scenario_regen_even_more"	"Sağlığınızı ve mananızı dolduracak tüketilebilir standart eşyalar."
"[english]DOTA_NPEDesc_scenario_regen_even_more"	"Basic consumables for restoring health and mana"
"scenario_regen_task_buy_regen"	"Çeşitli yenilenme eşyaları alın."
"[english]scenario_regen_task_buy_regen"	"Buy a variety of regen items"
"scenario_regen_wizard_tip_intro_Text"	"Yenilenme eşyalarını toptan aldığınız takdirde kaynak toplamaya daha fazla zaman ayırabilirsiniz."
"[english]scenario_regen_wizard_tip_intro_Text"	"Buying a handful of regen items early helps you spend more time gathering resources."
"scenario_regen_task_buy_clarity"	"Bir Clarity satın alın."
"[english]scenario_regen_task_buy_clarity"	"Buy a Clarity"
"scenario_regen_task_buy_clarity_Description"	"Dükkânı açın ve mavi iksire sağ tıklayın."
"[english]scenario_regen_task_buy_clarity_Description"	"Open the shop and right-click the blue potion"
"scenario_regen_task_buy_tango"	"Bir Tango satın alın."
"[english]scenario_regen_task_buy_tango"	"Buy a Tango"
"scenario_regen_task_buy_tango_Description"	"Dükkânı açın ve bir yaprak üzerinde yeşil küreler olan simgeye sağ tıklayın."
"[english]scenario_regen_task_buy_tango_Description"	"Open the shop and right-click the green orbs on a leaf"
"scenario_regen_task_buy_salve"	"Bir Healing Salve satın alın."
"[english]scenario_regen_task_buy_salve"	"Buy a Healing Salve"
"scenario_regen_task_buy_salve_Description"	"Dükkânı açın ve yeşil iksire sağ tıklayın."
"[english]scenario_regen_task_buy_salve_Description"	"Open the shop and right-click the green potion"
"scenario_regen_task_use_clarity"	"Mana yenilemeye başlamak için Clarity'yi kullanın."
"[english]scenario_regen_task_use_clarity"	"Use your Clarity to begin restoring mana"
"scenario_regen_task_use_clarity_Description"	"Önce Clarity'ye ve ardından kahramanınıza tıklayın."
"[english]scenario_regen_task_use_clarity_Description"	"Click the Clarity and then click on your hero"
"scenario_regen_wizard_tip_clarity_Text"	"Bir Clarity iksiri mana yenilemek için kendinizin veya bir dostunuzun üzerinde kullanılabilir."
"[english]scenario_regen_wizard_tip_clarity_Text"	"A clarity potion can be used on yourself or an ally to begin regenerating mana."
"scenario_regen_task_use_tango"	"Bir Tango kullanarak sağlığınızı yenileyin."
"[english]scenario_regen_task_use_tango"	"Use a Tango to restore health"
"scenario_regen_task_use_tango_Description"	"Tango'ya ve ardından bir ağaca tıklayın."
"[english]scenario_regen_task_use_tango_Description"	"Click the Tango and then click on a tree"
"scenario_regen_wizard_tip_tango_Text"	"Tangolar, ara sıra gelen hasarları önlemek için kullanışlıdır."
"[english]scenario_regen_wizard_tip_tango_Text"	"Tangos are useful for countering occasional incoming damage."
"scenario_regen_task_share_tango"	"Bir Tango'yu Lina ile paylaşın."
"[english]scenario_regen_task_share_tango"	"Share a Tango with Lina"
"scenario_regen_task_share_tango_Description"	"Önce Tango'ya ardından Lina'ya tıklayın."
"[english]scenario_regen_task_share_tango_Description"	"Click the Tango and then click on Lina"
"scenario_regen_task_use_salve"	"Hızlıca sağlık yenilemek için Healing Salve kullanın."
"[english]scenario_regen_task_use_salve"	"Use your Healing Salve to retore health quickly"
"scenario_regen_task_use_salve_Description"	"Önce Healing Salve'a ardından kahramanınıza tıklayın."
"[english]scenario_regen_task_use_salve_Description"	"Click the Healing Salve and then click on your hero"
"scenario_regen_wizard_tip_salve_Text"	"Dikkatli olun. Healing Salve'ın etkisi bir düşman kahramanından hasar alındığında bozulur."
"[english]scenario_regen_wizard_tip_salve_Text"	"Beware. The Healing Salve can be cancelled by taking damage from an enemy hero."
"scenario_regen_task_regen_full"	"Kendinizi ve takım arkadaşınızı tamamen iyileştirin."
"[english]scenario_regen_task_regen_full"	"Heal yourself and your teammate to full"
"scenario_regen_task_regen_self"	"Mananızı ve canınızı tamamen doldurun."
"[english]scenario_regen_task_regen_self"	"Bring yourself to full health and mana"
"scenario_regen_task_regen_self_Description"	"Kahramanınız üzerinde yenilenme eşyalarını kullanın."
"[english]scenario_regen_task_regen_self_Description"	"Use regen items on your hero"
"scenario_regen_task_regen_lina"	"Lina'nın canını ve manasını doldurun."
"[english]scenario_regen_task_regen_lina"	"Bring Lina to full health and mana"
"scenario_regen_task_regen_lina_Description"	"Lina üzerinde yenilenme eşyalarını kullanın."
"[english]scenario_regen_task_regen_lina_Description"	"Use regen items on Lina"
"scenario_regen_wizard_tip_regen_Text"	"Healing Salve, Clarity ve Tango dostlarınız üzerinde kullanılabilir veya onlarla paylaşılabilir."
"[english]scenario_regen_wizard_tip_regen_Text"	"Healing Salves, Clarities, and Tangos can all be used or shared with allies."
"scenario_courier_main_objective"	"Bir Aghanim's Scepter tamamlamak için kuryenizi kullanın."
"[english]scenario_courier_main_objective"	"Use your courier to complete an Aghanim's Scepter"
"scenario_courier_task_root"	"Bir Aghanim's Scepter'ın bileşenlerini edinin."
"[english]scenario_courier_task_root"	"Acquire components of an Aghanim's Scepter"
"scenario_courier_task_buy_ogre_club"	"Dükkândan Ogre Axe satın alın."
"[english]scenario_courier_task_buy_ogre_club"	"Purchase the Ogre Axe from the shop"
"scenario_courier_task_buy_ogre_club_Description"	"Dükkân butonuna tıklayın. Ogre Axe'a sağ tıklayın."
"[english]scenario_courier_task_buy_ogre_club_Description"	"Click on the Shop Button.  Right-Click on the Ogre Axe."
"scenario_courier_task_deliver_ogre_club_with_courier"	"Ogre Axe'ı kuryenizle teslim alın."
"[english]scenario_courier_task_deliver_ogre_club_with_courier"	"Deliver the Ogre Axe with your courier"
"scenario_courier_task_deliver_ogre_club_with_courier_Description"	"\"Eşyaları Kuryeyle Teslim Et\" butonuna tıklayın."
"[english]scenario_courier_task_deliver_ogre_club_with_courier_Description"	"Click on Courier Deliver Items."
"scenario_courier_task_buy_staff_of_wizardry"	"Staff of Wizardry satın alın."
"[english]scenario_courier_task_buy_staff_of_wizardry"	"Purchase the Staff of Wizardry"
"scenario_courier_task_buy_staff_of_wizardry_Description"	"Dükkân butonuna tıklayın. Staff of Wizardry'ye sağ tıklayın."
"[english]scenario_courier_task_buy_staff_of_wizardry_Description"	"Click on the Shop Button.  Right-Click on the Staff of Wizardry."
"scenario_courier_task_retrieve_staff_of_wizardry"	"Staff of Wizardry'yi kuryenize aktarın."
"[english]scenario_courier_task_retrieve_staff_of_wizardry"	"Move the Staff of Wizardry to your courier"
"scenario_courier_task_retrieve_staff_of_wizardry_Description"	"\"Kuryeyi Seç\" butonuna tıklayın. Kuryenin yeteneklerinden \"Eşyaları Al\" tuşuna basın."
"[english]scenario_courier_task_retrieve_staff_of_wizardry_Description"	"Click on Select Courier.  Press the 'Retrieve Items' hotkey in the courier's abilities."
"scenario_courier_task_send_courier_to_secret_shop"	"Kuryeyi Gizli Dükkân'a gönderin."
"[english]scenario_courier_task_send_courier_to_secret_shop"	"Send your courier to the Secret Shop"
"scenario_courier_task_send_courier_to_secret_shop_Description"	"Kuryenin yeteneklerinden \"Gizli Dükkân'a Git\" butonuna tıklayın."
"[english]scenario_courier_task_send_courier_to_secret_shop_Description"	"Click on Go To Secret Shop in the courier's abilities."
"scenario_courier_task_buy_point_booster"	"Bir Point Booster satın alın."
"[english]scenario_courier_task_buy_point_booster"	"Purchase a Point Booster"
"scenario_courier_task_buy_point_booster_Description"	"Dükkân butonuna tıklayın. Point Booster'a sağ tıklayın."
"[english]scenario_courier_task_buy_point_booster_Description"	"Click on the Shop Button.  Right-Click on the Point Booster."
"scenario_courier_task_deliver_aghs_with_courier"	"Eşyaları kuryenizle teslim alın."
"[english]scenario_courier_task_deliver_aghs_with_courier"	"Deliver the items with your courier"
"scenario_courier_task_deliver_aghs_with_courier_Description"	"Kuryenin yeteneklerinden \"Eşyaları Naklet\" tuşuna basın."
"[english]scenario_courier_task_deliver_aghs_with_courier_Description"	"Press the 'Transfer Items' hotkey in the courier's abilities."
"scenario_courier_wizard_tip_buying_Text"	"Bir dükkânın yakınlarında olmasınız bile eşya satın alabilirsiniz."
"[english]scenario_courier_wizard_tip_buying_Text"	"You can buy items when you are not near a shop."
"scenario_courier_wizard_tip_buying_Annotation"	"Bu eşyalar zulanıza gönderilir."
"[english]scenario_courier_wizard_tip_buying_Annotation"	"The items will go into your Stash."
"scenario_courier_wizard_tip_deliver_items_Text"	"Kuryeniz öldürülebilir."
"[english]scenario_courier_wizard_tip_deliver_items_Text"	"Your courier can be killed."
"scenario_courier_wizard_tip_deliver_items_Annotation"	"Ölürse, kuryenin taşıdığı eşyalar bir süreliğine erişilemez olur. Kuryeyi güvende tutmaya çalışın."
"[english]scenario_courier_wizard_tip_deliver_items_Annotation"	"This will also temporarily make the items it is carrying unavailable.  Try to keep it safe."
"scenario_courier_wizard_tip_speed_burst_Text"	"Kuryenizin hızını geçici olarak artırmak için \"Hız Artışı\" butonuna tıklayın."
"[english]scenario_courier_wizard_tip_speed_burst_Text"	"Click on the Speed Burst Ability for your courier to temporarily increase its speed."
"scenario_courier_wizard_tip_speed_burst_Annotation"	"Bu, kuryenizi ölümden kurtarabilir."
"[english]scenario_courier_wizard_tip_speed_burst_Annotation"	"This might save your courier from death."
"scenario_courier_wizard_tip_select_Text"	"\"Kuryeyi Seç\" butonuna çift tıklayarak kuryeyi ekranın merkezine alın."
"[english]scenario_courier_wizard_tip_select_Text"	"Double-click the Select Courier button to center the camera on it."
"scenario_courier_wizard_tip_secret_shop_Text"	"Dota haritasında iki Gizli Dükkân bulunmaktadır."
"[english]scenario_courier_wizard_tip_secret_shop_Text"	"There are two Secret Shops on the Dota map."
"scenario_courier_wizard_tip_secret_shop_Annotation"	"Gizli Dükkânlar üssünüzdeki dükkânda olmayan eşyalara sahiptir."
"[english]scenario_courier_wizard_tip_secret_shop_Annotation"	"Secret Shops contain items not available in your Home Shop."
"scenario_courier_ui_tip_click_to_open_shop"	"Dükkânı açmak için buraya tıklayın."
"[english]scenario_courier_ui_tip_click_to_open_shop"	"Click here to open the shop"
"scenario_courier_ui_tip_click_to_deliver_items"	"Eşyanızı teslim almak için buraya tıklayın."
"[english]scenario_courier_ui_tip_click_to_deliver_items"	"Click here to deliver your item"
"scenario_courier_ui_tip_click_to_select_courier"	"Kuryenizi seçmek için buraya tıklayın."
"[english]scenario_courier_ui_tip_click_to_select_courier"	"Click here to select your courier"
"scenario_courier_ui_tip_click_to_retrieve_items"	"Eşyaları kuryenize taşımak için buraya tıklayın."
"[english]scenario_courier_ui_tip_click_to_retrieve_items"	"Click here to move your items to your courier"
"scenario_courier_ui_tip_click_to_go_to_secret_shop"	"Kuryenizi Gizli Dükkân'a göndermek için buraya tıklayın."
"[english]scenario_courier_ui_tip_click_to_go_to_secret_shop"	"Click here to go to the Secret Shop"
"scenario_courier_ui_tip_click_to_transfer_items"	"Eşyaları kahramanınıza nakletmek için buraya tıklayın."
"[english]scenario_courier_ui_tip_click_to_transfer_items"	"Click here to transfer items to your hero"
"scenario_courier_items"	"Aghanim's Scepter Bileşenleri"
"[english]scenario_courier_items"	"Aghanim's Scepter Components"
"DOTA_NPEDesc_scenario_courier_items"	"Aghanim's Scepter'ı oluşturmak için bu dört eşyanın hepsine aynı anda sahip olun."
"[english]DOTA_NPEDesc_scenario_courier_items"	"Have all four of these items at the same time to create Aghanim's Scepter."
"scenario_euls_setup_main_objective"	"Shadow Fiend'e karşı Ice Path'i kullanın."
"[english]scenario_euls_setup_main_objective"	"Hit the Shadow Fiend with Ice Path"
"scenario_euls_setup_task_move_to_location"	"Senaryoyu başlatmak için işarete doğru ilerleyin."
"[english]scenario_euls_setup_task_move_to_location"	"Move to the marker to start the scenario."
"scenario_euls_setup_task_move_to_location_Description"	"Hareket etmek için zemine sağ tıklayın."
"[english]scenario_euls_setup_task_move_to_location_Description"	"Right-Click on the ground to move."
"scenario_euls_setup_task_ice_path_shadow_fiend_1"	"Shadow Fiend'i sersemletin."
"[english]scenario_euls_setup_task_ice_path_shadow_fiend_1"	"Stun Shadow Fiend"
"scenario_euls_setup_task_ice_path_shadow_fiend_1_Description"	"Shadow Fiend'i sersemletmek için Ice Path'i kullanın."
"[english]scenario_euls_setup_task_ice_path_shadow_fiend_1_Description"	"Cast Ice Path to stun Shadow Fiend"
"scenario_euls_setup_task_ice_path_shadow_fiend_2"	"Shadow Fiend'i sersemletin."
"[english]scenario_euls_setup_task_ice_path_shadow_fiend_2"	"Stun Shadow Fiend"
"scenario_euls_setup_task_ice_path_shadow_fiend_2_Description"	"Shadow Fiend'i sersemletmek için Rod of Atos'u ve Ice Path'i kullanın."
"[english]scenario_euls_setup_task_ice_path_shadow_fiend_2_Description"	"Use Rod of Atos and Ice Path to stun Shadow Fiend"
"scenario_euls_setup_task_ice_path_shadow_fiend_3"	"Shadow Fiend'i sersemletin."
"[english]scenario_euls_setup_task_ice_path_shadow_fiend_3"	"Stun Shadow Fiend"
"scenario_euls_setup_task_ice_path_shadow_fiend_3_Description"	"Shadow Fiend'i sersemletmek için Eul's Scepter'ı ve Ice Path'i kullanın."
"[english]scenario_euls_setup_task_ice_path_shadow_fiend_3_Description"	"Use Eul's Scepter and Ice Path to stun Shadow Fiend"
"scenario_euls_setup_wizard_tip_intro_Text"	"Jakiro'nun Ice Path yeteneği diğer birçok nokta hedefli büyü de olduğu gibi isabet ettirmesi zor olabilir. Bu senaryoda biraz alıştırma yapacağız!"
"[english]scenario_euls_setup_wizard_tip_intro_Text"	"Jakiro's Ice Path, like many Point Targeted spells, can be difficult to hit. In this scenario, we'll get some practice!"
"scenario_euls_setup_wizard_tip_intro_Annotation"	"Maçlarda oyuncular büyülerinizden kaçmak için ellerinden geleni yaparlar. Buna fırsat vermemeyi öğrenmeliyiz."
"[english]scenario_euls_setup_wizard_tip_intro_Annotation"	"In a game, players will do their best to evade your spells. Let's make sure they can't do that."
"scenario_euls_setup_wizard_tip_ice_path_shadow_fiend_1_Text"	"Ice Path düşmana hemen isabet etmez fakat kullanıldıktan sonra kısa bir süre daha zeminde etki göstermeye devam eder."
"[english]scenario_euls_setup_wizard_tip_ice_path_shadow_fiend_1_Text"	"Ice Path does not hit right away, but lingers for a short duration on the ground after the cast."
"scenario_euls_setup_wizard_tip_ice_path_shadow_fiend_1_Annotation"	"Ice Path düşmana hemen isabet etmez fakat kullanıldıktan sonra kısa bir süre daha zeminde etki göstermeye devam eder."
"[english]scenario_euls_setup_wizard_tip_ice_path_shadow_fiend_1_Annotation"	"Ice Path does not hit right away, but lingers for a short duration on the ground after the cast."
"scenario_euls_setup_wizard_tip_ice_path_shadow_fiend_2_Text"	"Çok iyi! Ancak Shadow Fiend artık daha fazla dikkat edeceğinden büyülerinizden daha fazla kaçmaya çalışacaktır! Unutmayın, Rod of Atos'un etkin yeteneği olan Cripple'ın hedefe ulaşması çok kısa bir süre alır, hedefe ulaştığında da hedefi kısa süreliğine olduğu yere sabitler."
"[english]scenario_euls_setup_wizard_tip_ice_path_shadow_fiend_2_Text"	"Very nice! However, Shadow Fiend is now paying more attention and will try to avoid your spells! Remember, Rod of Atos's Cripple active takes a little while to reach the target, but will then hold them in one place for a short duration."
"scenario_euls_setup_wizard_tip_ice_path_shadow_fiend_2_Annotation"	"Unutmayın, Rod of Atos'un etkin yeteneği olan Cripple'ın hedefe ulaşması çok kısa bir süre alır, hedefe ulaştığında da hedefi kısa süreliğine olduğu yere sabitler."
"[english]scenario_euls_setup_wizard_tip_ice_path_shadow_fiend_2_Annotation"	"Remember, Rod of Atos's Cripple active takes a little while to reach the target, but will then hold them in one place for a short duration."
"scenario_euls_setup_wizard_tip_ice_path_shadow_fiend_3_Text"	"Olamaz, Blink Dagger'ı var! Cyclone'un etkisi geçtiğinde Ice Path'in etkisi düşmanın altında olacak şekilde ayarlamak için Eul's Scepter'ı kullanmayı deneyin!"
"[english]scenario_euls_setup_wizard_tip_ice_path_shadow_fiend_3_Text"	"Oh no, now he has got a Blink Dagger! Try using Eul's Scepter on the enemy to make sure the Ice Path is already in place when when Cyclone wears off!"
"scenario_euls_setup_wizard_tip_ice_path_shadow_fiend_3_Annotation"	"Cyclone'un etkisi geçtiğinde, Ice Path'in etkisi düşmanın altında olacak şekilde ayarlamak için zamanlama konusunda alıştırma yapmanız gerekebilir."
"[english]scenario_euls_setup_wizard_tip_ice_path_shadow_fiend_3_Annotation"	"You may have to practice your timing to make sure that the Ice Path is still there when Cyclone wears off."
"scenario_euls_setup_wizard_tip_ice_path_shadow_fiend_3_missed_Text"	"Iskaladı! Yeteneği sıfırladım. Bu sefer Ice Path'i, Eul's Scepter'la birlikte zamanlayarak kullanmayı deneyin!"
"[english]scenario_euls_setup_wizard_tip_ice_path_shadow_fiend_3_missed_Text"	"Missed! Let me reset that ability for you. Don't forget to time your Ice Path to Eul's Scepter!"
"scenario_euls_setup_wizard_tip_ice_path_shadow_fiend_3_missed_Annotation"	"Denemeye devam edin!"
"[english]scenario_euls_setup_wizard_tip_ice_path_shadow_fiend_3_missed_Annotation"	"Keep trying!"
"scenario_euls_setup_wizard_tip_ice_path_shadow_fiend_2_missed_Text"	"Neredeyse oluyordu! Yeteneği sıfırladım. Düşmanları oldukları yere sabitlemek için Rod of Atos'u kullanın."
"[english]scenario_euls_setup_wizard_tip_ice_path_shadow_fiend_2_missed_Text"	"Close One! Let me reset that ability for you. Don't forget to use Rod of Atos to help keep the enemy in place!"
"scenario_euls_setup_wizard_tip_ice_path_shadow_fiend_2_missed_Annotation"	"Denemeye devam edin!"
"[english]scenario_euls_setup_wizard_tip_ice_path_shadow_fiend_2_missed_Annotation"	"Keep trying!"
"scenario_euls_setup_wizard_tip_ice_path_shadow_fiend_1_missed_Text"	"Oldu olacak! Yeteneği sıfırladım. Düşmanın hareketlerini tahmin etmeye çalışın ve büyülerinizi buna göre kullanmayı deneyin!"
"[english]scenario_euls_setup_wizard_tip_ice_path_shadow_fiend_1_missed_Text"	"Very close! Let me reset that ability for you. Try to anticipate his movements and get a feel for your own spells!"
"scenario_euls_setup_wizard_tip_ice_path_shadow_fiend_1_missed_Annotation"	"Denemeye devam edin!"
"[english]scenario_euls_setup_wizard_tip_ice_path_shadow_fiend_1_missed_Annotation"	"Keep trying!"
"scenario_euls_setup_wizard_tip_item_missed_Text"	"Eşyayı sıfırladım. Eşyalarınızı yeteneklerinizle birlikte kullandığınızda, her ikisi daha etkili olur!"
"[english]scenario_euls_setup_wizard_tip_item_missed_Text"	"Let me reset that item for you. Using your items together with your spells will greatly increase the effectiveness of both!"
"scenario_euls_setup_wizard_tip_ice_path_generic_missed_Text"	"Yeteneği sıfırladım. Butona doğru ilerlemeyi denemek isteyebilirsiniz."
"[english]scenario_euls_setup_wizard_tip_ice_path_generic_missed_Text"	"Let me reset that ability for you. In the meantime, why don't you get to the button?"
"scenario_euls_setup_wizard_tip_ice_path_generic_missed_Annotation"	"Bir hedef çıkana bekleyelim."
"[english]scenario_euls_setup_wizard_tip_ice_path_generic_missed_Annotation"	"Let's wait until we have a target, shall we?"
"scenario_euls_setup_wizard_tip_use_euls_Text"	"Eul's Scepter dövüş başlatmak için de kullanılabilir."
"[english]scenario_euls_setup_wizard_tip_use_euls_Text"	"A Eul's Scepter can also be used as a setup."
"scenario_euls_setup_wizard_tip_use_euls_Annotation"	"Doğru bir şekilde zamanladığınız takdirde Cyclone yeteneğini kaçmaya meyilli kahramanlar üzerinde kullanarak onları durdurabilirsiniz."
"[english]scenario_euls_setup_wizard_tip_use_euls_Annotation"	"Timed correctly, you can use the Cyclone ability to make sure evasive enemies cannot get away."
"scenario_euls_setup_wizard_tip_time_your_lsa_Text"	"Light Strike Array'inizi düşman tam Cyclone'un etkisinden çıktığında kullanın."
"[english]scenario_euls_setup_wizard_tip_time_your_lsa_Text"	"Time your Light Strike Array to hit the enemy after she drops down"
"scenario_euls_setup_wizard_tip_time_your_lsa_Annotation"	"Zamanlamayı öğrenmek biraz alıştırma gerektirecek fakat bunu öğrendiğinizde kaçmaya meyilli düşmanları öldürebileceksiniz."
"[english]scenario_euls_setup_wizard_tip_time_your_lsa_Annotation"	"It may take practice to get the timing just right, but when you do, you will be able to kill enemies that would otherwise escape."
"scenario_warding_main_objective"	"Nöbetçi ve izleyici gözleri yerleştirmeyi öğrenin."
"[english]scenario_warding_main_objective"	"Learn to place Observer and Sentry Wards"
"scenario_warding_task_buy_observer_ward"	"Bir izleyici göz satın alın."
"[english]scenario_warding_task_buy_observer_ward"	"Purchase an Observer Ward"
"scenario_warding_task_buy_observer_ward_Description"	"Dükkân butonuna tıklayın. İzleyici göze sağ tıklayın."
"[english]scenario_warding_task_buy_observer_ward_Description"	"Click on the Shop Button.  Right-Click on Observer Ward."
"scenario_warding_task_buy_sentry_ward"	"Bir nöbetçi göz satın alın."
"[english]scenario_warding_task_buy_sentry_ward"	"Purchase a Sentry Ward"
"scenario_warding_task_buy_sentry_ward_Description"	"Dükkân butonuna tıklayın. İzleyici göze sağ tıklayın."
"[english]scenario_warding_task_buy_sentry_ward_Description"	"Click on the Shop Button.  Right-Click on Sentry Ward."
"scenario_warding_task_move_to_location_1"	"Kahramanınızı ilgili konuma doğru ilerletin."
"[english]scenario_warding_task_move_to_location_1"	"Move your hero to the location"
"scenario_warding_task_move_to_location_1_Description"	"Hareket etmek için zemine sağ tıklayın."
"[english]scenario_warding_task_move_to_location_1_Description"	"Right-Click on the ground to move."
"scenario_warding_task_place_obs_ward_1"	"Göz konumuna bir izleyici göz yerleştirin."
"[english]scenario_warding_task_place_obs_ward_1"	"Place the Observer Ward at the ward location"
"scenario_warding_task_place_obs_ward_1_Description"	"Eşya yuvanızdaki \"Gözler\" tuşuna basın. Gözü yerleştirmek için dünyada bir yeri seçin."
"[english]scenario_warding_task_place_obs_ward_1_Description"	"Press the 'Wards' hotkey in your item slot.  Click in the world to place the Ward."
"scenario_warding_task_move_to_location_2"	"Kahramanınızı sonraki konuma götürün."
"[english]scenario_warding_task_move_to_location_2"	"Move your hero to the next location"
"scenario_warding_task_move_to_location_2_Description"	"Hareket etmek için zemine sağ tıklayın."
"[english]scenario_warding_task_move_to_location_2_Description"	"Right-Click on the ground to move."
"scenario_warding_task_place_sentry_ward_1"	"Göz konumuna bir nöbetçi göz yerleştirin."
"[english]scenario_warding_task_place_sentry_ward_1"	"Place the Sentry Ward at the ward location"
"scenario_warding_task_place_sentry_ward_1_Description"	"Eşya yuvanızdaki \"Gözler\" tuşuna basın. Gözü yerleştirmek için dünyada bir yeri seçin."
"[english]scenario_warding_task_place_sentry_ward_1_Description"	"Press the 'Wards' hotkey in your item slot.  Click in the world to place the Ward."
"scenario_warding_task_destroy_enemy_ward"	"Göz konumuna bir nöbetçi göz yerleştirin."
"[english]scenario_warding_task_destroy_enemy_ward"	"Destroy the enemy Observer Ward"
"scenario_warding_task_destroy_enemy_ward_Description"	"Bir düşman izleyici göze saldırmak için sağ tıklayın."
"[english]scenario_warding_task_destroy_enemy_ward_Description"	"Right-Click on the enemy Observer Ward to attack"
"scenario_warding_task_do_not_die"	"Ölmeyin!"
"[english]scenario_warding_task_do_not_die"	"Don't die!"
"scenario_warding_wizard_tip_ward_slot_Text"	"Nöbetçi ve izleyici gözler aynı eşya yuvasında yer alır."
"[english]scenario_warding_wizard_tip_ward_slot_Text"	"Observer and Sentry Wards stack in the same item slot."
"scenario_warding_wizard_tip_ward_slot_Annotation"	"Göz türünü değiştirmek için üstlerine gelin ve sol tıklayın."
"[english]scenario_warding_wizard_tip_ward_slot_Annotation"	"Left-Click on them twice to swap the type."
"scenario_warding_wizard_tip_vision_Text"	"Göz yerleştirerek takımınıza görüş sağlarsınız."
"[english]scenario_warding_wizard_tip_vision_Text"	"Placing a Ward provides vision for your team."
"scenario_warding_wizard_tip_vision_Annotation"	"Göz ne kadar yukarıda bir yere konarsa o kadar fazla görüş verir."
"[english]scenario_warding_wizard_tip_vision_Annotation"	"The higher the ward, the more area it can see."
"scenario_warding_wizard_tip_sentry_Text"	"Nöbetçi gözler gerçek görüş verir."
"[english]scenario_warding_wizard_tip_sentry_Text"	"Sentry Wards provide True Sight."
"scenario_warding_wizard_tip_sentry_Annotation"	"Gerçek görüş görünmez birimleri ve düşman gözlerini açığa çıkartır."
"[english]scenario_warding_wizard_tip_sentry_Annotation"	"True Sight reveals invisible units - including enemy Wards."
"scenario_warding_ui_tip_click_to_open_shop"	"Dükkânı açmak için buraya tıklayın."
"[english]scenario_warding_ui_tip_click_to_open_shop"	"Click here to open the shop"
"scenario_warding_ui_tip_select_ward"	"Bir göz seçmek için buraya tıklayın."
"[english]scenario_warding_ui_tip_select_ward"	"Click here to select a ward"
"scenario_warding_failure_sentry_ward_destroyed"	"Nöbetçi göz yok edildi."
"[english]scenario_warding_failure_sentry_ward_destroyed"	"Sentry Ward was destroyed."
"scenario_warding_failure_observer_placed_at_wrong_time"	"İzleyici göz yanlış zamanda yerleştirildi."
"[english]scenario_warding_failure_observer_placed_at_wrong_time"	"Observer placed at wrong time."
"scenario_warding_failure_sentry_placed_at_wrong_time"	"Nöbetçi göz yanlış zamanda yerleştirildi."
"[english]scenario_warding_failure_sentry_placed_at_wrong_time"	"Sentry placed at wrong time."
"scenario_warding_items"	"Gözler"
"[english]scenario_warding_items"	"Wards"
"DOTA_NPEDesc_scenario_warding_items"	"Geçici görüş ve gerçek görüş kazanmak için yere göz dikin."
"[english]DOTA_NPEDesc_scenario_warding_items"	"Plant wards on the ground gain temporary vision and True Sight."
"scenario_items_main_objective"	"Gelişmiş eşya etkileşimlerini öğrenin."
"[english]scenario_items_main_objective"	"Learn Advanced Item Interactions"
"scenario_items_task_root"	"Eşyaları alın, satın, paylaşın, parçalarına ayırın ve birleştirin."
"[english]scenario_items_task_root"	"Buy, Sell, Share, Disassemble and Combine Items"
"scenario_items_task_buy_tango"	"Tango satın alın."
"[english]scenario_items_task_buy_tango"	"Purchase Tango"
"scenario_items_task_buy_tango_Description"	"Dükkân butonuna tıklayın. Tango'ya sağ tıklayın."
"[english]scenario_items_task_buy_tango_Description"	"Click on the Shop Button.  Right-Click on Tango."
"scenario_items_task_share_tango"	"Tango'yu Windranger'la paylaşın."
"[english]scenario_items_task_share_tango"	"Share a Tango with Windranger"
"scenario_items_task_share_tango_Description"	"Paylaşmak için önce eşya yuvanızdaki Tango'lara tıklayın ardından Windranger'a tıklayın."
"[english]scenario_items_task_share_tango_Description"	"Click on the Tangos in your item slot.  Click on Windranger to share."
"scenario_items_task_sell_tango"	"Tango'nuzu satın."
"[english]scenario_items_task_sell_tango"	"Sell your tango"
"scenario_items_task_sell_tango_Description"	"Eşya yuvanızdaki Tango'lara sağ tıklayın, ardından \"Sat\"ı seçin."
"[english]scenario_items_task_sell_tango_Description"	"Right-Click on the Tangos in your item slot.  Select Sell."
"scenario_items_task_disassemble_arcane_boots"	"Arcane Boots'larınızı parçalayın."
"[english]scenario_items_task_disassemble_arcane_boots"	"Disassemble your Arcane Boots"
"scenario_items_task_disassemble_arcane_boots_Description"	"Eşya yuvanızdaki Arcane Boots'a sağ tıklayın, ardından \"Parçala\"yı seçin."
"[english]scenario_items_task_disassemble_arcane_boots_Description"	"Right-Click on the Arcane Boots in your item slot.  Select Disassemble."
"scenario_items_task_unlock_booster"	"Energy Booster'ın birleştirme kilidini açın."
"[english]scenario_items_task_unlock_booster"	"Unlock Combining on your Energy Booster"
"scenario_items_task_unlock_booster_Description"	"Eşya yuvanızdaki Energy Booster'a sağ tıklayın, ardından \"Birleştirmenin Kilidini Aç\"ı seçin."
"[english]scenario_items_task_unlock_booster_Description"	"Right-Click on the Energy Booster in your item slot.  Select Unlock Combining."
"scenario_items_task_buy_aether_lens"	"Aether Lens tarifini satın alın."
"[english]scenario_items_task_buy_aether_lens"	"Purchase the Recipe for Aether Lens"
"scenario_items_task_buy_aether_lens_Description"	"Dükkân butonuna tıklayarak dükkânı açın. Aether Lens'e sağ tıklayın."
"[english]scenario_items_task_buy_aether_lens_Description"	"Click on the Shop Button to open it.  Right-Click on Aether Lens."
"scenario_items_task_unlock_boots"	"Boots'un birleştirme kilidini açın."
"[english]scenario_items_task_unlock_boots"	"Unlock Combining on your Boots"
"scenario_items_task_unlock_boots_Description"	"Eşya yuvanızdaki Boots'a sağ tıklayın, ardından \"Birleştirmenin Kilidini Aç\"ı seçin."
"[english]scenario_items_task_unlock_boots_Description"	"Right-Click on the Boots in your item slot.  Select Unlock Combining."
"scenario_items_task_buy_boots_of_travel"	"Boots of Travel tarifini satın alın."
"[english]scenario_items_task_buy_boots_of_travel"	"Purchase the Recipe for Boots of Travel"
"scenario_items_task_buy_boots_of_travel_Description"	"Dükkân butonuna tıklayarak dükkânı açın. Boots of Travel'a sağ tıklayın."
"[english]scenario_items_task_buy_boots_of_travel_Description"	"Click on the Shop Button to open it.  Right-Click on Boots of Travel."
"scenario_items_wizard_tip_share_tango_Text"	"Tango, takım arkadaşlarınızla paylaşabileceğiniz birkaç eşyadan biridir."
"[english]scenario_items_wizard_tip_share_tango_Text"	"Tangos are one of the few items that can be shared with teammates."
"scenario_items_wizard_tip_support_Text"	"Destek kahramanları takım arkadaşlarına avantaj sağlamak için onlara Tango verir."
"[english]scenario_items_wizard_tip_support_Text"	"Support heroes often give their teammates a tango to get a head start."
"scenario_items_wizard_tip_disassemble_Text"	"Bazı kahramanların belirli eşya yapıları, oyun sonlarındaki eşyaları yapabilmek için oyun başlarında eşya parçalamalarını gerektirebilir."
"[english]scenario_items_wizard_tip_disassemble_Text"	"Specific item builds for heroes sometimes involve disassembling early game items to make late game items."
"scenario_items_wizard_tip_recipe_Text"	"Tarifler dükkânda görünmez sadece \"Eşya Birleştirme\" kısmında görünür."
"[english]scenario_items_wizard_tip_recipe_Text"	"Recipes do not appear in the shop except in the Combining Items section."
"scenario_items_ui_tip_click_to_open_shop"	"Dükkânı açmak için buraya tıklayın."
"[english]scenario_items_ui_tip_click_to_open_shop"	"Click here to open the shop"
"scenario_items_ui_tip_share_tango"	"Bir Tango seçmek için buraya tıklayın."
"[english]scenario_items_ui_tip_share_tango"	"Click here to Queue a Tango"
"scenario_items_ui_tip_sell_tango"	"Eşya seçeneklerini görüntülemek için buraya sağ tıklayın."
"[english]scenario_items_ui_tip_sell_tango"	"Right-Click here to see item options"
"scenario_items_ui_tip_unlock_booster"	"Eşya seçeneklerini görüntülemek için buraya sağ tıklayın."
"[english]scenario_items_ui_tip_unlock_booster"	"Right-Click here to see item options"
"scenario_items_ui_tip_unlock_boots"	"Eşya seçeneklerini görüntülemek için buraya sağ tıklayın."
"[english]scenario_items_ui_tip_unlock_boots"	"Right-Click here to see item options"
"scenario_items_failure_item_lost"	"Gerekli bir eşya eksik."
"[english]scenario_items_failure_item_lost"	"An essential item is missing."
"scenario_dodging_main_objective"	"Size hedefleyen bütün büyülerden sıyrılın."
"[english]scenario_dodging_main_objective"	"Dodge all the spells aimed at you"
"scenario_dodging_task_move_to_location_1"	"Sonraki aşamayı başlatmak için butona basın."
"[english]scenario_dodging_task_move_to_location_1"	"Push the button to start the next phase"
"scenario_dodging_task_move_to_location_1_Description"	"Hareket etmek için zemine sağ tıklayın."
"[english]scenario_dodging_task_move_to_location_1_Description"	"Right-Click on the ground to move."
"scenario_dodging_task_move_to_location_2"	"Sonraki aşamayı başlatmak için butona basın."
"[english]scenario_dodging_task_move_to_location_2"	"Push the button to start the next phase"
"scenario_dodging_task_move_to_location_2_Description"	"Hareket etmek için zemine sağ tıklayın."
"[english]scenario_dodging_task_move_to_location_2_Description"	"Right-Click on the ground to move."
"scenario_dodging_task_move_to_location_3"	"Sonraki aşamayı başlatmak için butona basın."
"[english]scenario_dodging_task_move_to_location_3"	"Push the button to start the next phase"
"scenario_dodging_task_move_to_location_3_Description"	"Hareket etmek için zemine sağ tıklayın."
"[english]scenario_dodging_task_move_to_location_3_Description"	"Right-Click on the ground to move."
"scenario_dodging_task_dodge_all_arrows"	"Mirana'nın bütün oklarından sıyrılın."
"[english]scenario_dodging_task_dodge_all_arrows"	"Dodge all of Mirana's Arrows"
"scenario_dodging_task_dodge_all_arrows_Description"	"Okların yolundan çekilerek gelecek hasardan kurtulun."
"[english]scenario_dodging_task_dodge_all_arrows_Description"	"Evade damage by moving out of the way of the Arrow"
"scenario_dodging_task_dodge_all_missiles_1"	"Tinker'ın 3 füzesinden kurtulun."
"[english]scenario_dodging_task_dodge_all_missiles_1"	"Evade 3 of Tinker's Missiles"
"scenario_dodging_task_dodge_all_missiles_1_Description"	"Füzelerden kaçınmak için Blink Dagger kullanın."
"[english]scenario_dodging_task_dodge_all_missiles_1_Description"	"Use Blink Dagger to disjoint the missiles"
"scenario_dodging_task_dodge_all_missiles_2"	"Tinker'ın 3 füzesinden sıyrılın."
"[english]scenario_dodging_task_dodge_all_missiles_2"	"Dodge 3 more Tinker's Missiles"
"scenario_dodging_task_dodge_all_missiles_2_Description"	"Füzelerden kaçınmak için Manta Style, Eul's Scepter ve Blink Dagger kullanın."
"[english]scenario_dodging_task_dodge_all_missiles_2_Description"	"Use Manta Style, Eul's Scepter and Blink Dagger to disjoint the missiles."
"scenario_dodging_task_outro_delay"	"Kazandınız!"
"[english]scenario_dodging_task_outro_delay"	"You won!"
"scenario_dodging_task_outro_delay_Description"	"Bütün füzelerden kaçındınız!"
"[english]scenario_dodging_task_outro_delay_Description"	"All missiles disjointed!"
"scenario_dodging_wizard_tip_intro_Text"	"Dota'da atılan ve vurulmak istemeyeceğiniz farklı türlerde \"mermiler\" vardır. Bu senaryoda iki ana tür gösterilecek: Lineer ve kovalayıcı."
"[english]scenario_dodging_wizard_tip_intro_Text"	"There are different types of projectiles in Dota, and you don't want to get hit by most of them. This scenario shows the two main kinds - Linear and Tracking."
"scenario_dodging_wizard_tip_intro_Annotation"	"Bunlardan isabet almamak zafere atılan emin adımlardan biridir!"
"[english]scenario_dodging_wizard_tip_intro_Annotation"	"Finding ways to avoid getting hit is key to victory!"
"scenario_dodging_wizard_tip_dodge_all_arrows_Text"	"Mirana'nın Sacred Arrow'u lineerdir, yani düz bir hat üzerinde ilerler. Okun yolundan çekilerek kurtulabilirsiniz."
"[english]scenario_dodging_wizard_tip_dodge_all_arrows_Text"	"Mirana's Sacred Arrow is a Linear Projectile, meaning that it flies in a straight line. You can just walk out of their way."
"scenario_dodging_wizard_tip_dodge_all_arrows_Annotation"	"Gerçek maçlarda oyuncular genellikle beklenmeyen açılardan ateş etmeye çalışır!"
"[english]scenario_dodging_wizard_tip_dodge_all_arrows_Annotation"	"In a real game players will often look for unexpected angles to fire from!"
"scenario_dodging_wizard_tip_move_to_location_2_Text"	"Çok iyi! Sıradaki test için Tinker'ın Heat Seeking Missile'larından kaçmak için kullanacağınız bir Blink Dagger vereceğiz. Endişe etmeyin, her füzeden önce Blink Dagger'ın dolum süresini sıfırlayacağız."
"[english]scenario_dodging_wizard_tip_move_to_location_2_Text"	"Good job! For this next test we will give you a blink to practice evading Tinker's Heat Seeking Missiles. Don't worry, we'll refresh the blink before each missile."
"scenario_dodging_wizard_tip_move_to_location_2_Annotation"	"Endişe etmeyin, her füzeden önce Blink Dagger'ın dolum süresini sıfırlayacağız."
"[english]scenario_dodging_wizard_tip_move_to_location_2_Annotation"	"Don't worry, we'll refresh the blink before each missile."
"scenario_dodging_wizard_tip_dodge_all_missiles_1_Text"	"Tinker'ın füzeleri kovalayıcıdır, yani bu füzeler kahramanınızın peşine düşer. Bunlardan kaçınabilirsiniz. Blink sahibi olduğunuz sürece size gelen bu füzelerden kaçınabilirsiniz!"
"[english]scenario_dodging_wizard_tip_dodge_all_missiles_1_Text"	"Tinker's Missiles are tracking, so they will follow your hero. They can also be disjointed, meaning as long as you Blink at any time during their flight, they will miss!"
"scenario_dodging_wizard_tip_dodge_all_missiles_1_Annotation"	"Bu tür büyülerden Eul's Scepter veya Manta Style gibi eşyaları kullanarak da kaçınabilirsiniz."
"[english]scenario_dodging_wizard_tip_dodge_all_missiles_1_Annotation"	"These types of spells can also be disjointed by items like Eul's Scepter or Manta Style."
"scenario_dodging_wizard_tip_move_to_location_3_Text"	"Harika! Eul's Scepter ve Manta Style, kovalayıcılardan sıyrılmada kullanabileceğiniz eşyalardandır."
"[english]scenario_dodging_wizard_tip_move_to_location_3_Text"	"Great! Other items that can allow you to dodge tracking projectiles are Eul's Scepter and Manta Style."
"scenario_dodging_wizard_tip_move_to_location_3_Annotation"	"Eşyaların dolum süreleri tazelenmeyecek. Füzelerden kaçmak için bu eşyaların hepsini teker teker kullanmalısınız."
"[english]scenario_dodging_wizard_tip_move_to_location_3_Annotation"	"The items will not refresh, you will have to use each of them to dodge the missile!"
"scenario_dodging_wizard_tip_dodge_all_missiles_2_Text"	"Menzilli saldırılardan sıyrılmak için Manta Style, Eul's Scepter ve Blink Dagger da kullanabilirsiniz!"
"[english]scenario_dodging_wizard_tip_dodge_all_missiles_2_Text"	"You can also use Manta Style, Eul's Scepter and Blink dagger to dodge ranged attacks!"
"scenario_dodging_wizard_tip_dodge_all_missiles_2_Annotation"	"Menzilli saldırılardan sıyrılmak için bunları da kullanabilirsiniz!"
"[english]scenario_dodging_wizard_tip_dodge_all_missiles_2_Annotation"	"You can also use these to dodge ranged attacks!"
"scenario_euls_setup_wizard_tip_dodge_all_arrows_hit_Text"	"Vuruldunuz! Bu aşamadaki ilerlemenizi sıfırladık. Sürekli hareket etmeyi unutmayın!"
"[english]scenario_euls_setup_wizard_tip_dodge_all_arrows_hit_Text"	"You got hit! We've reset your progress for this phase. Remember to keep moving!"
"scenario_euls_setup_wizard_tip_dodge_all_missiles_1_hit_Text"	"Vuruldunuz! Bu aşamadaki ilerlemenizi sıfırladık. Füzeler havadayken istediğiniz an Blink Dagger'ı kullanabileceğinizi unutmayın!"
"[english]scenario_euls_setup_wizard_tip_dodge_all_missiles_1_hit_Text"	"You got hit! We've reset your progress for this phase. Remember, you can use Blink at any time while the missiles are in the air!"
"scenario_euls_setup_wizard_tip_dodge_all_missiles_2_hit_Text"	"Vuruldunuz! Bu aşamadaki ilerlemenizi sıfırladık. Bu senaryoyu tamamlamak için 3 eşyanın tamamını doğru bir şekilde kullanmalısınız."
"[english]scenario_euls_setup_wizard_tip_dodge_all_missiles_2_hit_Text"	"You got hit! We've reset your items and your progress for this phase. You'll need to successfuly use all 3 items to complete this scenario."
"scenario_bkb_pa_main_objective"	"Black King Bar'ı ve büyü bağışıklığını öğrenin."
"[english]scenario_bkb_pa_main_objective"	"Learn about Black King Bar and Magic Immunity"
"scenario_bkb_pa_task_root"	"[Ana görev]"
"[english]scenario_bkb_pa_task_root"	"[Root task]"
"scenario_bkb_pa_task_move_near_rune"	"Ödül rününe doğru ilerleyin."
"[english]scenario_bkb_pa_task_move_near_rune"	"Advance towards the Bounty Rune"
"scenario_bkb_pa_task_move_near_rune_Description"	"Hareket etmek için zemine sağ tıklayın."
"[english]scenario_bkb_pa_task_move_near_rune_Description"	"Right-click on the ground to move."
"scenario_bkb_pa_task_kill_enemies"	"Sizi öldürmeden her iki düşmanı da öldürün."
"[english]scenario_bkb_pa_task_kill_enemies"	"Kill both enemies before they kill you"
"scenario_bkb_pa_task_kill_enemies_Description"	"Üzerine tıklayarak veya tuşuna basarak Black King Bar'ı etkinleştirin."
"[english]scenario_bkb_pa_task_kill_enemies_Description"	"Activate your Black King Bar by clicking on it or pressing its hotkey."
"scenario_bkb_pa_wizard_tip_bkb_Text"	"Black King Bar'ı dövüşten hemen önce etkinleştirin. Birkaç saniyeliğine gelen büyülere bağışıklık kazanırsınız."
"[english]scenario_bkb_pa_wizard_tip_bkb_Text"	"Activate your Black King Bar right before the fight. It makes you immune to spells for a few seconds."
"scenario_creep_pulling_main_objective"	"Tarafsız yaratıkları kendi kulvar yaratıklarınıza çekmeyi öğrenin."
"[english]scenario_creep_pulling_main_objective"	"Learn to pull neutral creeps into your lane creeps"
"scenario_creep_pulling_task_move_to_location_1"	"Kahramanınızı ilgili konuma doğru ilerletin."
"[english]scenario_creep_pulling_task_move_to_location_1"	"Move your hero to the location"
"scenario_creep_pulling_task_move_to_location_1_Description"	"Hareket etmek için zemine sağ tıklayın."
"[english]scenario_creep_pulling_task_move_to_location_1_Description"	"Right-Click on the ground to move."
"scenario_creep_pulling_task_attack_neutral_creep_1"	"Tarafsız yaratığa saldırın ama öldürmeyin."
"[english]scenario_creep_pulling_task_attack_neutral_creep_1"	"Attack the neutral creep but do not kill it"
"scenario_creep_pulling_task_attack_neutral_creep_1_Description"	"Saldırmak için tarafsız yaratıklara sağ tıklayın."
"[english]scenario_creep_pulling_task_attack_neutral_creep_1_Description"	"Right-Click on the neutral creep to attack."
"scenario_creep_pulling_task_lead_neutral_creep_1"	"Tarafsız yaratığı kendi kulvar yaratıklarınıza doğru çekin."
"[english]scenario_creep_pulling_task_lead_neutral_creep_1"	"Lead the neutral creep to your lane creep"
"scenario_creep_pulling_task_lead_neutral_creep_1_Description"	"Hareket etmek için zemine sağ tıklayın. İpucu konumuna doğru ilerleyin."
"[english]scenario_creep_pulling_task_lead_neutral_creep_1_Description"	"Right-Click on the ground to move.  Head toward the hint location."
"scenario_creep_pulling_task_move_to_location_2"	"Kahramanınızı ilgili konuma doğru ilerletin."
"[english]scenario_creep_pulling_task_move_to_location_2"	"Move your hero to the location"
"scenario_creep_pulling_task_move_to_location_2_Description"	"Hareket etmek için zemine sağ tıklayın."
"[english]scenario_creep_pulling_task_move_to_location_2_Description"	"Right-Click on the ground to move."
"scenario_creep_pulling_task_attack_neutral_creep_2"	"Tarafsız yaratığa doğru zamanda saldırın."
"[english]scenario_creep_pulling_task_attack_neutral_creep_2"	"Attack the neutral creep at the right moment"
"scenario_creep_pulling_task_attack_neutral_creep_2_Description"	"Kulvar yaratıklarınız yaklaşırken tarafsız yaratığa sağ tıklayın."
"[english]scenario_creep_pulling_task_attack_neutral_creep_2_Description"	"Right-Click on the neutral creep when your lane creep approaches."
"scenario_creep_pulling_task_lead_neutral_creep_2"	"Tarafsız yaratığı kendi kulvar yaratıklarınıza doğru çekin."
"[english]scenario_creep_pulling_task_lead_neutral_creep_2"	"Lead the neutral creep to your lane creep"
"scenario_creep_pulling_task_lead_neutral_creep_2_Description"	"Hareket etmek için zemine sağ tıklayın. İpucu konumuna doğru ilerleyin."
"[english]scenario_creep_pulling_task_lead_neutral_creep_2_Description"	"Right-Click on the ground to move.  Head toward the hint location."
"scenario_creep_pulling_task_move_to_location_3"	"Kahramanınızı ilgili konuma doğru ilerletin."
"[english]scenario_creep_pulling_task_move_to_location_3"	"Move your hero to the location"
"scenario_creep_pulling_task_move_to_location_3_Description"	"Hareket etmek için zemine sağ tıklayın."
"[english]scenario_creep_pulling_task_move_to_location_3_Description"	"Right-Click on the ground to move."
"scenario_creep_pulling_task_attack_neutral_creep_3"	"Tarafsız bir yaratığa doğru zamanda saldırın."
"[english]scenario_creep_pulling_task_attack_neutral_creep_3"	"Attack a neutral creep at the right moment"
"scenario_creep_pulling_task_attack_neutral_creep_3_Description"	"Kulvar yaratıklarınız yaklaşırken tarafsız yaratığa sağ tıklayın."
"[english]scenario_creep_pulling_task_attack_neutral_creep_3_Description"	"Right-Click on the neutral creep when your creep wave approaches."
"scenario_creep_pulling_task_lead_neutral_creep_3"	"Tarafsız yaratıkları kendi kulvar yaratıklarınıza doğru çekin."
"[english]scenario_creep_pulling_task_lead_neutral_creep_3"	"Lead the neutral creeps to your lane creeps"
"scenario_creep_pulling_task_lead_neutral_creep_3_Description"	"Hareket etmek için zemine sağ tıklayın. İpucu konumuna doğru ilerleyin."
"[english]scenario_creep_pulling_task_lead_neutral_creep_3_Description"	"Right-Click on the ground to move.  Head toward the hint location."
"scenario_creep_pulling_hint_good"	"Kulvar yaratıklarının burada buluşması<br>Radiant için daha iyidir."
"[english]scenario_creep_pulling_hint_good"	"Lane creeps meeting at this point<br>is better for Radiant."
"scenario_creep_pulling_hint_bad"	"Kulvar yaratıklarının burada buluşması<br>Dire için daha iyidir."
"[english]scenario_creep_pulling_hint_bad"	"Lane creeps meeting at this point<br>is better for Dire."
"scenario_creep_pulling_hint_pulling_time"	"Yaratık dalganızın pozisyonuna dikkat edin.<br>Saldırınızı iyi zamanlayın."
"[english]scenario_creep_pulling_hint_pulling_time"	"Watch your creep wave's position.<br>Time your attack."
"scenario_creep_pulling_wizard_tip_intro1_Text"	"Rakip kulvar yaratıkları farklı konumlarda buluşabilir."
"[english]scenario_creep_pulling_wizard_tip_intro1_Text"	"Opposing lane creeps can meet at different positions."
"scenario_creep_pulling_wizard_tip_intro2_Text"	"Her takım yaratıklarının kulelerine yakın bir yerde buluşmasını ister."
"[english]scenario_creep_pulling_wizard_tip_intro2_Text"	"Each team wants the creeps to meet closer to their tower."
"scenario_creep_pulling_wizard_tip_intro_radiant_Text"	"Kulvar yaratıklarının burada buluşması Radiant için daha iyidir."
"[english]scenario_creep_pulling_wizard_tip_intro_radiant_Text"	"Lane creeps meeting at this point is better for Radiant."
"scenario_creep_pulling_wizard_tip_intro_dire_Text"	"Kulvar yaratıklarının burada buluşması Dire için daha iyidir."
"[english]scenario_creep_pulling_wizard_tip_intro_dire_Text"	"Lane creeps meeting at this point is better for Dire."
"scenario_creep_pulling_wizard_tip_reason_Text"	"Tarafsız yaratıkları kulvara çekerseniz kulvar yaratıklarınızın yönünü ve dolayısıyla buluşma noktalarını değiştirebilirsiniz."
"[english]scenario_creep_pulling_wizard_tip_reason_Text"	"Pulling neutral creeps into the lane can divert your lane creeps and change the location of where the creep waves meet."
"scenario_creep_pulling_wizard_tip_negative_Text"	"Yaratık çekmek her zaman avantajlı bir eylem değildir."
"[english]scenario_creep_pulling_wizard_tip_negative_Text"	"Pulling creeps is not always beneficial."
"scenario_creep_pulling_failure_creeps_did_not_get_pulled"	"Yaratıklar çekilmedi."
"[english]scenario_creep_pulling_failure_creeps_did_not_get_pulled"	"Creeps did not get pulled."
"scenario_creep_pulling_failure_did_not_attack_in_time"	"Yaratıklar zamanında çekilmedi."
"[english]scenario_creep_pulling_failure_did_not_attack_in_time"	"Did not pull the creeps in time."
"scenario_creep_stacking_main_objective"	"Tarafsız yaratık kamplarını istiflemeyi öğrenin."
"[english]scenario_creep_stacking_main_objective"	"Learn to stack neutral creep camps"
"scenario_creep_stacking_task_move_to_location_1"	"Kahramanınızı ilgili konuma doğru ilerletin."
"[english]scenario_creep_stacking_task_move_to_location_1"	"Move your hero to the location"
"scenario_creep_stacking_task_move_to_location_1_Description"	"Hareket etmek için zemine sağ tıklayın."
"[english]scenario_creep_stacking_task_move_to_location_1_Description"	"Right-Click on the ground to move."
"scenario_creep_stacking_task_attack_neutral_creep_1"	"Tarafsız yaratığa saldırın ama öldürmeyin."
"[english]scenario_creep_stacking_task_attack_neutral_creep_1"	"Attack the neutral creep but do not kill it"
"scenario_creep_stacking_task_attack_neutral_creep_1_Description"	"Saldırmak için tarafsız yaratıklara sağ tıklayın."
"[english]scenario_creep_stacking_task_attack_neutral_creep_1_Description"	"Right-Click on the neutral creep to attack."
"scenario_creep_stacking_task_lead_neutral_creep_1"	"Tarafsız yaratığı kampınızı sınırlarından uzaklaştırın."
"[english]scenario_creep_stacking_task_lead_neutral_creep_1"	"Lead the neutral creep out of the camp's borders"
"scenario_creep_stacking_task_lead_neutral_creep_1_Description"	"Hareket etmek için zemine sağ tıklayın. İpucu konumuna doğru ilerleyin."
"[english]scenario_creep_stacking_task_lead_neutral_creep_1_Description"	"Right-Click on the ground to move.  Head toward the hint location."
"scenario_creep_stacking_task_move_to_location_3"	"Kahramanınızı ilgili konuma doğru ilerletin."
"[english]scenario_creep_stacking_task_move_to_location_3"	"Move your hero to the location"
"scenario_creep_stacking_task_move_to_location_3_Description"	"Hareket etmek için zemine sağ tıklayın."
"[english]scenario_creep_stacking_task_move_to_location_3_Description"	"Right-Click on the ground to move."
"scenario_creep_stacking_task_attack_neutral_creep_3"	"Tarafsız bir yaratığa 54. saniyede saldırın."
"[english]scenario_creep_stacking_task_attack_neutral_creep_3"	"Attack a neutral creep at the 54 second mark"
"scenario_creep_stacking_task_attack_neutral_creep_3_Description"	"Sayaç 54. saniyeye ulaştığında tarafsız yaratığa sağ tıklayın."
"[english]scenario_creep_stacking_task_attack_neutral_creep_3_Description"	"Right-Click on the neutral creep when the timer is at 54 seconds."
"scenario_creep_stacking_task_lead_neutral_creep_3"	"Kampı istifleyin."
"[english]scenario_creep_stacking_task_lead_neutral_creep_3"	"Stack the camp"
"scenario_creep_stacking_task_lead_neutral_creep_3_Description"	"İpucu konumuna doğru ilerleyin. Sayaç 60. saniyedeyken kamp tamamen boş olmalıdır."
"[english]scenario_creep_stacking_task_lead_neutral_creep_3_Description"	"Head toward the hint location.  The camp must be completely empty at the 60 second mark."
"scenario_creep_stacking_timer_header"	"Oyun Süresi:"
"[english]scenario_creep_stacking_timer_header"	"Game Time:"
"scenario_creep_stacking_hint_camp_borders"	"Kamp sınırları<br>bu senaryo için belirtilmiştir."
"[english]scenario_creep_stacking_hint_camp_borders"	"The borders of the camp<br>are highlighted for this scenario."
"scenario_creep_stacking_hint_stacking_time"	"Süreye dikkat edin!<br>54. saniyede saldırın."
"[english]scenario_creep_stacking_hint_stacking_time"	"Watch the clock!<br>Attack at 54 seconds."
"scenario_creep_stacking_wizard_tip_intro_Text"	"Birden fazla tarafsız yaratık grubunun aynı doğma noktasında çıkarılmasına istifleme denir."
"[english]scenario_creep_stacking_wizard_tip_intro_Text"	"Causing multiple neutral creep groups to spawn in the same camp is called Stacking."
"scenario_creep_stacking_wizard_tip_chase_Text"	"Saldırdığınız takdirde tarafsız yaratıklar peşinize düşer."
"[english]scenario_creep_stacking_wizard_tip_chase_Text"	"Neutral creeps will chase you if you attack them."
"scenario_creep_stacking_wizard_tip_out_Text"	"Onları kamp sınırlarından dışarı çekmeye çalışın."
"[english]scenario_creep_stacking_wizard_tip_out_Text"	"Try to lead them out of their camp's borders."
"scenario_creep_stacking_wizard_tip_leash_Text"	"Bu yaratıklar kamplarına bağlıdır ve birkaç saniye sonra kamplarına geri dönerler."
"[english]scenario_creep_stacking_wizard_tip_leash_Text"	"They are leashed to their camp and will return after a few seconds."
"scenario_creep_stacking_wizard_tip_respawn_Text"	"Yeni bir dakikaya girildiğinde tarafsız yaratıklar, kamplarında başka birimler olmadığı müddetçe yeniden doğar."
"[english]scenario_creep_stacking_wizard_tip_respawn_Text"	"Neutral creeps respawn at the minute mark but only if no other units are inside their camp."
"scenario_creep_stacking_wizard_tip_stacking_time_Text"	"Yeni dakika başlangıcında kamp boş olacak şekilde bütün yaratıkları kamp sınırlarından uzaklaştırın."
"[english]scenario_creep_stacking_wizard_tip_stacking_time_Text"	"Lead the entire camp out of their borders so the camp is empty at the minute mark."
"scenario_status_effects_main_objective"	"Tarafsız yaratıkları kendi kulvar yaratıklarınıza doğru çekmeyi öğrenin."
"[english]scenario_status_effects_main_objective"	"Learn about the main status effects in Dota"
"scenario_status_effects_task_move_to_location_1"	"Sonraki aşamayı başlatmak için butona basın."
"[english]scenario_status_effects_task_move_to_location_1"	"Push the button to start the next phase"
"scenario_status_effects_task_move_to_location_1_Description"	"Hareket etmek için zemine sağ tıklayın."
"[english]scenario_status_effects_task_move_to_location_1_Description"	"Right-Click on the ground to move"
"scenario_status_effects_task_move_to_location_2"	"Sonraki aşamayı başlatmak için butona basın."
"[english]scenario_status_effects_task_move_to_location_2"	"Push the button to start the next phase"
"scenario_status_effects_task_move_to_location_2_Description"	"Hareket etmek için zemine sağ tıklayın."
"[english]scenario_status_effects_task_move_to_location_2_Description"	"Right-Click on the ground to move"
"scenario_status_effects_task_move_to_location_3"	"Sonraki aşamayı başlatmak için butona basın."
"[english]scenario_status_effects_task_move_to_location_3"	"Push the button to start the next phase"
"scenario_status_effects_task_move_to_location_3_Description"	"Hareket etmek için zemine sağ tıklayın."
"[english]scenario_status_effects_task_move_to_location_3_Description"	"Right-Click on the ground to move"
"scenario_status_effects_task_move_to_location_4"	"Sonraki aşamayı başlatmak için butona basın."
"[english]scenario_status_effects_task_move_to_location_4"	"Push the button to start the next phase"
"scenario_status_effects_task_move_to_location_4_Description"	"Hareket etmek için zemine sağ tıklayın."
"[english]scenario_status_effects_task_move_to_location_4_Description"	"Right-Click on the ground to move"
"scenario_status_effects_task_stun_enemy_hero"	"Shadow Shaman'ı sersemletin ve öldürmeye çalışın."
"[english]scenario_status_effects_task_stun_enemy_hero"	"Stun Shadow Shaman help kill him"
"scenario_status_effects_task_stun_enemy_hero_Description"	"Shadow Shaman'ı sersemletmek için Abyssal Blade'in etkin yeteneğini kullanın."
"[english]scenario_status_effects_task_stun_enemy_hero_Description"	"Use Abyssal Blade's active ability to stun the Shadow Shaman"
"scenario_status_effects_task_silence_enemy_hero"	"Tinker'ı susturun ve öldürmeye çalışın."
"[english]scenario_status_effects_task_silence_enemy_hero"	"Silence Tinker and help kill him"
"scenario_status_effects_task_silence_enemy_hero_Description"	"Tinker'ı susturmak için Orchid Malevolence'ın etkin yeteneğini kullanın."
"[english]scenario_status_effects_task_silence_enemy_hero_Description"	"Use Orchid Malevolence's active ability to silence Tinker"
"scenario_status_effects_task_root_enemy_hero"	"Dark Seer'ı yere bağlayın ve öldürmeye çalışın."
"[english]scenario_status_effects_task_root_enemy_hero"	"Root the Dark Seer and help kill him"
"scenario_status_effects_task_root_enemy_hero_Description"	"Dark Seer'ı yere bağlamak için Rod of Atos'un etkin yeteneğini kullanın."
"[english]scenario_status_effects_task_root_enemy_hero_Description"	"Use Rod of Atos's active ability to root Dark Seer"
"scenario_status_effects_task_disarm_enemy_hero"	"Troll Warlord'u etkisizleştirin ve öldürmeye çalışın."
"[english]scenario_status_effects_task_disarm_enemy_hero"	"Disarm the Troll and help kill him"
"scenario_status_effects_task_disarm_enemy_hero_Description"	"Troll Warlord'u etkisizleştirmek için Heaven's Halberd'ın etkin yeteneğini kullanın."
"[english]scenario_status_effects_task_disarm_enemy_hero_Description"	"Use Heaven's Halberd active ability on Troll to disarm him"
"scenario_status_effects_wizard_tip_intro_Text"	"Şimdi Dota'daki bazı durum etkilerinden bahsedeceğiz."
"[english]scenario_status_effects_wizard_tip_intro_Text"	"We will go over some of the status effects that exist in a game of Dota"
"scenario_status_effects_wizard_tip_intro_Annotation"	"Dostlarınızın ve düşmanlarınızın neler yapabileceğini ve yapamayacağını bilmek stratejinizi belirlerken oldukça hayatidir."
"[english]scenario_status_effects_wizard_tip_intro_Annotation"	"Knowing what your allies and enemies can and cannot do at any moment is crucial when planning your strategy."
"scenario_status_effects_wizard_tip_stun_enemy_hero_Text"	"Sersemletmeler kahramanların hareket etmesini, saldırmasını ve büyü kullanmasını engeller; süreli büyüleri ve ışınlanmaları yarıda keser."
"[english]scenario_status_effects_wizard_tip_stun_enemy_hero_Text"	"Stuns prevent heroes from moving, attacking, and casting spells. They can also cancel channeled spells and teleports."
"scenario_status_effects_wizard_tip_stun_enemy_hero_Annotation"	"Shadow Shaman'ı sersemletmek için Abyssal Blade'in etkin yeteneğini kullanın."
"[english]scenario_status_effects_wizard_tip_stun_enemy_hero_Annotation"	"Try using your Abyssal Blade's active ability to stun the Shadow Shaman."
"scenario_status_effects_wizard_tip_silence_enemy_hero_Text"	"Laser, Drow Ranger'ı kör ettiği için bütün saldırıları ıskalıyor! Tinker'ı susturarak büyülerini kullanmasını engelleyin."
"[english]scenario_status_effects_wizard_tip_silence_enemy_hero_Text"	"The Drow Ranger is being blinded by the Laser and is missing all of her attacks! Silencing Tinker will prevent him from casting his spells."
"scenario_status_effects_wizard_tip_silence_enemy_hero_Annotation"	"Susturmalar kahramanların büyü kullanmasını engeller."
"[english]scenario_status_effects_wizard_tip_silence_enemy_hero_Annotation"	"Silences prevent heroes from casting spells."
"scenario_status_effects_wizard_tip_root_enemy_hero_Text"	"Yere bağlamalar kahramanların hareketsiz kalmasını sağlar ve atik düşmanlara karşı oldukça faydalıdır."
"[english]scenario_status_effects_wizard_tip_root_enemy_hero_Text"	"Roots prevent heroes from moving, and is a great tool against mobile enemies."
"scenario_status_effects_wizard_tip_root_enemy_hero_Annotation"	"Rod of Atos'un Cripple yeteneğini kullanarak Sven'in Dark Seer'a yetişmesini sağlayın."
"[english]scenario_status_effects_wizard_tip_root_enemy_hero_Annotation"	"Help Sven catch up to Dark Seer by using your Rod of Atos's Cripple ability"
"scenario_status_effects_wizard_tip_disarm_enemy_hero_Text"	"Etkisizleştirme kahramanların saldırmasını engeller ve güçlü fiziksel saldırılara sahip kahramanlara karşı oldukça faydalıdır."
"[english]scenario_status_effects_wizard_tip_disarm_enemy_hero_Text"	"Disarms prevent heroes from attacking, and works great against enemies with powerful physical attacks."
"scenario_status_effects_wizard_tip_disarm_enemy_hero_Annotation"	"Troll Warlord saldırılarıyla Storm Spirit'i sersemletti! Heaven's Halberd'la Troll Warlord'u etkisizleştirerek Strom Spirit'i kurtarın!"
"[english]scenario_status_effects_wizard_tip_disarm_enemy_hero_Annotation"	"Troll has locked down Storm Spirit with his attacks! Disarm him with Heaven's Halberd to save Storm!"
}
}
