"lang"
{
"Language"	"italian"
"Tokens"
{
"addon_game_name"	"Diretide"
"[english]addon_game_name"	"Diretide"
"DOTA_GameMode_15"	"Diretide"
"[english]DOTA_GameMode_15"	"Diretide"
"DOTA_GameMode_19"	"Diretide"
"[english]DOTA_GameMode_19"	"Diretide"
"DOTA_HUD_VS"	"vs"
"[english]DOTA_HUD_VS"	"vs"
"DOTA_HUD_Diretide_TimeLeft1"	"1"
"[english]DOTA_HUD_Diretide_TimeLeft1"	"1"
"DOTA_HUD_Diretide_TimeLeft2"	"2"
"[english]DOTA_HUD_Diretide_TimeLeft2"	"2"
"DOTA_HUD_Diretide_TimeLeft3"	"3"
"[english]DOTA_HUD_Diretide_TimeLeft3"	"3"
"npc_dota_roshan_diretide"	"Roshan"
"[english]npc_dota_roshan_diretide"	"Roshan"
"DOTA_Tooltip_ability_diretide_bucket_soldier_regen_building_passive_Lore"	""
"[english]DOTA_Tooltip_ability_diretide_bucket_soldier_regen_building_passive_Lore"	""
}
}
