"lang"
{
"Language"	"ukrainian"
"Tokens"
{
"addon_game_name"	"Пора Пітьми"
"[english]addon_game_name"	"Diretide"
"DOTA_GameMode_15"	"Пора Пітьми"
"[english]DOTA_GameMode_15"	"Diretide"
"DOTA_GameMode_19"	"Пора Пітьми"
"[english]DOTA_GameMode_19"	"Diretide"
"buy_spooky_tp"	"Купити моторошний телепорт"
"[english]buy_spooky_tp"	"Buy Spooky TP Scroll"
"buy_spooky_tp_description"	"Станьте лиховісно могутнім і вирушіть на ворожий бік мапи!"
"[english]buy_spooky_tp_description"	"Become hauntingly powerful and invade the enemy team's side of the map!"
"spawn_enemy_wave"	"Відродження монстрів"
"[english]spawn_enemy_wave"	"Spawn Monsters"
"spawn_enemy_wave_description"	"Надсилайте хвилю поточних монстрів на своїх суперників!"
"[english]spawn_enemy_wave_description"	"Send a wave of the current monsters at your opponents!"
"rosh_trick_or_treat"	"Рошанові цукерки або життя"
"[english]rosh_trick_or_treat"	"Roshan Trick Or Treat"
"rosh_trick_or_treat_description"	"Надсилайте Рошана вимагати цукерки або смерть у випадкового ворожого героя! Він забере їхні іриски… або їхнє ЖИТТЯ!"
"[english]rosh_trick_or_treat_description"	"Send Roshan to Trick or Treat from a random enemy hero!  He takes their taffy.. or their LIFE!"
"DOTA_HUD_RoshanTrickOrTreat_Toast"	"{s:player_name} надсилає Рошана по цукерки або життя!"
"[english]DOTA_HUD_RoshanTrickOrTreat_Toast"	"{s:player_name} sent Roshan trick or treating!"
"DOTA_HUD_RoshanTrickOrTreat_Target_Toast"	"Рошан тепер полює на {s:player_name}!"
"[english]DOTA_HUD_RoshanTrickOrTreat_Target_Toast"	"Roshan is now targeting {s:player_name}!"
"DOTA_HUD_PlayerInvasion_Toast"	"{s:player_name} вторгся до ворожої команди!"
"[english]DOTA_HUD_PlayerInvasion_Toast"	"{s:player_name} has invaded the enemy team!"
"DOTA_HUD_RoshanAttackRadiant_Toast"	"Сили Пітьми зібрали вдосталь ірисок! Рошана звільнено для нападу на сили Сяйва!"
"[english]DOTA_HUD_RoshanAttackRadiant_Toast"	"The Dire collected enough taffy! Roshan has been unleashed to attack The Radiant!"
"DOTA_HUD_RoshanAttackDire_Toast"	"Сили Сяйва зібрали вдосталь ірисок! Рошана звільнено для нападу на сили Пітьми!"
"[english]DOTA_HUD_RoshanAttackDire_Toast"	"The Radiant collected enough taffy! Roshan has been unleashed to attack The Dire!"
"DOTA_HUD_SpookyTPUsed_Toast"	"{s:player_name} вторгся до ворожої команди через портал!"
"[english]DOTA_HUD_SpookyTPUsed_Toast"	"{s:player_name} is invading the enemy team through a portal!"
"DOTA_HUD_PortalUnlocked_Toast"	"{s:player_name} відкрив портал для своєї команди!"
"[english]DOTA_HUD_PortalUnlocked_Toast"	"{s:player_name} unlocked a portal for their team!"
"DOTA_HUD_PortalUnlockedGood_Toast"	"Сяйво відкрило портал для своєї команди!"
"[english]DOTA_HUD_PortalUnlockedGood_Toast"	"The Radiant unlocked a portal for their team!"
"DOTA_HUD_PortalUnlockedBad_Toast"	"Пітьма відкрила портал для своєї команди!"
"[english]DOTA_HUD_PortalUnlockedBad_Toast"	"The Dire unlocked a portal for their team!"
"DOTA_HUD_RuneSpawned_Toast"	"{s:player_name} викликає руну для своєї команди!"
"[english]DOTA_HUD_RuneSpawned_Toast"	"{s:player_name} spawned a rune for their team!"
"DOTA_HUD_CandyBucketVulnerableGood_Toast"	"Домашній кошик Сяйва тепер вразливий!"
"[english]DOTA_HUD_CandyBucketVulnerableGood_Toast"	"The Radiant's Home Bucket is now vulnerable!"
"DOTA_HUD_CandyBucketVulnerableBad_Toast"	"Домашній кошик Пітьми тепер вразливий!"
"[english]DOTA_HUD_CandyBucketVulnerableBad_Toast"	"The Dire's Home Bucket is now vulnerable!"
"DOTA_HUD_RoshanCursedGoodTeam_Toast"	"Сили Сяйва було проклято через голодного Рошана!"
"[english]DOTA_HUD_RoshanCursedGoodTeam_Toast"	"Radiant cursed for not feeding Roshan!"
"DOTA_HUD_RoshanCursedBadTeam_Toast"	"Сили Пітьми було проклято через голодного Рошана!"
"[english]DOTA_HUD_RoshanCursedBadTeam_Toast"	"Dire cursed for not feeding Roshan!"
"DOTA_HUD_ScarecrowStashRespawn"	"Сховки опудала відродилися!"
"[english]DOTA_HUD_ScarecrowStashRespawn"	"The Scarecrow Stashes have respawned!"
"DOTA_HUD_Diretide_UnscoredCandy"	"Незараховані цукерки в героїв"
"[english]DOTA_HUD_Diretide_UnscoredCandy"	"Unscored Candy Held by Heroes"
"DOTA_diretide_gameplay_tips_count"	"ВІДДЯКИ: {d:current_tip_num} / {d:num_tips}"
"[english]DOTA_diretide_gameplay_tips_count"	"TIP {d:current_tip_num} / {d:num_tips}"
"DOTA_diretide_gameplay_tips_text"	"{s:tip_text}"
"[english]DOTA_diretide_gameplay_tips_text"	"{s:tip_text}"
"DOTA_diretide_gameplay_tip_00"	"Ви можете передати союзнику всі свої іриски, якщо застосуєте на нього здібність Кошик ірисок."
"[english]DOTA_diretide_gameplay_tip_00"	"You can throw your entire stash of Taffy to an ally by targeting them with the Taffy Bucket ability."
"DOTA_diretide_gameplay_tip_01"	"Ваше максимальне здоров’я зменшується на невеликий відсоток за кожну іриску, яку ви несете."
"[english]DOTA_diretide_gameplay_tip_01"	"Your maximum health is decreased by a small percentage for each taffy that you are carrying."
"DOTA_diretide_gameplay_tip_02"	"Якщо ви завдаєте кріпу з ірискою останній удар, то іриска полетить до вас!"
"[english]DOTA_diretide_gameplay_tip_02"	"Getting the last hit on a creep that's holding taffy will launch the taffy to you!"
"DOTA_diretide_gameplay_tip_03"	"Кожного раунду кріпи різні! Вивчіть їхні сильні та слабкі сторони."
"[english]DOTA_diretide_gameplay_tip_03"	"Each round has different creeps! Get to know their strengths and weaknesses."
"DOTA_diretide_gameplay_tip_04"	"Убивства кріпів дають золото й досвід усій вашій команді."
"[english]DOTA_diretide_gameplay_tip_04"	"Your entire team earns gold and xp as creeps are defeated."
"DOTA_diretide_gameplay_tip_05"	"Сховки опудала містять багацько ірисок і нейтральні предмети."
"[english]DOTA_diretide_gameplay_tip_05"	"Scarecrow Stashes contain lots of taffy and neutral items."
"DOTA_diretide_gameplay_tip_06"	"Два сховки опудал з’являються на першій, третій і п’ятій хвилині кожного раунду на півночі й півдні мапи."
"[english]DOTA_diretide_gameplay_tip_06"	"Two Scarecrow Stashes spawn at minutes 1, 3, and 5 of each round at the north and south locations on the map."
"DOTA_diretide_gameplay_tip_07"	"Рошан вивільняється на другій хвилині кожного раунду."
"[english]DOTA_diretide_gameplay_tip_07"	"Roshan is released 2 minutes into each round."
"DOTA_diretide_gameplay_tip_08"	"Іриски передаються в домашній кошик по черзі і цей процес не можна переривати."
"[english]DOTA_diretide_gameplay_tip_08"	"Taffy must be channeled one at a time into the home bucket and can be interrupted."
"DOTA_diretide_gameplay_tip_09"	"Руни з’являються в печері Рошана на другій, третій, четвертій і п’ятій хвилині."
"[english]DOTA_diretide_gameplay_tip_09"	"Runes spawn in Roshan’s pit at minutes 2, 3, 4, and 5."
"DOTA_diretide_gameplay_tip_10"	"Знищення ворожої криниці ірисок забере 10 ірисок із їхнього домашнього кошика."
"[english]DOTA_diretide_gameplay_tip_10"	"Destroying an enemy’s Taffy Well will extract 10 taffy from their home bucket."
"DOTA_diretide_gameplay_tip_11"	"Над головою Рошана вгорі інтерфейсу показується скільки ірисок він хоче."
"[english]DOTA_diretide_gameplay_tip_11"	"Look above Roshan’s head or to the top of the HUD to find out how much taffy he needs."
"DOTA_diretide_gameplay_tip_12"	"Рошан проклинає всю команду, якщо вбиває героя. Переконайтеся, що нагодували потвору!"
"[english]DOTA_diretide_gameplay_tip_12"	"Roshan will curse the entire team if he kills a hero. Make sure to feed The Beast!"
"DOTA_diretide_gameplay_tip_13"	"Рошанове прокляття витягує у вас чимало здоров’я, але воно не є фатальним!"
"[english]DOTA_diretide_gameplay_tip_13"	"Roshan’s curse is a powerful drain on your health, but it’s not fatal!"
"DOTA_diretide_gameplay_tip_14"	"Охоронців ірисок можна вбити й вони не відродяться до кінця раунду."
"[english]DOTA_diretide_gameplay_tip_14"	"Taffy Guardians can be killed and will not respawn until the end of the round."
"DOTA_diretide_gameplay_tip_15"	"Вартові варди оновлюються в крамниці між раундами."
"[english]DOTA_diretide_gameplay_tip_15"	"Sentry wards restock in-between rounds."
"DOTA_diretide_gameplay_tip_16"	"На ваш домашній кошик не можна напасти, допоки одну з ваших криниць ірисок не знищено."
"[english]DOTA_diretide_gameplay_tip_16"	"Your home bucket cannot be attacked until one of your Taffy Wells is destroyed."
"DOTA_diretide_gameplay_tip_17"	"Атакування ворожого домашнього кошика видобуватиме з нього іриски."
"[english]DOTA_diretide_gameplay_tip_17"	"Attacking the enemy’s home bucket will extract taffy from it."
"DOTA_diretide_gameplay_tip_18"	"На мапі є три крамниці. Там ви можете купувати предмети й отримувати доступ до нейтральних предметів."
"[english]DOTA_diretide_gameplay_tip_18"	"There are 3 shops on the map. You can buy items and access neutral items from these shops."
"DOTA_diretide_gameplay_tip_19"	"Рошан відштовхує й завдає шкоди будь-якій істоті на своєму шляху. Спрямуйте його на ворожу команду, аби створити максимум хаосу."
"[english]DOTA_diretide_gameplay_tip_19"	"Roshan creates a knock back and damages any unit in his path.  Lead him into the enemy team to cause maximum chaos."
"DOTA_diretide_gameplay_tip_20"	"Криниця ірисок та домашній кошик мають істинний зір у певному радіусі навколо них."
"[english]DOTA_diretide_gameplay_tip_20"	"Taffy Wells and the home buckets have a true sight radius around them."
"DOTA_diretide_gameplay_tip_21"	"Використовуйте сувій телепортації для повернення до домашнього кошика, коли зібрали багато ірисок."
"[english]DOTA_diretide_gameplay_tip_21"	"Use TP scrolls to return to your home bucket after collecting a lot of taffy."
"DOTA_diretide_gameplay_tip_22"	"Охоронці ірисок періодично лякають героїв під час влучання, а також регенерують здоров’я біля криниць."
"[english]DOTA_diretide_gameplay_tip_22"	"Taffy Guardians periodically fear heroes on-hit and regenerate health near their wells."
"DOTA_diretide_gameplay_tip_23"	"Зарядки героїв оновлюються кожного раунду."
"[english]DOTA_diretide_gameplay_tip_23"	"Hero cooldowns are refreshed every round."
"DOTA_diretide_gameplay_tip_24"	"Якщо команди мають однакову кількість ірисок наприкінці раунду, то додається 30 секунд додаткового часу!"
"[english]DOTA_diretide_gameplay_tip_24"	"If the teams are tied at the end of a round, 30 seconds of overtime will get added to the clock!"
"DOTA_diretide_gameplay_tip_25"	"Ваша команда має одну активацію гліфу фортифікації на раунд. Користуйтеся ним розумно!"
"[english]DOTA_diretide_gameplay_tip_25"	"Your team has one activation of the glyph of fortification per round. Use it wisely!"
"DOTA_diretide_gameplay_tip_26"	"Ви можете викупитися один раз за раунд."
"[english]DOTA_diretide_gameplay_tip_26"	"You can buy back once per round."
"DOTA_diretide_gameplay_tip_27"	"Торбинки жаденятських ірисок містять 5 ірисок."
"[english]DOTA_diretide_gameplay_tip_27"	"Bags of Greevil Taffy are worth 5 Taffy."
"DOTA_diretide_gameplay_tip_28"	"Номер раунду відповідає ступеню нейтральних предметів, що випадають зі сховків опудал."
"[english]DOTA_diretide_gameplay_tip_28"	"The round number corresponds to the tier of neutral items that will drop from Scarecrow Stashes."
"DOTA_diretide_gameplay_tip_29"	"Чим більше ірисок у вас, ніж у ваших суперників, тим більше від вашої команди вимагатиме Рошан. Використовуйте Рошана на свою користь, якщо відстаєте!"
"[english]DOTA_diretide_gameplay_tip_29"	"The larger your candy lead, the more candy Roshan will demand from your team. Use Roshan to your advantage if you're behind!"
"DOTA_Holdout_Round_Skeletons"	"Скелетні веселощі"
"[english]DOTA_Holdout_Round_Skeletons"	"Skele-tons of Fun"
"DOTA_Holdout_Round_Zombies"	"Неврівноважені зомбі"
"[english]DOTA_Holdout_Round_Zombies"	"Floppin' Zombies"
"DOTA_Holdout_Round_Hulks"	"Чудовиська з глибин"
"[english]DOTA_Holdout_Round_Hulks"	"Monsters From The Deep"
"DOTA_Holdout_Round_Ghosts"	"Моторошні привиди"
"[english]DOTA_Holdout_Round_Ghosts"	"Spooky Ghosts"
"DOTA_Holdout_Round_Spiders"	"Вибухові павуки"
"[english]DOTA_Holdout_Round_Spiders"	"Splodin' Spiders"
"DOTA_Radiant_Wins_Round"	"Сяйво перемагає"
"[english]DOTA_Radiant_Wins_Round"	"Radiant wins"
"DOTA_Dire_Wins_Round"	"Пітьма перемагає"
"[english]DOTA_Dire_Wins_Round"	"Dire wins"
"DOTA_Radiant_Candy_Score"	"{d:radiant_candy}"
"[english]DOTA_Radiant_Candy_Score"	"{d:radiant_candy}"
"DOTA_Dire_Candy_Score"	"{d:dire_candy}"
"[english]DOTA_Dire_Candy_Score"	"{d:dire_candy}"
"DOTA_HUD_VS"	"проти"
"[english]DOTA_HUD_VS"	"vs"
"DOTA_Round_Number"	"Раунд {d:round_number}"
"[english]DOTA_Round_Number"	"Round {d:round_number}"
"DOTA_HUD_Diretide_CurrentScore"	"Поточний рахунок"
"[english]DOTA_HUD_Diretide_CurrentScore"	"Current Score"
"DOTA_HUD_Diretide_FinalScore"	"Фінальний рахунок"
"[english]DOTA_HUD_Diretide_FinalScore"	"Final Score"
"DOTA_HUD_Diretide_RoshanCurse_Radiant"	"Рошан прокляв Сяйво"
"[english]DOTA_HUD_Diretide_RoshanCurse_Radiant"	"Roshan has cursed the Radiant"
"DOTA_HUD_Diretide_RoshanCurse_Dire"	"Рошан прокляв Пітьму"
"[english]DOTA_HUD_Diretide_RoshanCurse_Dire"	"Roshan has cursed the Dire"
"DOTA_HUD_Diretide_RoshanCurse_You"	"Рошан прокляв<br>ВАШУ КОМАНДУ"
"[english]DOTA_HUD_Diretide_RoshanCurse_You"	"Roshan has cursed<br>YOUR TEAM"
"DOTA_HUD_Diretide_RoshanCurse_Enemy"	"Рошан прокляв<br>ВОРОГІВ"
"[english]DOTA_HUD_Diretide_RoshanCurse_Enemy"	"Roshan has cursed<br>THE ENEMY"
"DOTA_HUD_Diretide_Overtime"	"Додатковий час: <br><span class=\"BoldMessageSmall\">+{d:extra_time} с</span>"
"[english]DOTA_HUD_Diretide_Overtime"	"Overtime<br><span class=\"BoldMessageSmall\">+{d:extra_time}s Added</span>"
"DOTA_HUD_Diretide_TimeLeft1"	"1"
"[english]DOTA_HUD_Diretide_TimeLeft1"	"1"
"DOTA_HUD_Diretide_TimeLeft2"	"2"
"[english]DOTA_HUD_Diretide_TimeLeft2"	"2"
"DOTA_HUD_Diretide_TimeLeft3"	"3"
"[english]DOTA_HUD_Diretide_TimeLeft3"	"3"
"DOTA_HUD_Diretide_TimeLeft10"	"Залишилося 10 с"
"[english]DOTA_HUD_Diretide_TimeLeft10"	"10s Remaining"
"DOTA_HUD_Diretide_TimeLeft20"	"Залишилося 20 с"
"[english]DOTA_HUD_Diretide_TimeLeft20"	"20s Remaining"
"DOTA_HUD_Diretide_RoshanTarget_Radiant"	"Рошан полює на Сяйво"
"[english]DOTA_HUD_Diretide_RoshanTarget_Radiant"	"Roshan is targeting the Radiant"
"DOTA_HUD_Diretide_RoshanTarget_Dire"	"Рошан полює на Пітьму"
"[english]DOTA_HUD_Diretide_RoshanTarget_Dire"	"Roshan is targeting the Dire"
"DOTA_HUD_Diretide_RoshanTarget_You"	"Рошан полює на <br><span class=\"BoldMessage\">ВАС</span>"
"[english]DOTA_HUD_Diretide_RoshanTarget_You"	"Roshan is coming after<br><span class=\"BoldMessage\">YOU</span>"
"DOTA_HUD_Diretide_RoshanTarget_Ally"	"Рошан полює на <br><span class=\"BoldMessageSmall\">ВАШОГО СОЮЗНИКА</span>"
"[english]DOTA_HUD_Diretide_RoshanTarget_Ally"	"Roshan is coming after<br><span class=\"BoldMessageSmall\">YOUR TEAMMATE</span>"
"DOTA_HUD_Diretide_RoshanTarget_Enemy"	"Рошан полює на ворога"
"[english]DOTA_HUD_Diretide_RoshanTarget_Enemy"	"Roshan is coming after an enemy"
"DOTA_HUD_Diretide_CandyBucketAttacked"	"Ваш кошик ірисок під атакою"
"[english]DOTA_HUD_Diretide_CandyBucketAttacked"	"Your Taffy Bucket is under attack"
"DOTA_HUD_Diretide_StashRespawn"	"Сховки опудал оновилися!"
"[english]DOTA_HUD_Diretide_StashRespawn"	"Scarecrow Stashes have refreshed!"
"npc_dota_radiant_bucket_soldier"	"Охоронець ірисок"
"[english]npc_dota_radiant_bucket_soldier"	"Taffy Guardian"
"npc_dota_dire_bucket_soldier"	"Охоронець ірисок"
"[english]npc_dota_dire_bucket_soldier"	"Taffy Guardian"
"npc_dota_diretide_portal"	"Портал вторгнення"
"[english]npc_dota_diretide_portal"	"Invasion Portal"
"npc_dota_crate"	"Дерев’яний ящик"
"[english]npc_dota_crate"	"Wooden Crate"
"npc_dota_creature_night_stalker"	"Нічний жах"
"[english]npc_dota_creature_night_stalker"	"Night Terror"
"npc_dota_creature_life_stealer"	"Загрозливий пожирач"
"[english]npc_dota_creature_life_stealer"	"Devouring Menace"
"npc_dota_creature_dark_troll_warlord"	"Темний троль-прикликач"
"[english]npc_dota_creature_dark_troll_warlord"	"Dark Troll Summoner"
"npc_dota_creature_hulk_radiant"	"Гнилий здоровило"
"[english]npc_dota_creature_hulk_radiant"	"Rotting Hulk"
"npc_dota_creature_hulk_dire"	"Гнійний здоровило"
"[english]npc_dota_creature_hulk_dire"	"Festering Hulk"
"npc_dota_creature_zombie_ogreseal"	"Зомбі Ґарі"
"[english]npc_dota_creature_zombie_ogreseal"	"Zombie Gary"
"npc_dota_creature_visage_familiar1"	"Вампір"
"[english]npc_dota_creature_visage_familiar1"	"Vampyre"
"npc_dota_black_dragon"	"Обсидіановий дракон"
"[english]npc_dota_black_dragon"	"Obsidian Dragon"
"npc_dota_creature_pumpkin_giant"	"Гарбузовий гігант"
"[english]npc_dota_creature_pumpkin_giant"	"Pumpkin Giant"
"npc_dota_creature_ranged_ghost"	"З’ява"
"[english]npc_dota_creature_ranged_ghost"	"Wraith"
"npc_dota_creature_melee_ghost"	"Привид"
"[english]npc_dota_creature_melee_ghost"	"Ghost"
"npc_dota_creature_huge_broodmother"	"Летючий арахнід"
"[english]npc_dota_creature_huge_broodmother"	"Volatile Arachnid"
"npc_dota_creature_newborn_spider"	"Новонароджений паразит"
"[english]npc_dota_creature_newborn_spider"	"Newborn Pest"
"neutral_candy_bucket"	"Сховок опудала"
"[english]neutral_candy_bucket"	"Scarecrow Stash"
"DOTA_Tooltip_ability_creature_life_stealer_rage"	"Rage"
"[english]DOTA_Tooltip_ability_creature_life_stealer_rage"	"Rage"
"DOTA_Tooltip_ability_creature_life_stealer_rage_Description"	"<b><font color='#F2A93E'>Лють</font></b>\nГероя охоплює приступ люті, який наділяє його імунітетом до чарів і збільшує швидкість руху.\n\nТИП РОЗВІЮВАННЯ: базове"
"[english]DOTA_Tooltip_ability_creature_life_stealer_rage_Description"	"Launch into a maddened rage, becoming Spell Immune, and gaining increased movement speed.\n\nDISPEL TYPE: Basic Dispel"
"DOTA_Tooltip_ability_creature_life_stealer_rage_Lore"	"Безумство та жорстокість Найкса робить його сильним і невблаганним ворогом на полі бою."
"[english]DOTA_Tooltip_ability_creature_life_stealer_rage_Lore"	"The madness and brutality of N'aix makes him a vicious and unrelenting foe in combat."
"DOTA_Tooltip_ability_creature_life_stealer_rage_Note0"	"При застосуванні герой втрачає більшість позитивних і негативних ефектів."
"[english]DOTA_Tooltip_ability_creature_life_stealer_rage_Note0"	"Upon casting, many buffs and debuffs will be removed."
"DOTA_Tooltip_ability_creature_life_stealer_rage_movement_speed_bonus"	"%ДОД. ШВИДКІСТЬ РУХУ:"
"[english]DOTA_Tooltip_ability_creature_life_stealer_rage_movement_speed_bonus"	"%MOVE SPEED BONUS:"
"DOTA_Tooltip_ability_creature_life_stealer_rage_duration"	"ТРИВАЛІСТЬ:"
"[english]DOTA_Tooltip_ability_creature_life_stealer_rage_duration"	"DURATION:"
"DOTA_Tooltip_ability_creature_life_stealer_feast"	"Feast"
"[english]DOTA_Tooltip_ability_creature_life_stealer_feast"	"Feast"
"DOTA_Tooltip_ability_creature_life_stealer_feast_Description"	"<b><font color='#F2A93E'>Пожива</font></b>\nАтаки Найкса лікують його на частку від максимального здоров’я цілі. Збільшуєтьтся швидкість атаки."
"[english]DOTA_Tooltip_ability_creature_life_stealer_feast_Description"	"Lifestealer's attacks heal himself for a percentage of his target's max health. Increases attack speed."
"DOTA_Tooltip_ability_creature_life_stealer_feast_Lore"	"Після втечі з клітки в Деварку Найкс харчувався плоттю та кістками тих, кому не поталанило опинитися на його шляху."
"[english]DOTA_Tooltip_ability_creature_life_stealer_feast_Lore"	"After escaping from his cell in Devarque, N'aix subsisted on flesh and bones of those unfortunate to cross his path."
"DOTA_Tooltip_ability_creature_life_stealer_feast_Note0"	"Не діє на Рошана."
"[english]DOTA_Tooltip_ability_creature_life_stealer_feast_Note0"	"Does not affect Roshan."
"DOTA_Tooltip_ability_creature_life_stealer_feast_Note1"	"Діє на істот з імунітетом до чарів."
"[english]DOTA_Tooltip_ability_creature_life_stealer_feast_Note1"	"Affects Spell Immune units."
"DOTA_Tooltip_ability_creature_life_stealer_feast_Note2"	"Відновлюване здоров’я не залежить від завданої шкоди."
"[english]DOTA_Tooltip_ability_creature_life_stealer_feast_Note2"	"The heal is independent of the damage."
"DOTA_Tooltip_ability_creature_life_stealer_feast_Note3"	"Поєднується з іншими ефектами вампіризму."
"[english]DOTA_Tooltip_ability_creature_life_stealer_feast_Note3"	"Stacks additively with other sources of Lifesteal."
"DOTA_Tooltip_ability_creature_life_stealer_feast_hp_leech_percent"	"%МАКС. ЗДОРОВ’Я ВІД ВАМПІРИЗМУ:"
"[english]DOTA_Tooltip_ability_creature_life_stealer_feast_hp_leech_percent"	"%MAX HEALTH LIFE STEAL:"
"DOTA_Tooltip_ability_creature_life_stealer_feast_attack_speed_bonus"	"ШВИДКІСТЬ АТАКИ:"
"[english]DOTA_Tooltip_ability_creature_life_stealer_feast_attack_speed_bonus"	"ATTACK SPEED:"
"DOTA_Tooltip_modifier_creature_life_stealer_rage"	"Лють"
"[english]DOTA_Tooltip_modifier_creature_life_stealer_rage"	"Rage"
"DOTA_Tooltip_modifier_creature_life_stealer_rage_Description"	"Підвищено швидкість атаки, імунітет до чарів й отримано 100% опору до магічної шкоди."
"[english]DOTA_Tooltip_modifier_creature_life_stealer_rage_Description"	"Gained attack speed, spell immunity, and 100% resistant to magic damage type."
"DOTA_Tooltip_ability_creature_dark_troll_warlord_raise_dead"	"Raise Dead"
"[english]DOTA_Tooltip_ability_creature_dark_troll_warlord_raise_dead"	"Raise Dead"
"DOTA_Tooltip_ability_creature_dark_troll_warlord_raise_dead_Description"	"<b><font color='#F2A93E'>Оживлення мерців</font></b>\nТемний троль-заклинач піднімає із землі рештки померлих тролів, повертаючи до життя двох Кістяних воїнів, які б’ються на його боці."
"[english]DOTA_Tooltip_ability_creature_dark_troll_warlord_raise_dead_Description"	"The Dark Troll Summoner stirs the ground underfoot, raising the remains of trolls long dead, bringing to life two skeleton Warriors who will fight at his side."
"npc_dota_creature_zombie_torso"	"Тіло зомбі"
"[english]npc_dota_creature_zombie_torso"	"Zombie Torso"
"npc_dota_creature_zombie_golem"	"Ґолем зомбі"
"[english]npc_dota_creature_zombie_golem"	"Zombie Golem"
"npc_dota_creature_zombie_basic"	"Зомбі"
"[english]npc_dota_creature_zombie_basic"	"Zombie"
"npc_dota_creature_skeleton_basic"	"Моторошний скелет"
"[english]npc_dota_creature_skeleton_basic"	"Spooky Skelly"
"npc_dota_creature_skeleton"	"Скелет"
"[english]npc_dota_creature_skeleton"	"Skeleton"
"npc_dota_creature_skeleton_champion"	"Скелет-чемпіон"
"[english]npc_dota_creature_skeleton_champion"	"Skeleton Champion"
"DOTA_Tooltip_ability_ogreseal_flop"	"Seal Flop"
"[english]DOTA_Tooltip_ability_ogreseal_flop"	"Seal Flop"
"DOTA_Tooltip_ability_ogreseal_flop_Description"	"<b><font color='#F2A93E'>Стрибок огоротюленя</font></b>\nПісля невеликої затримки стрибає вперед і двічі шльопає по землі, що приголомшує ворогів на %stun_duration% с і щоразу завдає %damage% шкоди."
"[english]DOTA_Tooltip_ability_ogreseal_flop_Description"	"Hop forward after a brief delay and smash the ground twice, stunning enemies for %stun_duration% seconds and dealing %damage% damage each time."
"DOTA_Tooltip_ability_ogreseal_stomp"	"Blubber Slam"
"[english]DOTA_Tooltip_ability_ogreseal_stomp"	"Blubber Slam"
"DOTA_Tooltip_ability_ogreseal_stomp_Description"	"<b><font color='#F2A93E'>Удар огротюленя</font></b>\nСтрибає високо в повітрі і приземлюється, що завдає %damage% шкоди і приголомшує ворогів на %stun_duration% с у радіусі %radius%. Удар також приголомшує зомбі Ґарі на %self_stun_duration% с."
"[english]DOTA_Tooltip_ability_ogreseal_stomp_Description"	"Leap high into the air and crash down, dealing %damage% damage and stunning enemies for %stun_duration% seconds in a %radius% radius. The impact also stuns the Odobenus Ghoul for %self_stun_duration% seconds."
"DOTA_Tooltip_ability_ogreseal_stickybomb"	"Ectoplasmic Fling"
"[english]DOTA_Tooltip_ability_ogreseal_stickybomb"	"Ectoplasmic Fling"
"DOTA_Tooltip_ability_ogreseal_stickybomb_Description"	"<b><font color='#F2A93E'>Кидок ектоплазми</font></b>\nЗомбі Ґарі жбурляє шмат ектоплазми в цільову зону, що сповільнює на %move_speed_penalty% всіх ворогів, які опиняються там у липкій калюжі. Калюжа триває %duration% с."
"[english]DOTA_Tooltip_ability_ogreseal_stickybomb_Description"	"The Odobenus Ghoul tosses a chunk of ectoplasm at the targeted area, slowing all enemies trapped in the resulting puddle of goo by %move_speed_penalty%. The puddle lasts for %duration% seconds."
"DOTA_Tooltip_ability_ogreseal_puke"	"Puke"
"[english]DOTA_Tooltip_ability_ogreseal_puke"	"Puke"
"DOTA_Tooltip_ability_ogreseal_puke_Description"	"<b><font color='#F2A93E'>Блювання</font></b>\nЗомбі Ґарі вибльовує купу ектоплазми в цільову зону, що сповільнює всіх зачеплених ворогів на %move_speed_penalty%%%. Вороги поруч стають розлюченими й починають атакувати цих героїв."
"[english]DOTA_Tooltip_ability_ogreseal_puke_Description"	"The Odobenus Ghoul pukes a pile of ectoplasm at the targeted area, slowing all enemies hit by %move_speed_penalty%%%. Nearby enemies are enraged and called to attack these heroes."
"DOTA_Tooltip_ability_ogreseal_explode"	"Blubber Bomb"
"[english]DOTA_Tooltip_ability_ogreseal_explode"	"Blubber Bomb"
"DOTA_Tooltip_ability_ogreseal_explode_Description"	"<b><font color='#F2A93E'>Вибух огротюленя</font></b>\nСтрибає високо в повітря й приземлюється, знищуючи себе, що завдає %damage% шкоди і сповільнює всіх зачеплених ворогів на %move_speed_penalty%%% в радіусі %radius%. Вороги поруч стають розлюченими й починають атакувати цих героїв."
"[english]DOTA_Tooltip_ability_ogreseal_explode_Description"	"Leap high into the air and crash down, destroying yourself to deal %damage% damage, slowing all enemies hit by %move_speed_penalty%%% in a %radius% radius. Nearby enemies are enraged and called to attack these heroes."
"DOTA_Tooltip_ability_hulk_immolation"	"Immolation"
"[english]DOTA_Tooltip_ability_hulk_immolation"	"Immolation"
"DOTA_Tooltip_ability_hulk_immolation_Description"	"<b><font color='#F2A93E'>Спалення</font></b>\nПідпалює ворогів поблизу здорованя періодичною шкодою."
"[english]DOTA_Tooltip_ability_hulk_immolation_Description"	"Burns the Hulk's nearby enemy units with damage per second."
"DOTA_Tooltip_ability_hulk_immolation_aura_damage"	"ШКОДА:"
"[english]DOTA_Tooltip_ability_hulk_immolation_aura_damage"	"DAMAGE:"
"DOTA_Tooltip_ability_hulk_immolation_aura_radius"	"РАДІУС АУРИ:"
"[english]DOTA_Tooltip_ability_hulk_immolation_aura_radius"	"AURA RADIUS:"
"DOTA_Tooltip_modifier_hulk_immolation_debuff"	"Спалення"
"[english]DOTA_Tooltip_modifier_hulk_immolation_debuff"	"Immolation"
"DOTA_Tooltip_modifier_hulk_immolation_debuff_Description"	"Отримує шкоду поблизу здорованя."
"[english]DOTA_Tooltip_modifier_hulk_immolation_debuff_Description"	"Taking damage while near a Hulk."
"DOTA_Tooltip_ability_building_defender_advantage"	"Defender Aura"
"[english]DOTA_Tooltip_ability_building_defender_advantage"	"Defender Aura"
"DOTA_Tooltip_ability_building_defender_advantage_Description"	"<b><font color='#F2A93E'>Аура захисника</font></b>\nДає %bonus_armor% броні та %bonus_hp_regen% регенерації здоров’я союзникам поблизу."
"[english]DOTA_Tooltip_ability_building_defender_advantage_Description"	"Provides %bonus_armor% armor and %bonus_hp_regen% health regeneration to nearby allies."
"DOTA_Tooltip_modifier_building_defender_advantage_buff"	"Захист Пори Пітьми"
"[english]DOTA_Tooltip_modifier_building_defender_advantage_buff"	"Diretide Defender"
"DOTA_Tooltip_modifier_building_defender_advantage_buff_Description"	"Отримує додаткову броню й регенерацію здоров’я від будівлі Пори Пітьми."
"[english]DOTA_Tooltip_modifier_building_defender_advantage_buff_Description"	"Receiving bonus armor and health regen from a Diretide building."
"DOTA_Tooltip_ability_bucket_soldier_attack"	"Spook 'Em"
"[english]DOTA_Tooltip_ability_bucket_soldier_attack"	"Spook 'Em"
"DOTA_Tooltip_ability_bucket_soldier_attack_Description"	"<b><font color='#F2A93E'>Переляк</font></b>\nCповільнює швидкість атаки та швидкість руху."
"[english]DOTA_Tooltip_ability_bucket_soldier_attack_Description"	"Slows attack speed and movement speed."
"DOTA_Tooltip_modifier_bucket_soldier_attack_debuff"	"Перелякано"
"[english]DOTA_Tooltip_modifier_bucket_soldier_attack_debuff"	"Spooked"
"DOTA_Tooltip_modifier_bucket_soldier_attack_debuff_Description"	"Cповільнено швидкість атаки та швидкість руху."
"[english]DOTA_Tooltip_modifier_bucket_soldier_attack_debuff_Description"	"This unit's attack speed and movement speed are slowed."
"DOTA_Tooltip_modifier_bucket_soldier_attack_fear"	"Перелякано"
"[english]DOTA_Tooltip_modifier_bucket_soldier_attack_fear"	"Spooked"
"DOTA_Tooltip_modifier_bucket_soldier_attack_fear_Description"	"Налякано чимось моторошним!"
"[english]DOTA_Tooltip_modifier_bucket_soldier_attack_fear_Description"	"Being scared by something spooky!"
"DOTA_Tooltip_modifier_ghost_pool_debuff"	"Примарний Мальстрем"
"[english]DOTA_Tooltip_modifier_ghost_pool_debuff"	"Ghostly Maelstrom"
"DOTA_Tooltip_modifier_ghost_pool_debuff_Description"	"Отримує періодичну шкоду."
"[english]DOTA_Tooltip_modifier_ghost_pool_debuff_Description"	"Receiving damage over time."
"npc_dota_roshan_diretide"	"Рошан"
"[english]npc_dota_roshan_diretide"	"Roshan"
"candy_bucket"	"Криниця ірисок"
"[english]candy_bucket"	"Taffy Well"
"home_candy_bucket"	"Домашній кошик"
"[english]home_candy_bucket"	"Home Bucket"
"DOTA_Tooltip_Ability_item_spooky_tpscroll"	"Spooky Scroll"
"[english]DOTA_Tooltip_Ability_item_spooky_tpscroll"	"Spooky TP Scroll"
"DOTA_Tooltip_Ability_item_spooky_tpscroll_Description"	"Телепортує на ворожий бік мапи на %buff_duration% с.\nНазва українською: <b><font color='#F2A93E'>Примарний сувій телепортації</font></b>"
"[english]DOTA_Tooltip_Ability_item_spooky_tpscroll_Description"	"Teleport to the enemy side of the map for %buff_duration% seconds."
"DOTA_Tooltip_modifier_spooky_tpscroll_buff"	"Ефект примарного сувою телепортації"
"[english]DOTA_Tooltip_modifier_spooky_tpscroll_buff"	"Spooky TP Scroll Buff"
"DOTA_Tooltip_modifier_spooky_tpscroll_buff_Description"	"Посилено примарним сувоєм телепортації."
"[english]DOTA_Tooltip_modifier_spooky_tpscroll_buff_Description"	"Juiced up by the Spooky TP"
"DOTA_Tooltip_Ability_item_candy"	"Жаденятська іриска"
"[english]DOTA_Tooltip_Ability_item_candy"	"Greevil Taffy"
"DOTA_Tooltip_Ability_item_candy_bag"	"Жаденятська торбинка ірисок"
"[english]DOTA_Tooltip_Ability_item_candy_bag"	"Greevil Taffy Bag"
"DOTA_Tooltip_modifier_hero_candy"	"Жаденятські іриски"
"[english]DOTA_Tooltip_modifier_hero_candy"	"Greevil Taffies"
"DOTA_Tooltip_modifier_hero_candy_Description"	"Кількість ірисок, які несе ця істота."
"[english]DOTA_Tooltip_modifier_hero_candy_Description"	"Number of taffies this unit is carrying."
"DOTA_Tooltip_modifier_candy_eat_regen"	"Ірискова регенерація"
"[english]DOTA_Tooltip_modifier_candy_eat_regen"	"Taffy Regen"
"DOTA_Tooltip_modifier_candy_eat_regen_Description"	"Регенерація здоров’я і мани від смачної іриски."
"[english]DOTA_Tooltip_modifier_candy_eat_regen_Description"	"Regenerating health and mana from delicious taffy."
"DOTA_Tooltip_modifier_candy_eaten_recently"	"Напханий ірисками"
"[english]DOTA_Tooltip_modifier_candy_eaten_recently"	"Full of taffy"
"DOTA_Tooltip_modifier_candy_eaten_recently_Description"	"Напхався ірисок так, що деякий час не може їсти більше."
"[english]DOTA_Tooltip_modifier_candy_eaten_recently_Description"	"Feeling full and unable to eat taffy for a bit."
"DOTA_Tooltip_Ability_item_hero_candy_bucket"	"Taffy Bag"
"[english]DOTA_Tooltip_Ability_item_hero_candy_bucket"	"Taffy Bag"
"DOTA_Tooltip_Ability_item_hero_candy_bucket_Description"	"<h1>Кидок (використ.)</h1>Цільтеся на домашній кошик своєї команди, щоби перекинути іриски.<br><br>Цільтеся на союзного героя, щоби передати свої іриски йому.<br><br>Цільтеся на Рошана, щоби нагодувати його потрібними йому ірисками, що ненадовго заспокоїть потвору.<br><br>Дальність: %abilitycastrange%\nНазва українською: <b><font color='#F2A93E'>Торбинка з ірисками</font></b>"
"[english]DOTA_Tooltip_Ability_item_hero_candy_bucket_Description"	"<h1>Use: Throw</h1>Target your team's home bucket to score.<br><br>Target an allied hero to transfer your taffy to them.<br><br>Target Roshan to feed him the taffy he demands, calming him down briefly.<br><br>Range: %abilitycastrange%"
"DOTA_Tooltip_Ability_item_hero_candy_bucket_Lore"	"Зберігає смачні іриски! Не кладіть сюди яблука!"
"[english]DOTA_Tooltip_Ability_item_hero_candy_bucket_Lore"	"Keeps delicious taffy! Do not put apples in here!"
"DOTA_Tooltip_Ability_hero_candy_bucket"	"Taffy Bag"
"[english]DOTA_Tooltip_Ability_hero_candy_bucket"	"Taffy Bag"
"DOTA_Tooltip_Ability_hero_candy_bucket_Description"	"<h1>Кидок (використ.)</h1>Цільтеся на домашній кошик своєї команди, щоби перекинути іриски.<br><br>Цільтеся на союзного героя, щоби передати свої іриски йому.<br><br>Цільтеся на Рошана, щоби нагодувати його потрібними йому ірисками, що ненадовго заспокоїть потвору.<br><br>Дальність: %abilitycastrange%\nНазва українською: <b><font color='#F2A93E'>Торбинка з ірисками</font></b>"
"[english]DOTA_Tooltip_Ability_hero_candy_bucket_Description"	"<h1>Use: Throw</h1>Target your team's home bucket to score.<br><br>Target an allied hero to transfer your taffy to them.<br><br>Target Roshan to feed him the taffy he demands, calming him down briefly.<br><br>Range: %abilitycastrange%"
"DOTA_Tooltip_Ability_hero_candy_bucket_Lore"	"Зберігає смачні іриски! Не кладіть сюди яблука!"
"[english]DOTA_Tooltip_Ability_hero_candy_bucket_Lore"	"Keeps delicious taffy! Do not put apples in here!"
"DOTA_Tooltip_modifier_item_hero_candy_bucket"	"Торбинка з ірисками"
"[english]DOTA_Tooltip_modifier_item_hero_candy_bucket"	"Taffy Bag"
"DOTA_Tooltip_modifier_item_hero_candy_bucket_Description"	"Несе небезпечну жаденятську іриску. Кожна така іриска зменшує максимальне здоров’я."
"[english]DOTA_Tooltip_modifier_item_hero_candy_bucket_Description"	"Carrying dangerous Greevil Taffy. Each stack reduces max hp."
"DOTA_Tooltip_modifier_hero_candy_bucket"	"Торбинка з ірисками"
"[english]DOTA_Tooltip_modifier_hero_candy_bucket"	"Taffy Bag"
"DOTA_Tooltip_modifier_hero_candy_bucket_Description"	"Несе небезпечну жаденятську іриску. Кожна така іриска зменшує максимальне здоров’я. Зменшено на %dMODIFIER_PROPERTY_EXTRA_HEALTH_PERCENTAGE%%%."
"[english]DOTA_Tooltip_modifier_hero_candy_bucket_Description"	"Carrying dangerous Greevil Taffy. Each stack reduces max HP.  Reduced by %dMODIFIER_PROPERTY_EXTRA_HEALTH_PERCENTAGE%%%."
"dota_hud_error_cant_cast_on_this_building"	"Здібність не діє на цю споруду."
"[english]dota_hud_error_cant_cast_on_this_building"	"Ability Can't Target That Building."
"dota_hud_error_candy_already_in_flight"	"Іриска вже летить!"
"[english]dota_hud_error_candy_already_in_flight"	"Taffy already in-flight!"
"dota_hud_error_candy_eaten_recently"	"Розболівся живіт!"
"[english]dota_hud_error_candy_eaten_recently"	"You'll get a tummy ache!"
"dota_hud_error_cant_cast_on_roshan_not_hungry"	"Рошан зараз не голодний!"
"[english]dota_hud_error_cant_cast_on_roshan_not_hungry"	"Roshan isn't hungry right now!"
"dota_hud_error_cant_cast_on_roshan_wrong_team"	"Рошан вимагає цукерки або життя від іншої команди!"
"[english]dota_hud_error_cant_cast_on_roshan_wrong_team"	"Roshan is Trick or Treating the other team!"
"DOTA_Tooltip_modifier_diretide_roshan_curse_debuff"	"Прокляття Рошана"
"[english]DOTA_Tooltip_modifier_diretide_roshan_curse_debuff"	"Curse of Roshan"
"DOTA_Tooltip_modifier_diretide_roshan_curse_debuff_Description"	"Отримує періодичну шкоду, бо команда не нагодувала Рошана."
"[english]DOTA_Tooltip_modifier_diretide_roshan_curse_debuff_Description"	"Receiving damage over time due to a teamwide failure to feed Roshan."
"DOTA_Tooltip_Ability_hulk_rot"	"Decay"
"[english]DOTA_Tooltip_Ability_hulk_rot"	"Decay"
"DOTA_Tooltip_Ability_hulk_rot_Description"	"<b><font color='#F2A93E'>Загнивання</font></b>\nЩосекунди завдає %damage% шкоди ворогам у радіусі %radius%."
"[english]DOTA_Tooltip_Ability_hulk_rot_Description"	"Deals %damage% damage to enemies in a %radius% radius each second."
"DOTA_Tooltip_modifier_hulk_rot"	"Гноїння"
"[english]DOTA_Tooltip_modifier_hulk_rot"	"Rotting"
"DOTA_Tooltip_modifier_hulk_rot_Description"	"Щосекунди завдає шкоди ворогам поблизу."
"[english]DOTA_Tooltip_modifier_hulk_rot_Description"	"Dealing damage to nearby enemies every second."
"DOTA_Tooltip_Ability_item_spooky_tranquil_boots"	"Spooky Tranquil Boots"
"[english]DOTA_Tooltip_Ability_item_spooky_tranquil_boots"	"Spooky Tranquil Boots"
"DOTA_Tooltip_Ability_item_spooky_tranquil_boots_Description"	"Звичайні черевики рівноваги, от тільки МОТОРОШНІ.\nНазва українською: <b><font color='#F2A93E'>Моторошні черевики рівноваги</font></b>"
"[english]DOTA_Tooltip_Ability_item_spooky_tranquil_boots_Description"	"Just like regular tranquil boots only SPOOKY"
"DOTA_Tooltip_modifier_diretide_respawn_time_penalty"	"Штраф на час відродження"
"[english]DOTA_Tooltip_modifier_diretide_respawn_time_penalty"	"Respawn Time Penalty"
"DOTA_Tooltip_modifier_diretide_respawn_time_penalty_Description"	"Додає +%dMODIFIER_PROPERTY_TOOLTIP% с до вашого часу відродження через попередні смерті цього раунду."
"[english]DOTA_Tooltip_modifier_diretide_respawn_time_penalty_Description"	"Adding a +%dMODIFIER_PROPERTY_TOOLTIP% seconds to your respawn timer from previous deaths this round."
"DOTA_Tooltip_ability_diretide_bucket_soldier_regen_building_passive"	"Regeneration Aura"
"[english]DOTA_Tooltip_ability_diretide_bucket_soldier_regen_building_passive"	"Regeneration Aura"
"DOTA_Tooltip_ability_diretide_bucket_soldier_regen_building_passive_Description"	"<b><font color='#F2A93E'>Аура регенерації</font></b>\nОхоронці ірисок у радіусі дії лікуються на %regen_pct_per_second%% від максимального здоров’я, якщо не в бою. Якщо охоронець отримує шкоду, то регенерація вимикається на %peace_time% с."
"[english]DOTA_Tooltip_ability_diretide_bucket_soldier_regen_building_passive_Description"	"Taffy Guardians within range heal %regen_pct_per_second%% of Max Health per second when out of combat. If a Guardiant takes damage, the regen is disabled for %peace_time% seconds."
"DOTA_Tooltip_ability_diretide_bucket_soldier_regen_building_passive_Lore"	" "
"[english]DOTA_Tooltip_ability_diretide_bucket_soldier_regen_building_passive_Lore"	""
"DOTA_Tooltip_modifier_diretide_bucket_soldier_passive"	"Освячена регенерація"
"[english]DOTA_Tooltip_modifier_diretide_bucket_soldier_passive"	"Hallowed Regeneration"
"DOTA_Tooltip_modifier_diretide_bucket_soldier_passive_Description"	"Регенерує відсоток максимального здоров’я за секунду, коли не в бою. Вимикається на короткий період часу, якщо охоронець ірисок отримує шкоду."
"[english]DOTA_Tooltip_modifier_diretide_bucket_soldier_passive_Description"	"Regenerates a percentage of Max Health per second when out of combat. Disabled for a short duration if the Taffy Guardian takes damage."
}
}
