"dota"
{
"InfoScreenClose"	"Продолжить"
"[english]InfoScreenClose"	"Continue"
"EndScreenClose"	"Выйти"
"[english]EndScreenClose"	"Exit"
"basics_alert_TowerDamageTitle"	"Вас атакуют!"
"[english]basics_alert_TowerDamageTitle"	"Incoming Fire!"
"basics_alert_TowerDamageBody"	"Вражеские башни наносят значительный урон. Отступайте!"
"[english]basics_alert_TowerDamageBody"	"Enemy Towers deal a lot of damage. Retreat!"
"basics_alert_UseTangoTitle"	"Лечение"
"[english]basics_alert_UseTangoTitle"	"Healing"
"basics_alert_UseTangoBody"	"Используйте Tango, чтобы пополнить здоровье."
"[english]basics_alert_UseTangoBody"	"Try using a Tango to keep your health full."
"basics_alert_UseSalveTitle"	"Слишком много урона"
"[english]basics_alert_UseSalveTitle"	"Heavy Damage"
"basics_alert_UseSalveBody"	"Используйте Healing Salve, чтобы пополнить здоровье. Любой нанесенный вам урон прервет лечение."
"[english]basics_alert_UseSalveBody"	"Use a Salve to heal. Taking damage will cancel the healing effect."
"basics_alert_UseClarityTitle"	"Восстановите ману"
"[english]basics_alert_UseClarityTitle"	"Restore Mana"
"basics_alert_UseClarityBody"	"Используйте Clarity, чтобы пополнить ману. Любой нанесенный вам урон прервет восстановление."
"[english]basics_alert_UseClarityBody"	"Use a Clarity to restore mana. Taking damage will cancel the restoring effect."
"basics_alert_FirstDeathTitle"	"Цена смерти и возрождение"
"[english]basics_alert_FirstDeathTitle"	"Death: Costs & Respawning"
"basics_alert_FirstDeathBody"	"Погибнув, вы потеряете часть своего золота, а убившие вас герои получат опыт и станут сильнее.\n\nВы возродитесь у фонтана своей команды, когда время на счетчике под портретом вашего героя в самом верху экрана подойдет к концу."
"[english]basics_alert_FirstDeathBody"	"When you die, you will lose a portion of your gold, and the hero or heroes responsible for your death earn experience to become stronger.\n\nYou will respawn at your team's fountain when your death timer ends. You can see your death timer beneath your hero's portrait at the top of the screen."
"basics_alert_SecondDeathTitle"	"Отступайте, если вы в опасности"
"[english]basics_alert_SecondDeathTitle"	"Death: Retreat When in Danger"
"basics_alert_SecondDeathBody"	"Следите за тем, куда направляете героя. Если башня, противник или вражеский крип атакует вас, лучше отступите.\n\nЧем больше уровень героя, тем дольше он возрождается."
"[english]basics_alert_SecondDeathBody"	"Take care where you place your hero. If a Tower, hero, or enemy creep begins attacking you, consider retreating.\n\nEach level gained increases how long a hero remains dead."
"basics_alert_RespawnTitle"	"Скоро вы возродитесь"
"[english]basics_alert_RespawnTitle"	"Respawning Soon"
"basics_alert_RespawnBody"	"Скоро ваш герой возродится у фонтана своей команды.\n\nСкорее возвращайтесь в бой!"
"[english]basics_alert_RespawnBody"	"Your hero will respawn at your team's fountain in a moment.\n\nTry to get back into battle quickly!"
"basics_alert_TangoUsageTitle"	"Tango"
"[english]basics_alert_TangoUsageTitle"	"Using a Tango"
"basics_alert_TangoUsageBody"	"С помощью Tango вы можете съесть дерево, чтобы постепенно восстановить немного здоровья.\n\nВы уже активировали Tango, нажав по его иконке или на соответствующую клавишу. Теперь нажмите левой кнопкой мыши на дерево, чтобы использовать Tango."
"[english]basics_alert_TangoUsageBody"	"A Tango allows you to consume a tree to restore a small amount of health over time.\n\nYou have already activated the Tango, either by clicking on its icon, or pressing its key. Now, left-click on a tree to use a Tango."
"basics_alert_SalveUsageTitle"	"Healing Salve"
"[english]basics_alert_SalveUsageTitle"	"Using a Healing Salve"
"basics_alert_SalveUsageBody"	"Healing Salve быстро восстанавливает здоровье героя, выбранного левой кнопкой мыши.\n\nЛечение прервется при получении урона."
"[english]basics_alert_SalveUsageBody"	"Healing Salves can quickly heal the hero you target (left-click).\n\nTaking damage will cancel the healing effect."
"basics_alert_ClarityUsageTitle"	"Clarity"
"[english]basics_alert_ClarityUsageTitle"	"Using a Clarity"
"basics_alert_ClarityUsageBody"	"Clarity медленно восстанавливает ману выбранного героя.\n\nВосстановление прервется при получении урона."
"[english]basics_alert_ClarityUsageBody"	"The Clarity potion slowly regenerates mana on the hero you target.\n\nTaking damage will cancel the regenerating effect."
"basics_ExcessiveTowerDamageTitle"	"Башни опасные. Отступайте!"
"[english]basics_ExcessiveTowerDamageTitle"	"Towers are Dangerous. Retreat!"
"basics_ExcessiveTowerDamageBody"	"Ой-ой-ой! Башня нанесла вам много урона!\n\nОтступите и дождитесь, пока она не начнет атаковать кого-нибудь другого."
"[english]basics_ExcessiveTowerDamageBody"	"Ouch! You are taking a lot of damage from the Tower!\n\nBack up until the Tower begins to attack something else."
"basics_objective_CloseShopTitle"	"Закройте лавку (левая кнопка мыши)"
"[english]basics_objective_CloseShopTitle"	"Close the Shop (left-click)"
"basics_objective_CloseShopBody"	"Еще раз нажмите на кнопку лавки, чтобы закрыть ее."
"[english]basics_objective_CloseShopBody"	"Click the Shop button again to close the shop."
"basics_objective_BackToCombatTitle"	"Возвращайтесь на среднюю линию"
"[english]basics_objective_BackToCombatTitle"	"Return to the Middle Lane"
"basics_objective_BackToCombatBody"	"Обучение проходит на ней!"
"[english]basics_objective_BackToCombatBody"	"That's where the tutorial is!"
"basics_HeroIntroTitle"	"Команда и герой"
"[english]basics_HeroIntroTitle"	"Your Hero & Your Team"
"basics_HeroIntroBody"	"Добро пожаловать в Dota 2! Это руководство обучит вас основам игры.\n\nВы будете управлять Luna, быстрым героем, который атакует врагов с небольшого расстояния и призывает с неба разрушительные лучи. Вы сыграете за команду сил Света против сил Тьмы."
"[english]basics_HeroIntroBody"	"Welcome to Dota! In this tutorial, we will teach you the basics.\n\nYou will be controlling Luna, a swift hero who throws blades at her enemies from a short distance, and summons damaging beams from the sky. You will be playing for the Radiant team, against the enemy Dire team."
"basics_FountainIntroTitle"	"Фонтан: источник лечения"
"[english]basics_FountainIntroTitle"	"The Fountain: A Source of Healing"
"basics_FountainIntroBody"	"Для вашего героя каждая игра начинается на союзном фонтане. Если вы погибнете в бою, то также возродитесь здесь.\n\nНаходясь возле фонтана своей команды, ваш герой быстро восстанавливает здоровье и ману."
"[english]basics_FountainIntroBody"	"Your hero begins each match at your team's fountain. If you fall in battle, you will respawn here as well.\n\nBeing near your team's fountain will quickly restore your health and mana."
"basics_MovingYourHeroTitle"	"Управление героем и камерой"
"[english]basics_MovingYourHeroTitle"	"Basic Hero & Camera Controls"
"basics_MovingYourHeroBody"	"Приказы на передвижение в указанное место или атаку выбранного объекта отдаются нажатием правой кнопки мыши.\n\nКамеру можно двигать, подводя указатель мыши к краю экрана. В любой момент можно вернуть камеру к своему герою, нажав клавишу {g:dota_key:keyname}."
"[english]basics_MovingYourHeroBody"	"Movement and attack commands are issued by right-clicking where you would like them to go, or on what you would like them to attack.\n\nThe camera view can be moved by touching your mouse cursor to the edge of the screen. At any time, you may center the view on your hero by pressing {g:dota_key:keyname}."
"basics_objective_MoveToAncientTitle"	"Направляйтесь к Крепости"
"[english]basics_objective_MoveToAncientTitle"	"Move to your Ancient"
"basics_objective_MoveToAncientBody"	"Перемещайте героя правой кнопкой мыши."
"[english]basics_objective_MoveToAncientBody"	"Right-click to move your hero."
"basics_AncientIntroTitle"	"Защищайте Крепость любой ценой"
"[english]basics_AncientIntroTitle"	"Your Ancient: Defend It at All Costs"
"basics_AncientIntroBody"	"Это ваша Крепость — Крепость сил Света.\n\nЧтобы выиграть, ваша команда должна уничтожить вражескую Крепость, прежде чем противник разрушит вашу."
"[english]basics_AncientIntroBody"	"This is the Radiant team's Ancient, your Ancient.\n\nIn Dota, in order to win a match your team must destroy the enemy's Ancient before the enemy can destroy yours."
"basics_SpendGoldTitle"	"Всегда тратьте стартовое золото"
"[english]basics_SpendGoldTitle"	"Always Spend Your Starting Gold"
"basics_SpendGoldBody"	"В начале каждого матча игроки получают немного золота. Обязательно потратьте его в лавке, прежде чем идти в бой.\n\nЛавка находится позади, возле фонтана вашей команды. Направляйтесь туда."
"[english]basics_SpendGoldBody"	"At the start of every match, players are given a small amount of starting gold. Always remember spend this gold on items from the shop before heading into the field.\n\nThe shop is available back at your team's fountain. Head there now."
"basics_objective_MoveToShopTitle"	"Возвращайтесь к фонтану"
"[english]basics_objective_MoveToShopTitle"	"Return to the Fountain"
"basics_objective_MoveToShopBody"	"Направляйтесь обратно в лавку возле фонтана (ПКМ)."
"[english]basics_objective_MoveToShopBody"	"Move (right-click) back to the shop near the fountain."
"basics_objective_OpenShopTitle"	"Откройте лавку"
"[english]basics_objective_OpenShopTitle"	"Open the Shop"
"basics_objective_OpenShopBody"	"Чтобы открыть лавку, нажмите левой кнопкой мыши на кнопку ЛАВКА в нижнем углу."
"[english]basics_objective_OpenShopBody"	"Left-click the Shop button near the lower corner of your screen to open the shop."
"basics_BuyFromShopTitle"	"Снарядите героя в бой"
"[english]basics_BuyFromShopTitle"	"The Shop: Equipping your Hero for Victory"
"basics_BuyFromShopBody"	"Каждый предмет в Dota 2 имеет свое предназначение. Одни позволяют лечиться, другие пассивно увеличивают силу героя, а некоторые даже дают уникальные способности.\n\nПомните, что в лавке есть список рекомендуемых предметов для вашего героя. Если вы еще учитесь играть, советуем покупать предметы из этого списка."
"[english]basics_BuyFromShopBody"	"Items have several uses in Dota. Some heal, others passively increase a hero's power, and some even provide unique abilities.\n\nNotice that the Shop displays a list of Suggested Items for your hero. We recommend that you purchase items from this list as you learn Dota."
"basics_objective_BuyTangoesTitle"	"Купите Tango"
"[english]basics_objective_BuyTangoesTitle"	"Purchase Tango"
"basics_objective_BuyTangoesBody"	"В магазине нажмите правой кнопкой мыши на Tango, чтобы приобрести его."
"[english]basics_objective_BuyTangoesBody"	"Right-click the Tango item in the shop to purchase."
"basics_objective_BuySalveTitle"	"Купите Healing Salve"
"[english]basics_objective_BuySalveTitle"	"Purchase Healing Salve"
"basics_objective_BuySalveBody"	"В магазине нажмите правой кнопкой мыши на Healing Salve, чтобы приобрести его."
"[english]basics_objective_BuySalveBody"	"Right-click the Healing Salve in the shop to purchase."
"basics_objective_BuyClarityTitle"	"Купите Clarity"
"[english]basics_objective_BuyClarityTitle"	"Purchase Clarity"
"basics_objective_BuyClarityBody"	"В магазине нажмите правой кнопкой мыши на Clarity, чтобы приобрести его."
"[english]basics_objective_BuyClarityBody"	"Right-click the Clarity in the shop to purchase."
"basics_objective_BuyCircletTitle"	"Купите Circlet"
"[english]basics_objective_BuyCircletTitle"	"Purchase Circlet"
"basics_objective_BuyCircletBody"	"В магазине нажмите правой кнопкой мыши на Circlet, чтобы приобрести его."
"[english]basics_objective_BuyCircletBody"	"Right-click the Circlet in the shop to purchase."
"basics_objective_BuySlippersTitle"	"Купите Slippers of Agility"
"[english]basics_objective_BuySlippersTitle"	"Purchase Slippers of Agility"
"basics_objective_BuySlippersBody"	"В магазине нажмите правой кнопкой мыши на Slippers of Agility, чтобы приобрести его."
"[english]basics_objective_BuySlippersBody"	"Right-click the Slippers of Agility in the shop to purchase."
"basics_BoughtStartingTitle"	"Начальные предметы помогают выжить на поле боя"
"[english]basics_BoughtStartingTitle"	"Starting Items: Surviving in the Field"
"basics_BoughtStartingBody"	"Некоторые начальные предметы позволяют восстановить здоровье или ману:\n- Tango позволяет поглотить выбранное дерево и медленно вылечиться\n- Healing Salve постепенно восстанавливает большое количество здоровья\n- Clarity медленно восстанавливает большое количество маны\n\nПОМНИТЕ: эффекты Healing Salve и Clarity прервутся, если вам нанесут урон."
"[english]basics_BoughtStartingBody"	"Some of your Starting Items can be consumed to heal or restore mana:\n- Tango: Use this to swallow a tree and slowly heal\n- Healing Salve: Gradually heals a large amount of health\n- Clarity: Slowly restores a large amount of mana\n\nNOTE: Healing Salve and Clarity's effects are cancelled if you are damaged."
"basics_LaneIntroTitle"	"Линии — три направления атаки"
"[english]basics_LaneIntroTitle"	"Lanes: Three Paths of Attack"
"basics_LaneIntroBody"	"Поле боя пересекают три линии, соединяющие базы обеих команд, — верхняя, средняя и нижняя."
"[english]basics_LaneIntroBody"	"There are three lanes that cross the battlefield, connecting the bases of both teams. These lanes are called Top, Middle, and Bottom."
"basics_objective_MoveToMidLaneTitle"	"Направляйтесь на среднюю линию"
"[english]basics_objective_MoveToMidLaneTitle"	"Move to the Middle Lane"
"basics_objective_MoveToMidLaneBody"	"Направляйтесь на среднюю линию (ПКМ)"
"[english]basics_objective_MoveToMidLaneBody"	"Move (right-click) to the Middle lane"
"basics_CreepsIntroTitle"	"Крипы-пехотинцы"
"[english]basics_CreepsIntroTitle"	"Creeps: Foot Soldiers of War"
"basics_CreepsIntroBody"	"Пехотинцы вашей команды, которые называются крипами, появляются на всех линиях рядом с границей базы каждые 30 секунд.\n\nКрипы всегда идут в сторону вражеской базы и атакуют всех юнитов противника и его постройки на своем пути."
"[english]basics_CreepsIntroBody"	"Your team's foot soldiers, called creeps, will spawn in each lane near the edge of your base every 30 seconds.\n\nCreeps automatically march toward the enemy base, attacking any enemy units or buildings they encounter."
"basics_LaningIntroTitle"	"Битва начинается: следуйте за крипами"
"[english]basics_LaningIntroTitle"	"The Battle Begins: Follow Your Creeps"
"basics_LaningIntroBody"	"Сейчас появится волна крипов. Последуйте за ними и помогите им в бою.\n\nДавайте крипам принимать удары врага на себя. Когда все крипы умрут, вам следует отступить и перегруппироваться со следующей волной."
"[english]basics_LaningIntroBody"	"A wave of creeps is about to spawn. Follow them into combat.\n\nTry to position yourself so that the creeps receive any enemy attacks. When a wave of creeps dies, back up and regroup with the next creep wave."
"basics_objective_FollowCreepsTitle"	"Следуйте в битву за своими крипами"
"[english]basics_objective_FollowCreepsTitle"	"Follow your Creeps into battle"
"basics_objective_FollowCreepsBody"	"Направляйтесь на среднюю линию (ПКМ)."
"[english]basics_objective_FollowCreepsBody"	"Move (right-click) into the Middle Lane."
"basics_AttackingIntroTitle"	"Нападение: просто нажимайте правой кнопкой мыши на врага"
"[english]basics_AttackingIntroTitle"	"Attacking: Simply Right-Click an Enemy"
"basics_AttackingIntroBody"	"Чтобы атаковать врага, нажмите на него правой кнопкой мыши.\n\nПолучив приказ на атаку, ваш герой будет выполнять его, пока не получит другой приказ или пока враг не умрет."
"[english]basics_AttackingIntroBody"	"Attack enemy units by right-clicking on them.\n\nOnce you begin attacking an enemy, your hero will continue attacking until the enemy dies, or until you perform another action."
"basics_BountiesIntroTitle"	"Добивание: зарабатывайте золото быстро"
"[english]basics_BountiesIntroTitle"	"Last Hits: Earn Gold Quickly"
"basics_BountiesIntroBody"	"Нанеся врагу смертельный удар, вы получите золото. Это называется добиванием.\n\nДобейте вражеского юнита с малым количеством здоровья."
"[english]basics_BountiesIntroBody"	"Whenever you strike the killing blow on an enemy, you will earn an additional bounty of gold. This is called a Last Hit.\n\nAttack enemy units whose health is low to earn a Last Hit now."
"basics_objective_LastHitCreepsTitle"	"Заработайте золото"
"[english]basics_objective_LastHitCreepsTitle"	"Earn a Bounty"
"basics_objective_LastHitCreepsBody"	"Нанесите врагу смертельный удар (ПКМ)."
"[english]basics_objective_LastHitCreepsBody"	"Strike the Last Hit on an enemy (right-click)."
"basics_ExpIntroTitle"	"Получайте опыт от сражений неподалеку"
"[english]basics_ExpIntroTitle"	"Earning Experience from Nearby Battles"
"basics_ExpIntroBody"	"В отличие от золота, опыт делится между всеми союзниками неподалеку независимо от того, кто добил врага.\n\nПолучая опыт и повышая уровень, вы сможете изучать и усилять способности героя."
"[english]basics_ExpIntroBody"	"Unlike Last Hit bounties, experience points are shared between all nearby allied heroes whenever an enemy is slain.\n\nEarning experience points and gaining levels allows you to augment your hero's abilities."
"basics_objective_GetALevelTitle"	"Получите уровень"
"[english]basics_objective_GetALevelTitle"	"Gain a Level"
"basics_objective_GetALevelBody"	"Повысьте уровень героя, помогая убивать врагов."
"[english]basics_objective_GetALevelBody"	"Level up your hero by helping kill enemy units."
"basics_AbilityIntroTitle"	"Способности: особые умения вашего героя"
"[english]basics_AbilityIntroTitle"	"Abilities: Your Hero's Special Powers"
"basics_AbilityIntroBody"	"Получив уровень, ваш герой зарабатывает очко, которое можно потратить на изучение или улучшение одной из его способностей.\n\nУчтите, что ульт, особую способность героя, нельзя изучить до 6-го уровня.\n\nНажмите на золотую кнопку «+» над способностью Lucent Beam, чтобы изучить ее."
"[english]basics_AbilityIntroBody"	"Whenever a hero gains a level, they earn a point to spend toward learning, or strengthening, one of their abilities.\n\nNote that the Ultimate ability, which is a hero's signature power, cannot be learned until level 6.\n\nClick on the gold \"+\" button above Lucent Beam to learn that ability."
"basics_objective_LevelUpTitle"	"Новый уровень"
"[english]basics_objective_LevelUpTitle"	"Level Up"
"basics_objective_LevelUpBody"	"Нажмите на кнопку «+» над способностью Lucent Beam."
"[english]basics_objective_LevelUpBody"	"Left-click the \"+\" button above Lucent Beam."
"basics_objective_BuyAbilityTitle"	"Изучите способность"
"[english]basics_objective_BuyAbilityTitle"	"Learn an Ability"
"basics_objective_BuyAbilityBody"	"Нажмите на кнопку «+» над способностью Lucent Beam, чтобы изучить ее."
"[english]basics_objective_BuyAbilityBody"	"Left-click the \"+\" button above Lucent Beam to learn it."
"basics_HealYourselfTitle"	"Использование предметов"
"[english]basics_HealYourselfTitle"	"Using Items: Select the Item, then its Target"
"basics_HealYourselfBody"	"Вылечитесь с помощью Healing Salve. Сначала активируйте предмет, нажав на его иконку. Затем нажмите левой кнопкой мыши на своего героя. Также можно нажать на иконку Healing Salve дважды, чтобы сразу использовать предмет на себя. \n\nВНИМАНИЕ: действие Healing Salve прервется при получении урона!"
"[english]basics_HealYourselfBody"	"Try using a Healing Salve to heal yourself. First, activate the item by pressing the key above its icon. Then, left-click on your hero. You can also double-click the Healing Salve to immediately use it on yourself.\n\nNOTE: Healing Salve's effects will be cancelled if you are damaged!"
"basics_CastIntroTitle"	"Активные и пассивные способности"
"[english]basics_CastIntroTitle"	"Using Abilities: Activation and Passive Abilities"
"basics_CastIntroBody"	"Чтобы использовать способность, сначала нажмите клавишу, указанную над иконкой способности, а затем выберите цель левой кнопкой мыши. Для использования способностей обычно необходима мана.\n\nПассивные способности (например, Lunar Blessing у вашего героя) работают всегда и не требуют маны."
"[english]basics_CastIntroBody"	"To use an ability, first activate it by pressing the key shown above the ability's icon, then left-click on a target. Abilities which require activation cost mana to use.\n\nPassive abilities, such as Luna's Lunar Blessing, are automatic, always active, and do not require mana to function."
"basics_objective_CastSpellTitle"	"Используйте Lucent Beam"
"[english]basics_objective_CastSpellTitle"	"Use Lucent Beam"
"basics_objective_CastSpellBody"	"Нажмите на {g:dota_key:keyname}, чтобы активировать способность Lucent Beam, а затем нажмите левой кнопкой мыши на врага, чтобы применить ее."
"[english]basics_objective_CastSpellBody"	"Press {g:dota_key:keyname} to activate Lucent Beam, then left-click on an enemy to cast."
"basics_AttackTowerTitle"	"Отступайте, если вас атакует башня"
"[english]basics_AttackTowerTitle"	"Towers: Retreat if Attacked"
"basics_AttackTowerBody"	"У башни много здоровья, а ее атаки наносят большой урон. Обычно она выбирает целью ближайшего вражеского юнита и атакует его, пока тот не погибнет или не выйдет за пределы досягаемости.\n\nЕсли вашего героя атакует башня, следует отступить — иначе вы можете пострадать.\n\nЧтобы завершить обучение, разрушьте башню."
"[english]basics_AttackTowerBody"	"Towers have a lot of health and launch powerful blasts at enemies. Generally, they target the closest opposing unit, then continue attacking until that unit dies or leaves its range.\n\nIf a Tower begins attacking your hero, you should retreat before you take too much damage.\n\nDestroy the tower to complete the tutorial."
"basics_objective_KillTowerTitle"	"Уничтожьте вражескую башню"
"[english]basics_objective_KillTowerTitle"	"Destroy the Enemy Tower"
"basics_objective_KillTowerBody"	"Уничтожьте башню, чтобы завершить обучение."
"[english]basics_objective_KillTowerBody"	"Destroy the Tower to complete the tutorial."
"basics_RazorIntroTitle"	"Сражение с вражескими героями"
"[english]basics_RazorIntroTitle"	"Battling Enemy Heroes"
"basics_RazorIntroBody"	"В бой вступает новый герой!\n\nК силам Тьмы присоединился Razor, который будет защищать башню своими молниями.\n\nНанесите ему достаточно урона, и он отступит."
"[english]basics_RazorIntroBody"	"A new hero has entered the battle!\n\nRazor has joined the enemy Dire team, and will try to defend his team's tower with his lightning abilities.\n\nDamaging Razor can force him to retreat."
"basics_WinningIntroTitle"	"Победа!"
"[english]basics_WinningIntroTitle"	"Victory!"
"basics_WinningIntroBody"	"Отлично! Вы разрушили башню и завершили обучение механике игры.\n\nТеперь вы готовы к матчу с ботами, в котором вы шаг за шагом, вместе с союзниками и врагами под управлением компьютера, проведете полноценную игру в Dota. Удачи!"
"[english]basics_WinningIntroBody"	"Well done! You've destroyed the Tower and completed the Mechanics tutorial.\n\nYou are now ready for the Guided Bot Matches. Guided Bot Matches take you through a full match of Dota, step by step, with the help of computer-controlled allies and enemies. Good luck, and have fun!"
"basics_QuestSuccessTitle"	"Вы победили!"
"[english]basics_QuestSuccessTitle"	"You Win!"
"basics_QuestSuccessBody"	"Вы успешно завершили задание."
"[english]basics_QuestSuccessBody"	"You successfully completed the quest."
"basics_QuestFailureTitle"	"Вы проиграли!"
"[english]basics_QuestFailureTitle"	"You Lose!"
"basics_QuestFailureBody"	"У вас не получилось выполнить задание."
"[english]basics_QuestFailureBody"	"You failed to complete the quest."
}
