"lang"
{
"Language"	"brazilian"
"Tokens"
{
"addon_game_name"	"Ira dos Mo'rokai"
"[english]addon_game_name"	"Wrath of the Mo'rokai"
"DOTA_Tooltip_ability_item_bag_of_gold"	"Bolsa de Ouro"
"[english]DOTA_Tooltip_ability_item_bag_of_gold"	"Bag of Gold"
"DOTA_GameMode_15"	"Ira dos Mo'rokai"
"[english]DOTA_GameMode_15"	"Wrath of the Mo'rokai"
"DOTA_GameMode_19"	"Ira dos Mo'rokai"
"[english]DOTA_GameMode_19"	"Wrath of the Mo'rokai"
"npc_dota_creature_jungle_spirit"	"Mo'rokai"
"[english]npc_dota_creature_jungle_spirit"	"Mo'rokai"
"npc_dota_jungle_spirit_summon_1"	"Guerreiro Espiritual"
"[english]npc_dota_jungle_spirit_summon_1"	"Spirit Warrior"
"npc_dota_jungle_spirit_summon_2"	"Guardião Espiritual"
"[english]npc_dota_jungle_spirit_summon_2"	"Spirit Guardian"
"npc_battle_point_pinata"	"Tesouro raro"
"[english]npc_battle_point_pinata"	"Rare Treasure"
"DOTA_Tooltip_ability_item_spirit_gem"	"Essência"
"[english]DOTA_Tooltip_ability_item_spirit_gem"	"Essence"
"jungle_branch_cost"	"Espírito"
"[english]jungle_branch_cost"	"Spirit"
"storm_branch_cost"	"Tempestade"
"[english]storm_branch_cost"	"Storm"
"volcano_branch_cost"	"Ira"
"[english]volcano_branch_cost"	"Wrath"
"spirit_branch"	"Espírito"
"[english]spirit_branch"	"Spirit"
"wrath_branch"	"Ira"
"[english]wrath_branch"	"Wrath"
"storm_branch"	"Tempestade"
"[english]storm_branch"	"Storm"
"JungleSpirits_NewMarchRadiant"	"<panel class='MorokaiIcon'/><font color='#27E100'>Mo'rokai dos Iluminados</font> está correndo para a {s:locstring_value}!"
"[english]JungleSpirits_NewMarchRadiant"	"<panel class='MorokaiIcon'/><font color='#27E100'>Radiant Mo'rokai</font> is charging down {s:locstring_value} lane!"
"GameEvent_PlayerOpenedLargeCarePackage"	"{s:player_name} abriu um tesouro <font color='#FF55FF'>raro</font>!"
"[english]GameEvent_PlayerOpenedLargeCarePackage"	"{s:player_name} opened a <font color='#FF55FF'>rare</font> treasure!"
"DOTA_Tooltip_Ability_item_travel_boots_morokai"	"Botas Estilosas de Mo'rokai"
"[english]DOTA_Tooltip_Ability_item_travel_boots_morokai"	"Stylish Mo'rokai Boots"
"DOTA_Tooltip_Ability_item_platemail_morokai"	"Armadura Moderna de Mo'rokai"
"[english]DOTA_Tooltip_Ability_item_platemail_morokai"	"Trendy Mo'rokai Armor"
"DOTA_Tooltip_Ability_item_battle_points"	"125 pontos de batalha"
"[english]DOTA_Tooltip_Ability_item_battle_points"	"125 Battle Points"
"DOTA_Tooltip_Ability_item_battle_points_250"	"250 pontos de batalha"
"[english]DOTA_Tooltip_Ability_item_battle_points_250"	"250 Battle Points"
"DOTA_Tooltip_Ability_item_battle_points_500"	"500 pontos de batalha"
"[english]DOTA_Tooltip_Ability_item_battle_points_500"	"500 Battle Points"
"DOTA_Tooltip_Ability_item_battle_points_2000"	"2.000 pontos de batalha"
"[english]DOTA_Tooltip_Ability_item_battle_points_2000"	"2000 Battle Points"
"DOTA_Tooltip_Ability_item_battle_points_5000"	"5.000 pontos de batalha"
"[english]DOTA_Tooltip_Ability_item_battle_points_5000"	"5000 Battle Points"
"DOTA_Tooltip_modifier_spirit_gem"	"Essência"
"[english]DOTA_Tooltip_modifier_spirit_gem"	"Essence"
"DOTA_Tooltip_modifier_spirit_gem_Description"	"Essência coletada pela unidade. O dano causado aumenta de acordo com a quantidade de essência coletada."
"[english]DOTA_Tooltip_modifier_spirit_gem_Description"	"This unit's collected essence. Provides increased outgoing damage when holding large amounts."
"DOTA_Tooltip_ability_jungle_spirit_summon_creeps"	"Guerreiros Espirituais"
"[english]DOTA_Tooltip_ability_jungle_spirit_summon_creeps"	"Spirit Warriors"
"DOTA_Tooltip_ability_jungle_spirit_summon_creeps_Description"	"Dispara um projétil no alvo, causando dano e invocando Guerreiros Espirituais ao seu redor."
"[english]DOTA_Tooltip_ability_jungle_spirit_summon_creeps_Description"	"Launches a projectile at the target, damaging it and summoning Spirit Warriors around it."
"DOTA_Tooltip_ability_jungle_spirit_summon_creeps_treant_level"	"NÍVEL DO GUERREIRO ESPIRITUAL:"
"[english]DOTA_Tooltip_ability_jungle_spirit_summon_creeps_treant_level"	"SPIRIT WARRIOR LEVEL:"
"DOTA_Tooltip_ability_jungle_spirit_summon_creeps_projectile_damage"	"DANO DO PROJÉTIL:"
"[english]DOTA_Tooltip_ability_jungle_spirit_summon_creeps_projectile_damage"	"PROJECTILE DAMAGE:"
"DOTA_Tooltip_ability_special_bonus_unique_morokai_treant_level"	"Guerreiros Espirituais mais fortes"
"[english]DOTA_Tooltip_ability_special_bonus_unique_morokai_treant_level"	"Stronger Spirit Warriors"
"DOTA_Tooltip_ability_morokai_jungle_heal_beam"	"Conjuração Selvagem"
"[english]DOTA_Tooltip_ability_morokai_jungle_heal_beam"	"Wild Conjuration"
"DOTA_Tooltip_ability_morokai_jungle_heal_beam_Description"	"O Mo'rokai cria feixes rotativos que transformam árvores em Guerreiros Espirituais aliados."
"[english]DOTA_Tooltip_ability_morokai_jungle_heal_beam_Description"	"The Mo'rokai creates rotating beams that transform trees into allied Spirit Warriors."
"DOTA_Tooltip_ability_morokai_jungle_heal_beam_beam_duration"	"DURAÇÃO:"
"[english]DOTA_Tooltip_ability_morokai_jungle_heal_beam_beam_duration"	"DURATION:"
"DOTA_Tooltip_ability_morokai_jungle_heal_beam_beam_count"	"RAIOS:"
"[english]DOTA_Tooltip_ability_morokai_jungle_heal_beam_beam_count"	"BEAMS:"
"DOTA_Tooltip_ability_morokai_jungle_heal_beam_beam_range"	"ALCANCE:"
"[english]DOTA_Tooltip_ability_morokai_jungle_heal_beam_beam_range"	"RANGE:"
"DOTA_Tooltip_ability_morokai_jungle_heal_beam_hp_per_second"	"CURA POR SEGUNDO:"
"[english]DOTA_Tooltip_ability_morokai_jungle_heal_beam_hp_per_second"	"HEAL PER SECOND:"
"DOTA_Tooltip_ability_special_bonus_unique_morokai_jungle_heal_beam_beam_heal"	"Cura adicional para a Conjuração Selvagem"
"[english]DOTA_Tooltip_ability_special_bonus_unique_morokai_jungle_heal_beam_beam_heal"	"Wild Conjuration Bonus Healing"
"DOTA_Tooltip_ability_special_bonus_unique_morokai_jungle_heal_beam_beam_heal_Description"	"Os feixes da Conjuração Selvagem do Mo'rokai ganham +20 de cura por segundo"
"[english]DOTA_Tooltip_ability_special_bonus_unique_morokai_jungle_heal_beam_beam_heal_Description"	"The Mo'rokai's Wild Conuration Beams gain +20 Heal per Second"
"DOTA_Tooltip_ability_special_bonus_unique_morokai_jungle_heal_beam_third_beam"	"Feixes adicionais para a Conjuração Selvagem"
"[english]DOTA_Tooltip_ability_special_bonus_unique_morokai_jungle_heal_beam_third_beam"	"Wild Conjuration Extra Beams"
"DOTA_Tooltip_ability_special_bonus_unique_morokai_jungle_heal_beam_third_beam_Description"	"A Conjuração Selvagem do Mo'rokai ganha dois feixes de cura adicionais"
"[english]DOTA_Tooltip_ability_special_bonus_unique_morokai_jungle_heal_beam_third_beam_Description"	"The Mo'rokai's Wild Conuration Gains 2 additional Heal Beams"
"DOTA_Tooltip_ability_jungle_spirit_river_rejuvenation"	"Chuva Rejuvenescente"
"[english]DOTA_Tooltip_ability_jungle_spirit_river_rejuvenation"	"Rainwater Rejuvenation"
"DOTA_Tooltip_ability_jungle_spirit_river_rejuvenation_Description"	"Fornece vida e mana a heróis que estiverem no rio ou perto de um dos seus santuários."
"[english]DOTA_Tooltip_ability_jungle_spirit_river_rejuvenation_Description"	"Grants heroes health and mana when they are in the river or near one of their shrines."
"DOTA_Tooltip_ability_jungle_spirit_river_rejuvenation_health_restore"	"VIDA POR SEGUNDO:"
"[english]DOTA_Tooltip_ability_jungle_spirit_river_rejuvenation_health_restore"	"HEALTH PER SECOND:"
"DOTA_Tooltip_ability_jungle_spirit_river_rejuvenation_mana_restore"	"MANA POR SEGUNDO:"
"[english]DOTA_Tooltip_ability_jungle_spirit_river_rejuvenation_mana_restore"	"MANA PER SECOND:"
"DOTA_Tooltip_modifier_jungle_spirit_river_rejuvenation_regen"	"Chuva Rejuvenescente"
"[english]DOTA_Tooltip_modifier_jungle_spirit_river_rejuvenation_regen"	"Rainwater Rejuvenation"
"DOTA_Tooltip_modifier_jungle_spirit_river_rejuvenation_regen_health_restore"	"REGENERAÇÃO DE VIDA:"
"[english]DOTA_Tooltip_modifier_jungle_spirit_river_rejuvenation_regen_health_restore"	"HEALTH REGEN:"
"DOTA_Tooltip_modifier_jungle_spirit_river_rejuvenation_regen_mana_restore"	"REGENERAÇÃO DE MANA:"
"[english]DOTA_Tooltip_modifier_jungle_spirit_river_rejuvenation_regen_mana_restore"	"MANA REGEN:"
"DOTA_Tooltip_ability_item_bag_of_gold_caster_only"	"Bolsa de Ouro"
"[english]DOTA_Tooltip_ability_item_bag_of_gold_caster_only"	"Bag of Gold"
"DOTA_Tooltip_ability_junglespirit_volcano_eruption"	"Erupção"
"[english]DOTA_Tooltip_ability_junglespirit_volcano_eruption"	"Eruption"
"DOTA_Tooltip_ability_junglespirit_volcano_eruption_split_radius"	"ÁREA DE EFEITO DA EXPLOSÃO:"
"[english]DOTA_Tooltip_ability_junglespirit_volcano_eruption_split_radius"	"EXPLOSION AOE:"
"DOTA_Tooltip_ability_junglespirit_volcano_eruption_flight_time"	"ATRASO:"
"[english]DOTA_Tooltip_ability_junglespirit_volcano_eruption_flight_time"	"DELAY:"
"DOTA_Tooltip_ability_junglespirit_volcano_eruption_damage"	"DANO:"
"[english]DOTA_Tooltip_ability_junglespirit_volcano_eruption_damage"	"DAMAGE:"
"DOTA_Tooltip_ability_special_bonus_unique_jungle_spirit_volcano_multitarget"	"Erupção multialvo"
"[english]DOTA_Tooltip_ability_special_bonus_unique_jungle_spirit_volcano_multitarget"	"Eruption Multitarget"
"DOTA_Tooltip_ability_special_bonus_unique_jungle_spirit_volcano_multitarget_Description"	"A Erupção do Mo'rokai alveja um inimigo adicional a casa uso."
"[english]DOTA_Tooltip_ability_special_bonus_unique_jungle_spirit_volcano_multitarget_Description"	"The Mo'rokai's Eruption targets an additional enemy with each cast."
"DOTA_Tooltip_ability_special_bonus_unique_jungle_spirit_volcano_damage_bonus"	"Dano adicional para a Erupção"
"[english]DOTA_Tooltip_ability_special_bonus_unique_jungle_spirit_volcano_damage_bonus"	"Eruption Bonus Damage"
"DOTA_Tooltip_ability_special_bonus_unique_jungle_spirit_volcano_damage_bonus_Description"	"A Erupção do Mo'rokai causa mais 500 de dano."
"[english]DOTA_Tooltip_ability_special_bonus_unique_jungle_spirit_volcano_damage_bonus_Description"	"The Mo'rokai's Eruption gains 500 bonus damage."
"DOTA_Tooltip_ability_special_bonus_unique_jungle_spirit_volcano_splinter"	"Erupção Dividida"
"[english]DOTA_Tooltip_ability_special_bonus_unique_jungle_spirit_volcano_splinter"	"Eruption Splinter"
"DOTA_Tooltip_ability_special_bonus_unique_jungle_spirit_volcano_splinter_Description"	"A Erupção do Mo'rokai se divide em 6 pedra adicionais ao redor do alvo."
"[english]DOTA_Tooltip_ability_special_bonus_unique_jungle_spirit_volcano_splinter_Description"	"The Mo'rokai's Eruption splits into 6 additional stones around the target."
"DOTA_Tooltip_ability_jungle_spirit_storm_cyclone"	"Ciclone"
"[english]DOTA_Tooltip_ability_jungle_spirit_storm_cyclone"	"Cyclone"
"DOTA_Tooltip_ability_jungle_spirit_storm_cyclone_projectile_distance"	"DISTÂNCIA DE USO:"
"[english]DOTA_Tooltip_ability_jungle_spirit_storm_cyclone_projectile_distance"	"CAST DISTANCE:"
"DOTA_Tooltip_ability_jungle_spirit_storm_cyclone_projectile_amount"	"CICLONES:"
"[english]DOTA_Tooltip_ability_jungle_spirit_storm_cyclone_projectile_amount"	"CYCLONES:"
"DOTA_Tooltip_ability_jungle_spirit_storm_cyclone_debuff_duration"	"DURAÇÃO DO ATORDOAMENTO:"
"[english]DOTA_Tooltip_ability_jungle_spirit_storm_cyclone_debuff_duration"	"STUN DURATION:"
"DOTA_Tooltip_ability_jungle_spirit_storm_cyclone_cyclone_damage"	"DANO:"
"[english]DOTA_Tooltip_ability_jungle_spirit_storm_cyclone_cyclone_damage"	"DAMAGE"
"DOTA_Tooltip_ability_special_bonus_unique_jungle_spirit_storm_cyclone_damage"	"Dano adicional para o Ciclone"
"[english]DOTA_Tooltip_ability_special_bonus_unique_jungle_spirit_storm_cyclone_damage"	"Cyclone Bonus Damage"
"DOTA_Tooltip_ability_special_bonus_unique_jungle_spirit_storm_cyclone_damage_Description"	"O Ciclone do Mo'rokai causa +50 de dano por segundo."
"[english]DOTA_Tooltip_ability_special_bonus_unique_jungle_spirit_storm_cyclone_damage_Description"	"The Mo'rokai's Cyclones deal +50 damage per second."
"DOTA_Tooltip_ability_special_bonus_unique_jungle_spirit_storm_cyclone_debuff_duration"	"Duração do efeito negativo do Ciclone"
"[english]DOTA_Tooltip_ability_special_bonus_unique_jungle_spirit_storm_cyclone_debuff_duration"	"Cyclone Debuff Duration"
"DOTA_Tooltip_ability_special_bonus_unique_jungle_spirit_storm_cyclone_debuff_duration_Description"	"O Ciclone do Mo'rokai atordoa por mais 2 segundos."
"[english]DOTA_Tooltip_ability_special_bonus_unique_jungle_spirit_storm_cyclone_debuff_duration_Description"	"The Mo'rokai's Cyclones gain 2 seconds of stun on impact."
"DOTA_Tooltip_ability_special_bonus_unique_jungle_spirit_storm_cyclone_projectiles"	"Ciclones adicionais"
"[english]DOTA_Tooltip_ability_special_bonus_unique_jungle_spirit_storm_cyclone_projectiles"	"Cyclone Extra Cyclones."
"DOTA_Tooltip_ability_special_bonus_unique_jungle_spirit_storm_cyclone_projectiles_Description"	"O Ciclone do Mo'rokai cria 6 ciclones adicionais."
"[english]DOTA_Tooltip_ability_special_bonus_unique_jungle_spirit_storm_cyclone_projectiles_Description"	"The Mo'rokai's Cyclones +6 cyclones created."
"DOTA_Tooltip_ability_jungle_spirit_volcano_damage_block"	"Escudo de Obsidiana"
"[english]DOTA_Tooltip_ability_jungle_spirit_volcano_damage_block"	"Obsidian Shield"
"DOTA_Tooltip_ability_jungle_spirit_volcano_damage_block_block_chance"	"CHANCE DE BLOQUEIO:"
"[english]DOTA_Tooltip_ability_jungle_spirit_volcano_damage_block_block_chance"	"BLOCK CHANCE:"
"DOTA_Tooltip_ability_jungle_spirit_volcano_damage_block_damage_reduction"	"REDUÇÃO DE DANO:"
"[english]DOTA_Tooltip_ability_jungle_spirit_volcano_damage_block_damage_reduction"	"DAMAGE REDUCTION:"
"DOTA_Tooltip_modifier_jungle_spirit_volcano_damage_block"	"Escudo de Obsidiana"
"[english]DOTA_Tooltip_modifier_jungle_spirit_volcano_damage_block"	"Obsidian Shield"
"DOTA_Tooltip_modifier_jungle_spirit_volcano_damage_block_block_chance"	"CHANCE DE BLOQUEIO:"
"[english]DOTA_Tooltip_modifier_jungle_spirit_volcano_damage_block_block_chance"	"BLOCK CHANCE:"
"DOTA_Tooltip_modifier_jungle_spirit_volcano_damage_block_damage_reduction"	"REDUÇÃO DE DANO:"
"[english]DOTA_Tooltip_modifier_jungle_spirit_volcano_damage_block_damage_reduction"	"DAMAGE REDUCTION:"
"DOTA_Tooltip_ability_jungle_spirit_storm_multicast_multicast_chance"	"CHANCE DE MULTILANÇAMENTO:"
"[english]DOTA_Tooltip_ability_jungle_spirit_storm_multicast_multicast_chance"	"MULTICAST CHANCE:"
"DOTA_Tooltip_modifier_jungle_spirit_storm_multicast_multicast_chance"	"CHANCE DE MULTILANÇAMENTO:"
"[english]DOTA_Tooltip_modifier_jungle_spirit_storm_multicast_multicast_chance"	"MULTICAST CHANCE:"
"DOTA_Tooltip_ability_jungle_spirit_jungle_building_regeneration"	"Estruturas Vivas"
"[english]DOTA_Tooltip_ability_jungle_spirit_jungle_building_regeneration"	"Living Structures"
"DOTA_Tooltip_ability_jungle_spirit_jungle_building_regeneration_regeneration"	"REGENERAÇÃO:"
"[english]DOTA_Tooltip_ability_jungle_spirit_jungle_building_regeneration_regeneration"	"REGENERATION:"
"DOTA_Tooltip_modifier_jungle_spirit_jungle_building_regeneration"	"Estruturas Vivas"
"[english]DOTA_Tooltip_modifier_jungle_spirit_jungle_building_regeneration"	"Living Structures"
"DOTA_Tooltip_modifier_jungle_spirit_jungle_building_regeneration_regeneration"	"REGENERAÇÃO:"
"[english]DOTA_Tooltip_modifier_jungle_spirit_jungle_building_regeneration_regeneration"	"REGENERATION:"
"DOTA_Tooltip_ability_jungle_spirit_jungle_lumber_lock"	"Árvores Traiçoeiras"
"[english]DOTA_Tooltip_ability_jungle_spirit_jungle_lumber_lock"	"Treacherous Trees"
"DOTA_Tooltip_ability_jungle_spirit_jungle_lumber_lock_Description"	"Fornece uma chance de criar uma fileira de árvores atrás de um inimigo ao atacar."
"[english]DOTA_Tooltip_ability_jungle_spirit_jungle_lumber_lock_Description"	"Provides a chance to create a row of trees behind an enemy on each attack."
"DOTA_Tooltip_ability_jungle_spirit_jungle_lumber_lock_sprout_chance"	"CHANCE:"
"[english]DOTA_Tooltip_ability_jungle_spirit_jungle_lumber_lock_sprout_chance"	"CHANCE:"
"DOTA_Tooltip_ability_jungle_spirit_jungle_lumber_lock_duration"	"DURAÇÃO:"
"[english]DOTA_Tooltip_ability_jungle_spirit_jungle_lumber_lock_duration"	"DURATION:"
"DOTA_Tooltip_modifier_jungle_spirit_jungle_lumber_lock"	"Árvores Traiçoeiras"
"[english]DOTA_Tooltip_modifier_jungle_spirit_jungle_lumber_lock"	"Treacherous Trees"
"DOTA_Tooltip_modifier_jungle_spirit_jungle_lumber_lock_Description"	"Fornece uma chance de criar uma fileira de árvores atrás de um inimigo ao atacar."
"[english]DOTA_Tooltip_modifier_jungle_spirit_jungle_lumber_lock_Description"	"Provides a chance to create a row of trees behind an enemy on each attack."
"DOTA_Tooltip_modifier_jungle_spirit_jungle_lumber_lock_sprout_chance"	"CHANCE:"
"[english]DOTA_Tooltip_modifier_jungle_spirit_jungle_lumber_lock_sprout_chance"	"CHANCE:"
"DOTA_Tooltip_modifier_jungle_spirit_jungle_lumber_lock_duration"	"DURAÇÃO:"
"[english]DOTA_Tooltip_modifier_jungle_spirit_jungle_lumber_lock_duration"	"DURATION:"
"DOTA_Tooltip_ability_jungle_spirit_volcano_fire_strike_strike_chance"	"CHANCE DE ATAQUE:"
"[english]DOTA_Tooltip_ability_jungle_spirit_volcano_fire_strike_strike_chance"	"ATTACK CHANCE:"
"DOTA_Tooltip_ability_jungle_spirit_volcano_fire_strike_radius"	"RAIO:"
"[english]DOTA_Tooltip_ability_jungle_spirit_volcano_fire_strike_radius"	"RADIUS:"
"DOTA_Tooltip_modifier_jungle_spirit_volcano_fire_strike_strike_chance"	"CHANCE DE ATAQUE:"
"[english]DOTA_Tooltip_modifier_jungle_spirit_volcano_fire_strike_strike_chance"	"ATTACK CHANCE:"
"DOTA_Tooltip_modifier_jungle_spirit_volcano_fire_strike_radius"	"RAIO:"
"[english]DOTA_Tooltip_modifier_jungle_spirit_volcano_fire_strike_radius"	"RADIUS:"
"DOTA_Tooltip_Ability_jungle_spirit_melee_smash"	"Corpo a corpo"
"[english]DOTA_Tooltip_Ability_jungle_spirit_melee_smash"	"Melee Attack"
"DOTA_Tooltip_Ability_jungle_spirit_melee_smash_impact_radius"	"RAIO:"
"[english]DOTA_Tooltip_Ability_jungle_spirit_melee_smash_impact_radius"	"RADIUS:"
"DOTA_Tooltip_Ability_jungle_spirit_melee_smash_impact_stun_duration"	"DURAÇÃO DO ATORDOAMENTO:"
"[english]DOTA_Tooltip_Ability_jungle_spirit_melee_smash_impact_stun_duration"	"STUN DURATION:"
"DOTA_Tooltip_Ability_jungle_spirit_range_attack"	"Longo alcance"
"[english]DOTA_Tooltip_Ability_jungle_spirit_range_attack"	"Range Attack"
"DOTA_Tooltip_Ability_special_bonus_unique_jungle_spirit_melee_stun_duration"	"Atordoamento para ataques corpo a corpo do Mo'rokai"
"[english]DOTA_Tooltip_Ability_special_bonus_unique_jungle_spirit_melee_stun_duration"	"Mo'rokai Melee Attack Stun Duration"
"DOTA_Tooltip_Ability_special_bonus_unique_jungle_spirit_melee_stun_duration_Description"	"Ataques corpo a corpo do Mo'rokai atordoam por 1 segundo."
"[english]DOTA_Tooltip_Ability_special_bonus_unique_jungle_spirit_melee_stun_duration_Description"	"The Mo'rokai's Melee Attacks gain 1 second stun duration."
"DOTA_Tooltip_Ability_special_bonus_unique_morokai_jungle_heal_beam_treant_level"	"Guerreiros Espirituais mais fortes para o Mo'rokai"
"[english]DOTA_Tooltip_Ability_special_bonus_unique_morokai_jungle_heal_beam_treant_level"	"Mo'rokai Stronger Spirit Warriors"
"DOTA_Tooltip_Ability_special_bonus_unique_morokai_jungle_heal_beam_treant_level_Description"	"A Conjuração Selvagem do Mo'rokai invoca Guardiões Espirituais."
"[english]DOTA_Tooltip_Ability_special_bonus_unique_morokai_jungle_heal_beam_treant_level_Description"	"The Mo'rokai's Wild Conjuration summons Spirit Guardians."
"DOTA_Tooltip_Ability_special_bonus_unique_jungle_spirit_bonus_health"	"Vida para o Mo'rokai"
"[english]DOTA_Tooltip_Ability_special_bonus_unique_jungle_spirit_bonus_health"	"Mo'rokai Health"
"DOTA_Tooltip_Ability_special_bonus_unique_jungle_spirit_bonus_health_Description"	"O Mo'rokai recebe 800 de vida."
"[english]DOTA_Tooltip_Ability_special_bonus_unique_jungle_spirit_bonus_health_Description"	"The Mo'rokai gains 800 Health."
"DOTA_Tooltip_Ability_special_bonus_unique_jungle_spirit_cooldown_reduction"	"Redução de intervalo entre usos para o Mo'rokai"
"[english]DOTA_Tooltip_Ability_special_bonus_unique_jungle_spirit_cooldown_reduction"	"Mo'rokai Cooldown Reduction"
"DOTA_Tooltip_Ability_special_bonus_unique_jungle_spirit_cooldown_reduction_Description"	"O Mo'rokai recebe 15% de redução de intervalo entre usos para os seus ataques e habilidades."
"[english]DOTA_Tooltip_Ability_special_bonus_unique_jungle_spirit_cooldown_reduction_Description"	"The Mo'rokai has 15% cooldown reduction on its attacks and spells."
"DOTA_Tooltip_Ability_special_bonus_unique_jungle_spirit_magic_resistance"	"Resistência mágica para o Mo'rokai"
"[english]DOTA_Tooltip_Ability_special_bonus_unique_jungle_spirit_magic_resistance"	"Mo'rokai Magic Resistance"
"DOTA_Tooltip_Ability_special_bonus_unique_jungle_spirit_magic_resistance_Description"	"O Mo'rokai sofre 15% a menos de dano de ataques mágicos."
"[english]DOTA_Tooltip_Ability_special_bonus_unique_jungle_spirit_magic_resistance_Description"	"The Mo'rokai takes 15% less damage from Magic attacks."
"DOTA_Tooltip_Ability_special_bonus_unique_jungle_spirit_spell_amplify"	"Amplificação arcana para o Mo'rokai"
"[english]DOTA_Tooltip_Ability_special_bonus_unique_jungle_spirit_spell_amplify"	"Mo'rokai Spell Amplification"
"DOTA_Tooltip_Ability_special_bonus_unique_jungle_spirit_spell_amplify_Description"	"As habilidades do Mo'rokai causam mais 20% de dano."
"[english]DOTA_Tooltip_Ability_special_bonus_unique_jungle_spirit_spell_amplify_Description"	"The Mo'rokai's abilities deal 20% more damage."
"DOTA_Tooltip_Ability_special_bonus_unique_jungle_spirit_attack_damage"	"Dano para o Mo'rokai"
"[english]DOTA_Tooltip_Ability_special_bonus_unique_jungle_spirit_attack_damage"	"Mo'rokai Damage"
"DOTA_Tooltip_Ability_special_bonus_unique_jungle_spirit_attack_damage_Description"	"Os ataques corpo a corpo e de longo alcance do Mo'rokai causam +40 de dano."
"[english]DOTA_Tooltip_Ability_special_bonus_unique_jungle_spirit_attack_damage_Description"	"The Mo'rokai's Melee and Range attacks deal +40 damage."
"DOTA_Tooltip_Ability_special_bonus_unique_jungle_spirit_health_regen"	"Regen. de vida para o Mo'rokai"
"[english]DOTA_Tooltip_Ability_special_bonus_unique_jungle_spirit_health_regen"	"Mo'rokai Health Regen"
"DOTA_Tooltip_Ability_special_bonus_unique_jungle_spirit_health_regen_Description"	"O Mo'rokai regenera 12 de vida por segundo."
"[english]DOTA_Tooltip_Ability_special_bonus_unique_jungle_spirit_health_regen_Description"	"The Mo'rokai regenerates 12 health per second."
"DOTA_Tooltip_Ability_special_bonus_unique_jungle_spirit_bonus_armor"	"Armadura para o Mo'rokai"
"[english]DOTA_Tooltip_Ability_special_bonus_unique_jungle_spirit_bonus_armor"	"Mo'rokai Armor"
"DOTA_Tooltip_Ability_special_bonus_unique_jungle_spirit_bonus_armor_Description"	"O Mo'rokai ganha 20 de armadura."
"[english]DOTA_Tooltip_Ability_special_bonus_unique_jungle_spirit_bonus_armor_Description"	"The Mo'rokai gains 20 armor."
"jungle_spirits_game_info_brief_description"	"Os guardiões ancestrais ressurgem, mas precisam de tributos para recuperar as forças. Colete essência e use-a para controlar o fortalecimento do seu Mo'rokai."
"[english]jungle_spirits_game_info_brief_description"	"The ancient guardians rise, but they require tribute to regain strength. Collect essence and use it to guide your Mo'rokai's growth."
"jungle_game_info_desc_group_2"	"Reúna essência o suficiente para oferecer tributos ao seu Mo'rokai. Aprimore os caminhos de habilidades arcanas para ajudar na sua estratégia."
"[english]jungle_game_info_desc_group_2"	"Gather enough essence to offer tribute to your Mo'rokai. Level up the Mo'rokai's arcane ability paths to aid your strategy."
"jungle_game_info_ok"	"Ok"
"[english]jungle_game_info_ok"	"Ok"
"top_lane"	"trilha de cima"
"[english]top_lane"	"top"
"middle_lane"	"trilha do meio"
"[english]middle_lane"	"middle"
"bottom_lane"	"trilha de baixo"
"[english]bottom_lane"	"bottom"
}
}
