"dota"
{
"TitleText"	"{s:TitleTextVar}"
"[english]TitleText"	"{s:TitleTextVar}"
"BodyText"	"{s:BodyTextVar}"
"[english]BodyText"	"{s:BodyTextVar}"
"ProgressText"	"{s:ProgressTextVar}"
"[english]ProgressText"	"{s:ProgressTextVar}"
"EndScreenClose"	"ΕΞΟΔΟΣ"
"[english]EndScreenClose"	"EXIT"
"InfoScreenClose"	"ΣΥΝΕΧΕΙΑ"
"[english]InfoScreenClose"	"CONTINUE"
"ag_alert_InvulnerabilityTitle"	"Μάχη σε παύση"
"[english]ag_alert_InvulnerabilityTitle"	"Combat Paused"
"ag_info_PreGamePrepTitle"	"Σχεδιασμός: Το κλειδί για τη νίκη"
"[english]ag_info_PreGamePrepTitle"	"Planning: The Key to Victory"
"ag_info_PreGamePrepBody"	"Στο Dota, ο σχεδιασμός είναι το ίδιο σημαντικός με την ικανότητα. Οι καλύτερες ομάδες επιλέγουν ήρωες που αλληλοσυμπληρώνονται, αλληλοϋποστήριζονται όταν βρίσκονται υπό επίθεση και προσπαθούν ομαδικά να επιτυγχάνουν τους αντικειμενικούς στόχους. Αυτά είναι μερικά πράγματα που θα μάθετε με τον καιρό. Για την ώρα, θα εστιαστούμε στο να τα καταφέρνετε καλά σε έναν μόνο ρόλο."
"[english]ag_info_PreGamePrepBody"	"In Dota, planning is just as important as skill. The best teams choose heroes which complement each other, support each other when under attack, and try to take objectives together. These are things you will learn with time. For now, we'll focus on doing well in one role."
"ag_info_YourRoleTitle"	"Ο ρόλος σας: Γίνετε δυνατός, και μετά καταστρέψτε τον εχθρό"
"[english]ag_info_YourRoleTitle"	"Your Role: Gather Power, then Destroy the Enemy"
"ag_info_YourRoleBody"	"Σε αυτό τον αγώνα θα εστιάσετε στο να γίνετε δυνατός από τα μέσα του παιχνιδιού και μέχρι αργά στο παιχνίδι.\n\nΜε μερικά επίπεδα και αντικείμενα θα είστε πανίσχυρος σε μάχες και θα μπορείτε να καταστρέφετε πύργους γρήγορα.\n\nΤα bot που ελέγχους τους συμπαίκτες σας θα προσπαθήσουν να σας υποστηρίζουν σε ό,τι κάνετε."
"[english]ag_info_YourRoleBody"	"In this match you will focus on building toward Mid to Late Game power.\n\nWith a few levels and items you will be powerful in fights and able to destroy Towers quickly.\n\nThe bots which control your teammates will try to work around what you do."
"ag_info_GamePlanTitle"	"Σχέδιο παιχνιδιού"
"[english]ag_info_GamePlanTitle"	"Game Plan"
"ag_info_GamePlanBody"	"1) Προετοιμαστείτε αγοράζοντας τα αρχικά αντικείμενα\n2) Επιβιώστε στο μέτωπο επίθεσής σας για να κερδίσετε χρυσό και εμπειρία\n3) Καταφέρετε την τελική επίθεση στις μονάδες για να κερδίσετε επιπλέον χρυσό\n4) Αγοράστε βασικά αντικείμενα για να δυναμώσετε τον ήρωα σας\n5) Καταστρέψτε εχθρικούς πύργους με συμπαίκτες\n6) Καταστρέψτε τους εχθρικούς στρατώνες\n7) Καταστρέψτε το εχθρικό αρχαίο για να νικήσετε τον αγώνα"
"[english]ag_info_GamePlanBody"	"1) Prepare by purchasing your Starting Items\n2) Survive in your lane to earn Gold and Experience\n3) Strike the Last Hit on creeps to earn additional gold\n4) Buy Early Game Items to strengthen your hero\n5) Destroy enemy Towers with teammates\n6) Destroy the enemy Barracks\n7) Destroy the enemy Ancient to win the match"
"ag_objective_LunaUnlockAbilityTitle"	"Εκμάθηση ικανότητας"
"[english]ag_objective_LunaUnlockAbilityTitle"	"Learn Ability"
"ag_objective_LunaUnlockAbilityBody"	"Πατήστε το κουμπί «Επίπεδο» για να μάθετε την ικανότητα Lunar Blessing."
"[english]ag_objective_LunaUnlockAbilityBody"	"Press the \"Level Up\" button and learn the Lunar Blessing ability."
"ag_objective_SvenUnlockAbilityTitle"	"Εκμάθηση ικανότητας"
"[english]ag_objective_SvenUnlockAbilityTitle"	"Learn Ability"
"ag_objective_SvenUnlockAbilityBody"	"Πατήστε το κουμπί «Επίπεδο» για να μάθετε την ικανότητα Storm Hammer."
"[english]ag_objective_SvenUnlockAbilityBody"	"Press the \"Level Up\" button and learn the Storm Hammer ability."
"ag_objective_LinaUnlockAbilityTitle"	"Εκμάθηση ικανότητας"
"[english]ag_objective_LinaUnlockAbilityTitle"	"Learn Ability"
"ag_objective_LinaUnlockAbilityBody"	"Πατήστε το κουμπί «Επίπεδο» για να μάθετε την ικανότητα Dragon Slave."
"[english]ag_objective_LinaUnlockAbilityBody"	"Press the \"Level Up\" button and learn the Dragon Slave ability."
"ag_info_AbilityItemBuildLunaTitle"	"Οδηγοί ικανοτήτων και αντικειμένων: Ζημιά και επιβίωση"
"[english]ag_info_AbilityItemBuildLunaTitle"	"Ability & Item Builds: Damage and Survival"
"ag_info_AbilityItemBuildLunaBody"	"Για αυτό το παιχνίδι θα έχετε προκαθορισμένες Ικανότητες και Αντικείμενα.\n\nΚαθώς εξελίσσεστε, τα αντικείμενά σας θα σας επιτρέπουν να προκαλέσετε ζημιά με επιθέσεις που επίσης θα σας θεραπεύουν καθώς θα αναπηδούν σε στόχους.Αυτό θα σας βοηθήσει να επιβιώσετε καθώς θα ορμάτε σε εχθρούς και θα εκτοξεύετε την πανίσχυρη απόλυτη ικανότητά σας, που μπορεί να καταστρέψει κοντινούς εχθρούς."
"[english]ag_info_AbilityItemBuildLunaBody"	"For this match you will have preset Ability and Item build orders.\n\nAs you progress, your items will enable you to deal damaging attacks which also heal you as they bounce between targets. This will help you to survive as you charge enemies and launch your powerful ultimate ability, which can destroy nearby foes."
"ag_info_AbilityItemBuildSvenTitle"	"Οδηγοί ικανοτήτων και αντικειμένων: Αντοχή και Ζημιά"
"[english]ag_info_AbilityItemBuildSvenTitle"	"Ability & Item Builds: Durability and Damage"
"ag_info_AbilityItemBuildSvenBody"	"Για αυτό το παιχνίδι θα έχετε προκαθορισμένες Ικανότητες και Αντικείμενα.\n\nΚαθώς εξελίσσεστε, τα αντικείμενά σας θα αυξάνουν την άμυνα και την ζημιά που προκαλείτε, επιτρέποντάς σας να μειώσετε την απόσταση από τους εχθρούς σας και μετά να τους σκοτώσετε."
"[english]ag_info_AbilityItemBuildSvenBody"	"For this match you will have preset Ability and Item build orders.\n\nAs you progress, your items will increase your armor and attack damage, allowing you to close the distance to your enemy and then cut them down."
"ag_info_AbilityItemBuildLinaTitle"	"Οδηγοί ικανοτήτων και αντικειμένων: Ενέργεια για συχνή εκτέλεση ικανοτήτων"
"[english]ag_info_AbilityItemBuildLinaTitle"	"Ability & Item Builds: Mana to Cast Abilities Often"
"ag_info_AbilityItemBuildLinaBody"	"Για αυτό το παιχνίδι θα έχετε προκαθορισμένες Ικανότητες και Αντικείμενα.\n\nΚαθώς εξελίσσεστε, τα αντικείμενά σας θα σας δώσουν περισσότερη ενέργεια και αναπλήρωση ενέργειας, επιτρέποντας σας έτσι να εκτελείτε τις πανίσχυρες και ακριβές μαγείες της Lina πιο συχνά."
"[english]ag_info_AbilityItemBuildLinaBody"	"For this match you will have preset Ability and Item build orders.\n\nAs you progress, your items will grant you additional mana and mana regeneration, making it possible to cast Lina's extremely powerful and costly spells more often."
"ag_objective_BuyItemsTitle"	"Προετοιμασία για μάχη"
"[english]ag_objective_BuyItemsTitle"	"Preparing for Combat"
"ag_objective_BuyItemsBody"	"Αγοράστε τα αρχικά σας αντικείμενα. (Ανοίξτε το κατάστημα και κάντε δεξί κλικ στα εικονίδια)"
"[english]ag_objective_BuyItemsBody"	"Buy your starting items. (Open the shop and right-click icons)"
"ag_info_LaningTitle"	"Νωρίς στο παιχνίδι: Επιβιώστε καθώς αποκτάτε χρυσό από μονάδες"
"[english]ag_info_LaningTitle"	"Early Game: Survive While Earning Gold from Creeps"
"ag_objective_MoveToLaneTitle"	"Νωρίς στο παιχνίδι: Μεταβείτε στο μέτωπο επίθεσής σας"
"[english]ag_objective_MoveToLaneTitle"	"Early Game: Move to Your Lane"
"ag_info_LaningIntroTitle"	"Νωρίς στο παιχνίδι: Η μάχη ξεκινάει"
"[english]ag_info_LaningIntroTitle"	"Early Game: The Battle Begins"
"ag_objective_GetLastHitsTitle"	"Νωρίς στο παιχνίδι: Αποκτώντας χρυσό"
"[english]ag_objective_GetLastHitsTitle"	"Early Game: Earning Gold"
"ag_info_CoreItemsTitle"	"Νωρίς στο παιχνίδι: Αγορά αντικειμένων"
"[english]ag_info_CoreItemsTitle"	"Early Game: Purchase Items"
"ag_info_TakeObjectivesTitle"	"Μέσα του παιχνιδιού: Καταστροφή πύργων και πίεση για τη νίκη"
"[english]ag_info_TakeObjectivesTitle"	"Mid Game: Destroy Towers and Push Toward Victory"
"ag_objective_TakeTowersTitle"	"Μέσα του παιχνιδιού: Καταστροφή πύργων και ηρώων"
"[english]ag_objective_TakeTowersTitle"	"Mid Game: Destroy Towers and Heroes"
"ag_info_HighgroundTitle"	"Αργά στο παιχνίδι: Επίθεση στην εχθρική βάση"
"[english]ag_info_HighgroundTitle"	"Late Game: Assaulting the Enemy Base"
"ag_objective_DestroyAncientTitle"	"Αργά στο παιχνίδι: Καταστροφή του αρχαίου"
"[english]ag_objective_DestroyAncientTitle"	"Late Game: Destroy Their Ancient"
"ag_info_RoshanTitle"	"Ο Roshan και το Aegis of the Immortal"
"[english]ag_info_RoshanTitle"	"Roshan & Aegis of the Immortal"
"ag_info_VictoryTitle"	"Νίκη!"
"[english]ag_info_VictoryTitle"	"Victory!"
"ag_alert_TooManyTowerHitsTitle"	"Υπερβολική ζημιά από πύργους"
"[english]ag_alert_TooManyTowerHitsTitle"	"Excessive Tower Damage"
"ag_alert_TooManyTowerHitsBody"	"Οι πύργοι είναι θανάσιμοι!\n\nΥποχωρήστε για να υποστούν οι μονάδες σας τις επιθέσεις τους."
"[english]ag_alert_TooManyTowerHitsBody"	"Towers are deadly!\n\nRetreat and let your creeps suffer its attacks instead."
"ag_alert_TooManyCreepHitsTitle"	"Υπερβολική ζημιά από μονάδες"
"[english]ag_alert_TooManyCreepHitsTitle"	"Excessive Creep Damage"
"ag_alert_TooManyCreepHitsBody"	"Δέχεστε πολλή ζημιά από μονάδες!\n\nΑν και οι μονάδες επιτίθονται στον πρώτο εχθρό που θα συναντούν, θα αλλάξουν την στόχευσή τους σε εσάς, εάν επιτεθείτε σε έναν ήρωα της ομάδας τους."
"[english]ag_alert_TooManyCreepHitsBody"	"You are taking a lot of damage from Creeps!\n\nThough creeps will attack the first enemy they encounter, they will switch to attacking you if you attack a hero on their team."
"ag_alert_CanPurchaseItemsTitle"	"Ξοδεύοντας τον χρυσό σας"
"[english]ag_alert_CanPurchaseItemsTitle"	"Spend your gold"
"ag_alert_CanPurchaseItemsBody"	"Πατήστε {g:dota_key:keyname} για να αγοράσετε ένα αντικείμενο άμεσης αγοράς."
"[english]ag_alert_CanPurchaseItemsBody"	"Press {g:dota_key:keyname} to buy a Quick Buy item."
"ag_alert_LowHealthTitle"	"Χαμηλή ζωή"
"[english]ag_alert_LowHealthTitle"	"Low Health"
"ag_alert_LowHealthBody"	"Η ζωή σας είναι χαμηλά.\n\nΧρησιμοποιήστε ένα Healing Salve ή ένα Tango για να θεραπευθείτε."
"[english]ag_alert_LowHealthBody"	"Your health is low.\n\nUse a Healing Salve or a Tango to heal."
"ag_alert_FirstPurchaseTitle"	"Αγοράζοντας στο μέτωπο: Άμεση αγορά"
"[english]ag_alert_FirstPurchaseTitle"	"Buying in Lane: Quick Buy at any Time"
"ag_alert_FirstPurchaseBody"	"Τοποθετήσαμε τα αντικείμενα που θα χρειαστείτε στο πλαίσιο άμεσης αγοράς κοντά στο κάτω μέρος της οθόνης. Αγοράστε αντικείμενα πατώντας δεξί κλικ επάνω τους ή πατώντας {g:dota_key:keyname}.\n\nΤα αγορασμένα αντικείμενα από το μαγαζί της βάσης σας τοποθετούνται στη φύλαξη σας. Μπορείτε να χρησιμοποιήσετε τον μεταφορέα της ομάδας για σας παραδώσει τα αντικείμενα από τη φύλαξή σας πατώντας {g:dota_key:keyname2}."
"[english]ag_alert_FirstPurchaseBody"	"We have placed the items you will need in the Quick Buy tray near the bottom of the screen. Purchase items by right-clicking on them there, or by pressing {g:dota_key:keyname}.\n\nItems purchased from your base's shop while you are in the field are placed in your Stash. You can have your team's Courier deliver items from your Stash by pressing {g:dota_key:keyname2}."
"ag_alert_ForcePurchaseItemsTitle"	"Ξοδεύοντας τον χρυσό σας!"
"[english]ag_alert_ForcePurchaseItemsTitle"	"Spend your gold!"
"ag_alert_ForcePurchaseItemsBody"	"Έχετε πολύ αξόδευτο χρυσό. Αγοράστε κάτι. Να θυμάστε ότι χάνετε χρυσό όταν πεθάνετε!"
"[english]ag_alert_ForcePurchaseItemsBody"	"You have a lot of unspent gold. Buy something. Remember, you lose gold when you die!"
"ag_alert_NeedDeliverItemsTitle"	"Αντικείμενα στη φύλαξη"
"[english]ag_alert_NeedDeliverItemsTitle"	"Items in Your Stash"
"ag_alert_NeedDeliverItemsBody"	"Πατήστε {g:dota_key:keyname} για να σας παραδοθούν τα αντικείμενα στη φύλαξή σας από τον μεταφορέα της ομάδας σας."
"[english]ag_alert_NeedDeliverItemsBody"	"Press {g:dota_key:keyname} to have the items in your Stash delivered by your team's courier."
"ag_alert_CanLevelUpTitle"	"Αύξηση επιπέδου"
"[english]ag_alert_CanLevelUpTitle"	"Level Up"
"ag_alert_CanLevelUpBody"	"Μάθετε μια νέα ικανότητα ή ενδυναμώστε μια υπάρχουσα."
"[english]ag_alert_CanLevelUpBody"	"Learn a new ability, or strengthen an existing one."
"ag_alert_ForceLevelUpTitle"	"Αύξηση επιπέδου!"
"[english]ag_alert_ForceLevelUpTitle"	"Level Up!"
"ag_alert_ForceLevelUpBody"	"Δεν χρησιμοποιήσατε όλους τους πόντους επιπέδων σας. Προσθέστε πόντους σε μια ικανότητα."
"[english]ag_alert_ForceLevelUpBody"	"You haven't used all of your Level Points. Add points to a skill."
"ag_alert_BehindOnTowersTitle"	"Καταστροφή πύργων"
"[english]ag_alert_BehindOnTowersTitle"	"Destroy Towers"
"ag_alert_BehindOnTowersBody"	"Καταστρέψετε εχθρικούς πύργους πριν ο εχθρός καταφέρει να καταστρέψει τους δικούς σας."
"[english]ag_alert_BehindOnTowersBody"	"Destroy enemy Towers before the enemy can destroy yours!"
"ag_alert_BehindOnGoldTitle"	"Πίσω σε χρυσό"
"[english]ag_alert_BehindOnGoldTitle"	"Behind on Gold"
"ag_alert_BehindOnGoldBody"	"Καταφέρετε τελικές επιθέσεις σε περισσότερες μονάδες για πρόσθετο χρυσό."
"[english]ag_alert_BehindOnGoldBody"	"Last Hit more creeps to catch up on gold."
"ag_alert_BehindOnExpTitle"	"Πίσω σε εμπειρία"
"[english]ag_alert_BehindOnExpTitle"	"Behind on Experience"
"ag_alert_BehindOnExpBody"	"Παραμένετε κοντά στη μάχη για κερδίζετε εμπειρία."
"[english]ag_alert_BehindOnExpBody"	"Stay near combat to earn experience."
"ag_alert_UseSalveTitle"	"Πληγωθήκατε"
"[english]ag_alert_UseSalveTitle"	"You Are Hurt"
"ag_alert_UseSalveBody"	"Χρησιμοποιήστε ένα Healing Salve για θεραπεία. Εάν δεχθείτε ζημιά, η επίδραση θα ακυρωθεί."
"[english]ag_alert_UseSalveBody"	"Use a Healing Salve to heal. Taking damage cancels the effect."
"ag_alert_UseClarityTitle"	"Επαναφορά ενέργειας"
"[english]ag_alert_UseClarityTitle"	"Restore Mana"
"ag_alert_UseClarityBody"	"Χρησιμοποιήστε ένα Clarity για επαναφορά ενέργειας. Εάν δεχθείτε ζημιά, η επίδραση θα ακυρωθεί."
"[english]ag_alert_UseClarityBody"	"Use a Clarity to restore mana. Taking damage cancels the effect."
"ag_alert_RespawnTitle"	"Αναβίωση"
"[english]ag_alert_RespawnTitle"	"Respawn"
"ag_alert_RespawnBody"	"Ο ήρωάς σας θα αναβιώσει σύντομα.\n\nΠροσπαθήστε να επανέλθετε άμεσα στη δράση!"
"[english]ag_alert_RespawnBody"	"Your hero will respawn soon.\n\nTry to get back into the action quickly!"
"ag_alert_TangoUsageTitle"	"Tango"
"[english]ag_alert_TangoUsageTitle"	"Tangos"
"ag_alert_TangoUsageBody"	"Τα Tango σας επιτρέπουν να καταναλώσετε ένα δέντρο για να θεραπεύσετε σταδιακά τον ήρωα σας.\n\nΠατήστε αριστερό κλικ σε ένα δέντρο για να χρησιμοποιήσετε ένα Tango."
"[english]ag_alert_TangoUsageBody"	"Tangos let you eat a tree to heal your hero over time.\n\nLeft-click on a tree to use a tango."
"ag_alert_SalveUsageTitle"	"Healing Salve"
"[english]ag_alert_SalveUsageTitle"	"Healing Salve"
"ag_alert_SalveUsageBody"	"Τα Healing Salve μπορούν θεραπεύσουν γρήγορα τον ήρωα που στοχεύετε (αριστερό κλικ).\n\nΕάν δεχθείτε ζημιά, η επίδραση θα ακυρωθεί."
"[english]ag_alert_SalveUsageBody"	"Healing Salves can quickly heal the hero you target (left-click).\n\nTaking damage will cancel the effect."
"ag_alert_ClarityUsageTitle"	"Clarity"
"[english]ag_alert_ClarityUsageTitle"	"Clarity"
"ag_alert_ClarityUsageBody"	"Τα Clarity αναπληρώνουν αργά την ενέργεια του ήρωα που στοχεύετε (αριστερό κλικ).\n\nΕάν δεχθείτε ζημιά, η επίδραση θα ακυρωθεί."
"[english]ag_alert_ClarityUsageBody"	"Clarity slowly regenerates the mana of the hero you target (left click).\n\nTaking damage will cancel the effect."
"ag_ExcessiveTowerDamageTitle"	"Οι πύργοι είναι επικίνδυνοι. Υποχωρήστε!"
"[english]ag_ExcessiveTowerDamageTitle"	"Towers are Dangerous. Retreat!"
"ag_alert_DeathTitle"	"Θάνατος και αναβίωση"
"[english]ag_alert_DeathTitle"	"Death & Respawning"
"ag_alert_DeathBody"	"Όταν πεθαίνετε, χάνετε ένα μέρος του χρυσού σας και οι ήρωες που είναι υπεύθυνοι για τον θάνατό σας κερδίζουν εμπειρία και γίνονται δυνατότεροι.\n\nΘα αναβιώσετε στην πηγή της ομάδας σας όταν το χρονόμετρο θανάτου σας λήξει. Μπορείτε να δείτε το χρονόμετρο θανάτου σας κάτω από το πορτραίτο του ήρωά σας στο επάνω μέρος της οθόνης."
"[english]ag_alert_DeathBody"	"When you die, you lose a portion of your gold, and the hero or heroes responsible for your death earn experience to become stronger.\n\nYou will respawn at your team's fountain when your death timer ends. You can see your death timer beneath your hero's portrait at the top of the screen.\n\nEach level gained increases how long a hero remains dead."
"ag_alert_FountainTitle"	"Πηγή: Το σημείο για θεραπεία"
"[english]ag_alert_FountainTitle"	"The Fountain: A Source of Healing"
"ag_alert_FountainBody"	"Μετά τον θάνατο, ο ήρωάς σας θα αναβιώσει στην πηγή της ομάδας του. Εάν επιστρέψετε στην πηγή, θα αναπληρώσετε γρήγορα τη ζωή και ενέργειά σας."
"[english]ag_alert_FountainBody"	"After death, your hero will respawn at their team's fountain. Returning to the Fountain will quickly restore your health and mana."
"ag_alert_ScrollTitle"	"Town Portal Scroll: Τηλεμεταφερθείτε στο πεδίο μάχης"
"[english]ag_alert_ScrollTitle"	"Town Portal Scrolls: Teleport Around the Battlefield"
"ag_alert_ScrollBody"	"Η γρήγορη μετακίνηση στο πεδίο μάχης είναι σημαντική.\n\nΤα Town Portal Scroll μπορούν να αγοραστούν από το μαγαζί και σας επιτρέπουν να τηλεμεταφέρεστε σε έναν συμμαχικό πύργο ή άλλο κτήριο.\n\nΓια να χρησιμοποιήσετε ένα Town Portal Scroll, πατήστε αριστερό κλικ στο αντικείμενο και μετά αριστερό κλικ στο συμμαχικό κτήριο στον μικρό χάρτη ώστε να τηλεμεταφερθείτε εκεί."
"[english]ag_alert_ScrollBody"	"Moving around the battlefield quickly is important.\n\nTown Portal Scrolls can be purchased from the shop, and allow you to teleport to an allied Tower or other building.\n\nTo use a Scroll, left-click on the item, then left-click on an allied building on the minimap to teleport there."
"ag_alert_ScrollUsageTitle"	"Town Portal Scroll"
"[english]ag_alert_ScrollUsageTitle"	"Town Portal Scroll"
"ag_alert_ScrollUsageBody"	"Αγοράστε και χρησιμοποιήστε ένα Town Portal Scroll. Για να χρησιμοποιήσετε ένα Town Portal Scroll, πατήστε αριστερό κλικ στο αντικείμενο και μετά αριστερό κλικ στο συμμαχικό κτήριο στον μικρό χάρτη ώστε να τηλεμεταφερθείτε εκεί."
"[english]ag_alert_ScrollUsageBody"	"Purchase and use a Town Portal Scroll. To use the Scroll, left-click on the item, then left-click on any allied building on the minimap to teleport there."
"ag_alert_SecretShopTitle"	"Μυστικό μαγαζί: Αντικείμενα μη διαθέσιμα αλλού"
"[english]ag_alert_SecretShopTitle"	"Secret Shop: Items not available elsewhere"
"ag_alert_SecretShopBody"	"Κάποια αντικείμενα μπορούν να αγοραστούν μόνο από το μυστικό μαγαζί. Εάν προσπαθήσετε να αγοράσετε ένα από αυτά τα αντικείμενα ενώ βρίσκεστε εκτός εμβέλειας από το μυστικό μαγαζί, ένας δείκτης θα εμφανιστεί για να σας δείξει πού να πάτε."
"[english]ag_alert_SecretShopBody"	"Some items can only be purchased from a Secret Shop. If you try to buy one of these items while out of range of a Secret Shop, a marker will appear to tell you where to go."
"ag_alert_SecretShopFoundTitle"	"Μυστικό μαγαζί: Όχι και τόσο μυστικό τελικά"
"[english]ag_alert_SecretShopFoundTitle"	"The Secret Shop: Not Actually a Secret"
"ag_alert_SecretShopFoundBody"	"Καλώς ορίσατε στο μυστικό μαγαζί.\n\nΥπάρχει ένα μυστικό μαγαζί σε κάθε πλευρά του ποταμιού· και τα δύο πουλάνε τα ίδια αντικείμενα. Και οι δύο ομάδες μπορούν να χρησιμοποιήσουν οποιοδήποτε μυστικό μαγαζί."
"[english]ag_alert_SecretShopFoundBody"	"Welcome to the Secret Shop.\n\nThere is a Secret Shop on both sides of the river, and both sell the same items. Either team can use either Secret Shop."
"ag_detail_InventoryTitle"	"Διαχείριση των αντικειμένων μου"
"[english]ag_detail_InventoryTitle"	"Managing Your Inventory"
"ag_detail_ItemSvenHyperstoneTitle"	"Λεπτομέρειες αντικειμένου: Hyperstone - Επιπλέον ταχύτητα επίθεσης"
"[english]ag_detail_ItemSvenHyperstoneTitle"	"Item Details: Hyperstone - Attack Speed Boost"
"ag_detail_ItemSvenAssaultTitle"	"Λεπτομέρειες αντικειμένου: Assault Cuirass - Αύρα άμυνας και ταχύτητας επίθεσης"
"[english]ag_detail_ItemSvenAssaultTitle"	"Item Details: Assault Cuirass - Attack speed and Armor aura"
"ag_detail_ItemLinaCycloneTitle"	"Πληροφορίες αντικειμένου: Eul's Scepter of Divinity - Κινητικότητα και ευελιξία"
"[english]ag_detail_ItemLinaCycloneTitle"	"Item Details: Eul's Scepter of Divinity - Mobility and Versatility"
}
